scores,steps_per_game,epsilon,game,steps,time per apple
130,216,0,0,216,16.615384615384617
340,521,0,1,737,15.323529411764707
160,261,0,2,998,16.3125
120,143,0,3,1141,11.916666666666666
170,237,0,4,1378,13.941176470588236
150,193,0,5,1571,12.866666666666667
350,574,0,6,2145,16.4
480,874,0,7,3019,18.208333333333332
280,334,0,8,3353,11.928571428571429
320,496,0,9,3849,15.5
130,190,0,10,4039,14.615384615384615
290,446,0,11,4485,15.379310344827585
120,159,0,12,4644,13.25
450,650,0,13,5294,14.444444444444445
350,501,0,14,5795,14.314285714285715
250,342,0,15,6137,13.68
240,376,0,16,6513,15.666666666666666
270,418,0,17,6931,15.481481481481481
140,231,0,18,7162,16.5
190,228,0,19,7390,12.0
130,161,0,20,7551,12.384615384615385
370,516,0,21,8067,13.945945945945946
180,223,0,22,8290,12.38888888888889
240,370,0,23,8660,15.416666666666666
270,375,0,24,9035,13.88888888888889
210,239,0,25,9274,11.380952380952381
380,554,0,26,9828,14.578947368421053
290,460,0,27,10288,15.862068965517242
80,103,0,28,10391,12.875
280,461,0,29,10852,16.464285714285715
190,223,0,30,11075,11.736842105263158
210,224,0,31,11299,10.666666666666666
280,372,0,32,11671,13.285714285714286
310,435,0,33,12106,14.03225806451613
160,267,0,34,12373,16.6875
250,288,0,35,12661,11.52
230,316,0,36,12977,13.73913043478261
330,486,0,37,13463,14.727272727272727
140,190,0,38,13653,13.571428571428571
310,440,0,39,14093,14.193548387096774
210,350,0,40,14443,16.666666666666668
360,559,0,41,15002,15.527777777777779
180,227,0,42,15229,12.61111111111111
120,190,0,43,15419,15.833333333333334
260,386,0,44,15805,14.846153846153847
310,432,0,45,16237,13.935483870967742
230,315,0,46,16552,13.695652173913043
100,165,0,47,16717,16.5
200,263,0,48,16980,13.15
230,270,0,49,17250,11.73913043478261
160,241,0,50,17491,15.0625
270,306,0,51,17797,11.333333333333334
150,181,0,52,17978,12.066666666666666
270,295,0,53,18273,10.925925925925926
360,513,0,54,18786,14.25
130,183,0,55,18969,14.076923076923077
440,739,0,56,19708,16.795454545454547
230,340,0,57,20048,14.782608695652174
270,450,0,58,20498,16.666666666666668
370,583,0,59,21081,15.756756756756756
100,162,0,60,21243,16.2
190,306,0,61,21549,16.105263157894736
260,371,0,62,21920,14.26923076923077
340,587,0,63,22507,17.264705882352942
130,180,0,64,22687,13.846153846153847
290,442,0,65,23129,15.241379310344827
320,512,0,66,23641,16.0
320,467,0,67,24108,14.59375
250,340,0,68,24448,13.6
270,408,0,69,24856,15.11111111111111
540,792,0,70,25648,14.666666666666666
300,474,0,71,26122,15.8
370,647,0,72,26769,17.486486486486488
120,184,0,73,26953,15.333333333333334
470,865,0,74,27818,18.404255319148938
220,270,0,75,28088,12.272727272727273
300,510,0,76,28598,17.0
370,522,0,77,29120,14.108108108108109
100,152,0,78,29272,15.2
250,418,0,79,29690,16.72
210,310,0,80,30000,14.761904761904763
290,400,0,81,30400,13.793103448275861
170,260,0,82,30660,15.294117647058824
230,299,0,83,30959,13.0
230,293,0,84,31252,12.73913043478261
130,196,0,85,31448,15.076923076923077
450,846,0,86,32294,18.8
150,180,0,87,32474,12.0
220,358,0,88,32832,16.272727272727273
210,277,0,89,33109,13.19047619047619
440,681,0,90,33790,15.477272727272727
130,169,0,91,33959,13.0
370,605,0,92,34564,16.35135135135135
100,130,0,93,34694,13.0
270,440,0,94,35134,16.296296296296298
220,300,0,95,35434,13.636363636363637
290,423,0,96,35857,14.586206896551724
420,674,0,97,36531,16.047619047619047
390,546,0,98,37077,14.0
210,318,0,99,37395,15.142857142857142
140,241,0,100,37636,17.214285714285715
170,271,0,101,37907,15.941176470588236
130,138,0,102,38045,10.615384615384615
450,748,0,103,38793,16.622222222222224
250,343,0,104,39136,13.72
70,85,0,105,39221,12.142857142857142
290,372,0,106,39593,12.827586206896552
220,364,0,107,39957,16.545454545454547
200,323,0,108,40280,16.15
230,311,0,109,40591,13.521739130434783
380,508,0,110,41099,13.368421052631579
230,301,0,111,41400,13.08695652173913
200,280,0,112,41680,14.0
120,172,0,113,41852,14.333333333333334
300,502,0,114,42354,16.733333333333334
340,505,0,115,42859,14.852941176470589
300,443,0,116,43302,14.766666666666667
330,550,0,117,43852,16.666666666666668
390,654,0,118,44506,16.76923076923077
180,234,0,119,44740,13.0
270,366,0,120,45106,13.555555555555555
260,357,0,121,45463,13.73076923076923
220,320,0,122,45783,14.545454545454545
370,569,0,123,46352,15.378378378378379
210,316,0,124,46668,15.047619047619047
170,271,0,125,46939,15.941176470588236
400,721,0,126,47660,18.025
420,670,0,127,48330,15.952380952380953
280,417,0,128,48747,14.892857142857142
170,222,0,129,48969,13.058823529411764
480,713,0,130,49682,14.854166666666666
120,191,0,131,49873,15.916666666666666
330,530,0,132,50403,16.060606060606062
330,531,0,133,50934,16.09090909090909
240,372,0,134,51306,15.5
270,401,0,135,51707,14.851851851851851
250,362,0,136,52069,14.48
370,499,0,137,52568,13.486486486486486
230,335,0,138,52903,14.565217391304348
390,668,0,139,53571,17.128205128205128
180,280,0,140,53851,15.555555555555555
160,241,0,141,54092,15.0625
320,469,0,142,54561,14.65625
370,592,0,143,55153,16.0
270,416,0,144,55569,15.407407407407407
350,589,0,145,56158,16.82857142857143
380,652,0,146,56810,17.157894736842106
180,244,0,147,57054,13.555555555555555
180,235,0,148,57289,13.055555555555555
260,376,0,149,57665,14.461538461538462
380,548,0,150,58213,14.421052631578947
120,141,0,151,58354,11.75
190,264,0,152,58618,13.894736842105264
250,411,0,153,59029,16.44
190,272,0,154,59301,14.31578947368421
280,445,0,155,59746,15.892857142857142
170,200,0,156,59946,11.764705882352942
340,498,0,157,60444,14.647058823529411
320,490,0,158,60934,15.3125
220,273,0,159,61207,12.409090909090908
40,62,0,160,61269,15.5
140,165,0,161,61434,11.785714285714286
140,200,0,162,61634,14.285714285714286
80,115,0,163,61749,14.375
360,497,0,164,62246,13.805555555555555
340,595,0,165,62841,17.5
150,204,0,166,63045,13.6
220,327,0,167,63372,14.863636363636363
300,431,0,168,63803,14.366666666666667
170,191,0,169,63994,11.235294117647058
130,189,0,170,64183,14.538461538461538
190,254,0,171,64437,13.368421052631579
270,386,0,172,64823,14.296296296296296
190,263,0,173,65086,13.842105263157896
280,466,0,174,65552,16.642857142857142
270,380,0,175,65932,14.074074074074074
140,205,0,176,66137,14.642857142857142
130,171,0,177,66308,13.153846153846153
360,551,0,178,66859,15.305555555555555
220,293,0,179,67152,13.318181818181818
100,150,0,180,67302,15.0
190,248,0,181,67550,13.052631578947368
50,60,0,182,67610,12.0
210,275,0,183,67885,13.095238095238095
280,394,0,184,68279,14.071428571428571
310,452,0,185,68731,14.580645161290322
140,212,0,186,68943,15.142857142857142
350,529,0,187,69472,15.114285714285714
140,212,0,188,69684,15.142857142857142
340,445,0,189,70129,13.088235294117647
280,392,0,190,70521,14.0
160,187,0,191,70708,11.6875
240,370,0,192,71078,15.416666666666666
500,816,0,193,71894,16.32
130,167,0,194,72061,12.846153846153847
170,298,0,195,72359,17.529411764705884
210,277,0,196,72636,13.19047619047619
310,482,0,197,73118,15.548387096774194
320,429,0,198,73547,13.40625
150,214,0,199,73761,14.266666666666667
190,337,0,200,74098,17.736842105263158
230,373,0,201,74471,16.217391304347824
340,562,0,202,75033,16.529411764705884
260,432,0,203,75465,16.615384615384617
350,415,0,204,75880,11.857142857142858
180,272,0,205,76152,15.11111111111111
340,430,0,206,76582,12.647058823529411
190,327,0,207,76909,17.210526315789473
250,380,0,208,77289,15.2
490,748,0,209,78037,15.26530612244898
280,420,0,210,78457,15.0
200,288,0,211,78745,14.4
290,414,0,212,79159,14.275862068965518
360,568,0,213,79727,15.777777777777779
220,288,0,214,80015,13.090909090909092
70,78,0,215,80093,11.142857142857142
300,439,0,216,80532,14.633333333333333
250,380,0,217,80912,15.2
250,378,0,218,81290,15.12
290,336,0,219,81626,11.586206896551724
320,467,0,220,82093,14.59375
190,220,0,221,82313,11.578947368421053
350,614,0,222,82927,17.542857142857144
120,146,0,223,83073,12.166666666666666
300,475,0,224,83548,15.833333333333334
130,200,0,225,83748,15.384615384615385
270,377,0,226,84125,13.962962962962964
370,609,0,227,84734,16.45945945945946
280,426,0,228,85160,15.214285714285714
210,274,0,229,85434,13.047619047619047
270,438,0,230,85872,16.22222222222222
90,133,0,231,86005,14.777777777777779
180,238,0,232,86243,13.222222222222221
110,207,0,233,86450,18.818181818181817
210,320,0,234,86770,15.238095238095237
390,668,0,235,87438,17.128205128205128
250,509,0,236,87947,20.36
270,422,0,237,88369,15.62962962962963
480,769,0,238,89138,16.020833333333332
310,399,0,239,89537,12.870967741935484
240,365,0,240,89902,15.208333333333334
120,131,0,241,90033,10.916666666666666
170,272,0,242,90305,16.0
210,338,0,243,90643,16.095238095238095
180,290,0,244,90933,16.11111111111111
310,418,0,245,91351,13.483870967741936
280,409,0,246,91760,14.607142857142858
240,416,0,247,92176,17.333333333333332
140,201,0,248,92377,14.357142857142858
330,547,0,249,92924,16.575757575757574
210,253,0,250,93177,12.047619047619047
190,309,0,251,93486,16.263157894736842
360,609,0,252,94095,16.916666666666668
260,366,0,253,94461,14.076923076923077
390,684,0,254,95145,17.53846153846154
300,443,0,255,95588,14.766666666666667
190,243,0,256,95831,12.789473684210526
290,432,0,257,96263,14.89655172413793
160,181,0,258,96444,11.3125
180,280,0,259,96724,15.555555555555555
280,469,0,260,97193,16.75
150,215,0,261,97408,14.333333333333334
400,651,0,262,98059,16.275
110,147,0,263,98206,13.363636363636363
310,541,0,264,98747,17.451612903225808
290,447,0,265,99194,15.413793103448276
180,290,0,266,99484,16.11111111111111
420,751,0,267,100235,17.88095238095238
400,614,0,268,100849,15.35
180,261,0,269,101110,14.5
130,173,0,270,101283,13.307692307692308
160,255,0,271,101538,15.9375
280,402,0,272,101940,14.357142857142858
170,233,0,273,102173,13.705882352941176
140,225,0,274,102398,16.071428571428573
300,482,0,275,102880,16.066666666666666
430,666,0,276,103546,15.488372093023257
320,406,0,277,103952,12.6875
270,422,0,278,104374,15.62962962962963
240,272,0,279,104646,11.333333333333334
270,381,0,280,105027,14.11111111111111
130,176,0,281,105203,13.538461538461538
320,543,0,282,105746,16.96875
170,272,0,283,106018,16.0
240,378,0,284,106396,15.75
230,370,0,285,106766,16.08695652173913
250,355,0,286,107121,14.2
140,199,0,287,107320,14.214285714285714
460,744,0,288,108064,16.17391304347826
260,345,0,289,108409,13.26923076923077
140,168,0,290,108577,12.0
160,243,0,291,108820,15.1875
320,510,0,292,109330,15.9375
90,122,0,293,109452,13.555555555555555
340,497,0,294,109949,14.617647058823529
280,423,0,295,110372,15.107142857142858
180,275,0,296,110647,15.277777777777779
240,278,0,297,110925,11.583333333333334
230,359,0,298,111284,15.608695652173912
260,321,0,299,111605,12.346153846153847
80,89,0,300,111694,11.125
140,177,0,301,111871,12.642857142857142
170,265,0,302,112136,15.588235294117647
460,784,0,303,112920,17.043478260869566
190,270,0,304,113190,14.210526315789474
140,181,0,305,113371,12.928571428571429
430,564,0,306,113935,13.116279069767442
200,366,0,307,114301,18.3
140,164,0,308,114465,11.714285714285714
200,285,0,309,114750,14.25
140,206,0,310,114956,14.714285714285714
300,369,0,311,115325,12.3
270,457,0,312,115782,16.925925925925927
300,504,0,313,116286,16.8
160,229,0,314,116515,14.3125
370,562,0,315,117077,15.18918918918919
170,252,0,316,117329,14.823529411764707
280,439,0,317,117768,15.678571428571429
140,213,0,318,117981,15.214285714285714
350,503,0,319,118484,14.371428571428572
350,488,0,320,118972,13.942857142857143
210,324,0,321,119296,15.428571428571429
340,480,0,322,119776,14.117647058823529
80,112,0,323,119888,14.0
220,341,0,324,120229,15.5
130,167,0,325,120396,12.846153846153847
340,484,0,326,120880,14.235294117647058
400,656,0,327,121536,16.4
400,627,0,328,122163,15.675
210,331,0,329,122494,15.761904761904763
360,540,0,330,123034,15.0
130,187,0,331,123221,14.384615384615385
420,570,0,332,123791,13.571428571428571
140,232,0,333,124023,16.571428571428573
280,374,0,334,124397,13.357142857142858
450,662,0,335,125059,14.71111111111111
160,234,0,336,125293,14.625
220,255,0,337,125548,11.590909090909092
190,276,0,338,125824,14.526315789473685
370,552,0,339,126376,14.91891891891892
160,244,0,340,126620,15.25
250,385,0,341,127005,15.4
360,546,0,342,127551,15.166666666666666
180,263,0,343,127814,14.61111111111111
390,557,0,344,128371,14.282051282051283
120,182,0,345,128553,15.166666666666666
320,478,0,346,129031,14.9375
130,204,0,347,129235,15.692307692307692
90,77,0,348,129312,8.555555555555555
180,256,0,349,129568,14.222222222222221
330,568,0,350,130136,17.21212121212121
450,702,0,351,130838,15.6
170,252,0,352,131090,14.823529411764707
280,438,0,353,131528,15.642857142857142
320,406,0,354,131934,12.6875
340,578,0,355,132512,17.0
230,322,0,356,132834,14.0
230,306,0,357,133140,13.304347826086957
300,496,0,358,133636,16.533333333333335
260,338,0,359,133974,13.0
360,644,0,360,134618,17.88888888888889
180,323,0,361,134941,17.944444444444443
300,394,0,362,135335,13.133333333333333
160,197,0,363,135532,12.3125
290,410,0,364,135942,14.137931034482758
140,157,0,365,136099,11.214285714285714
170,278,0,366,136377,16.352941176470587
370,543,0,367,136920,14.675675675675675
280,416,0,368,137336,14.857142857142858
270,419,0,369,137755,15.518518518518519
250,339,0,370,138094,13.56
270,341,0,371,138435,12.62962962962963
120,142,0,372,138577,11.833333333333334
290,397,0,373,138974,13.689655172413794
350,491,0,374,139465,14.028571428571428
450,759,0,375,140224,16.866666666666667
150,200,0,376,140424,13.333333333333334
180,197,0,377,140621,10.944444444444445
360,498,0,378,141119,13.833333333333334
160,218,0,379,141337,13.625
190,282,0,380,141619,14.842105263157896
110,190,0,381,141809,17.272727272727273
180,248,0,382,142057,13.777777777777779
100,147,0,383,142204,14.7
100,106,0,384,142310,10.6
370,546,0,385,142856,14.756756756756756
250,318,0,386,143174,12.72
280,435,0,387,143609,15.535714285714286
140,204,0,388,143813,14.571428571428571
290,400,0,389,144213,13.793103448275861
160,223,0,390,144436,13.9375
250,322,0,391,144758,12.88
110,145,0,392,144903,13.181818181818182
300,410,0,393,145313,13.666666666666666
110,139,0,394,145452,12.636363636363637
460,868,0,395,146320,18.869565217391305
240,340,0,396,146660,14.166666666666666
290,429,0,397,147089,14.793103448275861
410,662,0,398,147751,16.146341463414632
270,473,0,399,148224,17.51851851851852
330,457,0,400,148681,13.848484848484848
200,305,0,401,148986,15.25
160,279,0,402,149265,17.4375
330,434,0,403,149699,13.151515151515152
170,248,0,404,149947,14.588235294117647
210,274,0,405,150221,13.047619047619047
220,322,0,406,150543,14.636363636363637
260,379,0,407,150922,14.576923076923077
180,250,0,408,151172,13.88888888888889
310,473,0,409,151645,15.258064516129032
190,240,0,410,151885,12.631578947368421
190,258,0,411,152143,13.578947368421053
500,866,0,412,153009,17.32
260,405,0,413,153414,15.576923076923077
160,212,0,414,153626,13.25
140,193,0,415,153819,13.785714285714286
280,412,0,416,154231,14.714285714285714
160,244,0,417,154475,15.25
140,229,0,418,154704,16.357142857142858
240,363,0,419,155067,15.125
420,598,0,420,155665,14.238095238095237
180,284,0,421,155949,15.777777777777779
180,253,0,422,156202,14.055555555555555
280,383,0,423,156585,13.678571428571429
290,381,0,424,156966,13.137931034482758
80,95,0,425,157061,11.875
150,263,0,426,157324,17.533333333333335
270,372,0,427,157696,13.777777777777779
260,408,0,428,158104,15.692307692307692
270,407,0,429,158511,15.074074074074074
300,393,0,430,158904,13.1
140,168,0,431,159072,12.0
100,135,0,432,159207,13.5
250,381,0,433,159588,15.24
210,279,0,434,159867,13.285714285714286
200,281,0,435,160148,14.05
190,261,0,436,160409,13.736842105263158
120,175,0,437,160584,14.583333333333334
260,354,0,438,160938,13.615384615384615
230,360,0,439,161298,15.652173913043478
210,306,0,440,161604,14.571428571428571
240,350,0,441,161954,14.583333333333334
220,320,0,442,162274,14.545454545454545
80,106,0,443,162380,13.25
100,130,0,444,162510,13.0
230,322,0,445,162832,14.0
300,517,0,446,163349,17.233333333333334
230,353,0,447,163702,15.347826086956522
110,155,0,448,163857,14.090909090909092
140,241,0,449,164098,17.214285714285715
210,354,0,450,164452,16.857142857142858
250,326,0,451,164778,13.04
420,704,0,452,165482,16.761904761904763
250,318,0,453,165800,12.72
290,427,0,454,166227,14.724137931034482
340,529,0,455,166756,15.558823529411764
280,437,0,456,167193,15.607142857142858
400,517,0,457,167710,12.925
260,372,0,458,168082,14.307692307692308
340,474,0,459,168556,13.941176470588236
460,843,0,460,169399,18.32608695652174
170,230,0,461,169629,13.529411764705882
170,236,0,462,169865,13.882352941176471
480,718,0,463,170583,14.958333333333334
260,337,0,464,170920,12.961538461538462
170,191,0,465,171111,11.235294117647058
250,313,0,466,171424,12.52
260,480,0,467,171904,18.46153846153846
280,403,0,468,172307,14.392857142857142
160,216,0,469,172523,13.5
220,366,0,470,172889,16.636363636363637
340,496,0,471,173385,14.588235294117647
120,167,0,472,173552,13.916666666666666
250,371,0,473,173923,14.84
360,583,0,474,174506,16.194444444444443
160,252,0,475,174758,15.75
250,338,0,476,175096,13.52
240,327,0,477,175423,13.625
470,711,0,478,176134,15.127659574468085
170,243,0,479,176377,14.294117647058824
420,658,0,480,177035,15.666666666666666
120,176,0,481,177211,14.666666666666666
330,482,0,482,177693,14.606060606060606
190,271,0,483,177964,14.263157894736842
360,489,0,484,178453,13.583333333333334
140,192,0,485,178645,13.714285714285714
240,288,0,486,178933,12.0
360,448,0,487,179381,12.444444444444445
280,419,0,488,179800,14.964285714285714
50,43,0,489,179843,8.6
90,94,0,490,179937,10.444444444444445
90,125,0,491,180062,13.88888888888889
150,253,0,492,180315,16.866666666666667
220,357,0,493,180672,16.227272727272727
370,545,0,494,181217,14.72972972972973
200,255,0,495,181472,12.75
290,427,0,496,181899,14.724137931034482
360,554,0,497,182453,15.38888888888889
420,581,0,498,183034,13.833333333333334
230,279,0,499,183313,12.130434782608695
270,425,0,500,183738,15.74074074074074
260,282,0,501,184020,10.846153846153847
240,407,0,502,184427,16.958333333333332
200,373,0,503,184800,18.65
240,305,0,504,185105,12.708333333333334
60,86,0,505,185191,14.333333333333334
290,465,0,506,185656,16.03448275862069
210,306,0,507,185962,14.571428571428571
420,684,0,508,186646,16.285714285714285
80,108,0,509,186754,13.5
430,695,0,510,187449,16.162790697674417
350,545,0,511,187994,15.571428571428571
430,592,0,512,188586,13.767441860465116
230,309,0,513,188895,13.434782608695652
100,145,0,514,189040,14.5
170,286,0,515,189326,16.823529411764707
320,455,0,516,189781,14.21875
90,96,0,517,189877,10.666666666666666
210,281,0,518,190158,13.380952380952381
170,255,0,519,190413,15.0
390,619,0,520,191032,15.871794871794872
430,724,0,521,191756,16.837209302325583
310,406,0,522,192162,13.096774193548388
310,470,0,523,192632,15.161290322580646
340,520,0,524,193152,15.294117647058824
160,242,0,525,193394,15.125
280,427,0,526,193821,15.25
180,270,0,527,194091,15.0
230,343,0,528,194434,14.91304347826087
240,348,0,529,194782,14.5
230,290,0,530,195072,12.608695652173912
270,345,0,531,195417,12.777777777777779
180,243,0,532,195660,13.5
390,696,0,533,196356,17.846153846153847
160,205,0,534,196561,12.8125
220,277,0,535,196838,12.590909090909092
330,503,0,536,197341,15.242424242424242
190,238,0,537,197579,12.526315789473685
260,378,0,538,197957,14.538461538461538
330,510,0,539,198467,15.454545454545455
260,356,0,540,198823,13.692307692307692
150,220,0,541,199043,14.666666666666666
160,241,0,542,199284,15.0625
250,402,0,543,199686,16.08
460,768,0,544,200454,16.695652173913043
270,392,0,545,200846,14.518518518518519
240,322,0,546,201168,13.416666666666666
190,302,0,547,201470,15.894736842105264
190,274,0,548,201744,14.421052631578947
450,826,0,549,202570,18.355555555555554
380,537,0,550,203107,14.131578947368421
240,264,0,551,203371,11.0
240,394,0,552,203765,16.416666666666668
210,310,0,553,204075,14.761904761904763
230,351,0,554,204426,15.26086956521739
290,455,0,555,204881,15.689655172413794
270,407,0,556,205288,15.074074074074074
250,307,0,557,205595,12.28
100,148,0,558,205743,14.8
80,96,0,559,205839,12.0
180,252,0,560,206091,14.0
250,287,0,561,206378,11.48
200,295,0,562,206673,14.75
330,505,0,563,207178,15.303030303030303
370,485,0,564,207663,13.108108108108109
270,401,0,565,208064,14.851851851851851
260,325,0,566,208389,12.5
250,383,0,567,208772,15.32
290,436,0,568,209208,15.03448275862069
160,213,0,569,209421,13.3125
250,383,0,570,209804,15.32
270,442,0,571,210246,16.37037037037037
270,375,0,572,210621,13.88888888888889
240,337,0,573,210958,14.041666666666666
280,415,0,574,211373,14.821428571428571
130,146,0,575,211519,11.23076923076923
200,270,0,576,211789,13.5
370,657,0,577,212446,17.756756756756758
160,279,0,578,212725,17.4375
240,371,0,579,213096,15.458333333333334
300,388,0,580,213484,12.933333333333334
410,683,0,581,214167,16.658536585365855
330,532,0,582,214699,16.12121212121212
470,816,0,583,215515,17.361702127659573
180,261,0,584,215776,14.5
130,302,0,585,216078,23.23076923076923
160,237,0,586,216315,14.8125
180,318,0,587,216633,17.666666666666668
190,231,0,588,216864,12.157894736842104
330,465,0,589,217329,14.090909090909092
170,275,0,590,217604,16.176470588235293
320,490,0,591,218094,15.3125
430,651,0,592,218745,15.13953488372093
350,590,0,593,219335,16.857142857142858
350,506,0,594,219841,14.457142857142857
80,90,0,595,219931,11.25
150,250,0,596,220181,16.666666666666668
270,407,0,597,220588,15.074074074074074
120,174,0,598,220762,14.5
210,282,0,599,221044,13.428571428571429
140,205,0,600,221249,14.642857142857142
90,80,0,601,221329,8.88888888888889
280,499,0,602,221828,17.821428571428573
340,577,0,603,222405,16.970588235294116
260,330,0,604,222735,12.692307692307692
170,252,0,605,222987,14.823529411764707
300,442,0,606,223429,14.733333333333333
210,290,0,607,223719,13.80952380952381
330,530,0,608,224249,16.060606060606062
380,584,0,609,224833,15.368421052631579
150,229,0,610,225062,15.266666666666667
380,650,0,611,225712,17.105263157894736
240,324,0,612,226036,13.5
240,346,0,613,226382,14.416666666666666
350,488,0,614,226870,13.942857142857143
230,431,0,615,227301,18.73913043478261
230,310,0,616,227611,13.478260869565217
200,241,0,617,227852,12.05
400,603,0,618,228455,15.075
180,254,0,619,228709,14.11111111111111
410,675,0,620,229384,16.463414634146343
330,516,0,621,229900,15.636363636363637
280,412,0,622,230312,14.714285714285714
300,563,0,623,230875,18.766666666666666
130,150,0,624,231025,11.538461538461538
250,402,0,625,231427,16.08
500,691,0,626,232118,13.82
300,474,0,627,232592,15.8
390,655,0,628,233247,16.794871794871796
180,216,0,629,233463,12.0
250,298,0,630,233761,11.92
150,235,0,631,233996,15.666666666666666
190,266,0,632,234262,14.0
340,480,0,633,234742,14.117647058823529
170,196,0,634,234938,11.529411764705882
220,291,0,635,235229,13.227272727272727
220,280,0,636,235509,12.727272727272727
250,454,0,637,235963,18.16
360,585,0,638,236548,16.25
480,644,0,639,237192,13.416666666666666
260,443,0,640,237635,17.03846153846154
300,439,0,641,238074,14.633333333333333
210,331,0,642,238405,15.761904761904763
170,232,0,643,238637,13.647058823529411
500,903,0,644,239540,18.06
330,454,0,645,239994,13.757575757575758
300,478,0,646,240472,15.933333333333334
130,181,0,647,240653,13.923076923076923
230,334,0,648,240987,14.521739130434783
140,192,0,649,241179,13.714285714285714
110,191,0,650,241370,17.363636363636363
310,469,0,651,241839,15.129032258064516
170,265,0,652,242104,15.588235294117647
300,403,0,653,242507,13.433333333333334
320,463,0,654,242970,14.46875
130,210,0,655,243180,16.153846153846153
340,577,0,656,243757,16.970588235294116
260,385,0,657,244142,14.807692307692308
340,514,0,658,244656,15.117647058823529
260,344,0,659,245000,13.23076923076923
390,587,0,660,245587,15.051282051282051
310,561,0,661,246148,18.096774193548388
460,769,0,662,246917,16.717391304347824
160,206,0,663,247123,12.875
190,302,0,664,247425,15.894736842105264
130,194,0,665,247619,14.923076923076923
110,169,0,666,247788,15.363636363636363
300,425,0,667,248213,14.166666666666666
250,345,0,668,248558,13.8
330,498,0,669,249056,15.090909090909092
330,565,0,670,249621,17.12121212121212
180,234,0,671,249855,13.0
120,166,0,672,250021,13.833333333333334
250,377,0,673,250398,15.08
150,204,0,674,250602,13.6
220,327,0,675,250929,14.863636363636363
410,585,0,676,251514,14.268292682926829
510,700,0,677,252214,13.72549019607843
260,361,0,678,252575,13.884615384615385
290,405,0,679,252980,13.96551724137931
200,275,0,680,253255,13.75
270,401,0,681,253656,14.851851851851851
180,245,0,682,253901,13.61111111111111
220,345,0,683,254246,15.681818181818182
240,375,0,684,254621,15.625
180,281,0,685,254902,15.61111111111111
310,490,0,686,255392,15.806451612903226
300,413,0,687,255805,13.766666666666667
270,409,0,688,256214,15.148148148148149
40,28,0,689,256242,7.0
320,569,0,690,256811,17.78125
140,224,0,691,257035,16.0
70,100,0,692,257135,14.285714285714286
140,193,0,693,257328,13.785714285714286
310,450,0,694,257778,14.516129032258064
160,189,0,695,257967,11.8125
270,394,0,696,258361,14.592592592592593
230,341,0,697,258702,14.826086956521738
370,518,0,698,259220,14.0
230,338,0,699,259558,14.695652173913043
210,354,0,700,259912,16.857142857142858
210,291,0,701,260203,13.857142857142858
360,552,0,702,260755,15.333333333333334
360,630,0,703,261385,17.5
150,189,0,704,261574,12.6
290,494,0,705,262068,17.03448275862069
270,437,0,706,262505,16.185185185185187
250,336,0,707,262841,13.44
320,394,0,708,263235,12.3125
270,371,0,709,263606,13.74074074074074
180,289,0,710,263895,16.055555555555557
260,338,0,711,264233,13.0
230,335,0,712,264568,14.565217391304348
180,233,0,713,264801,12.944444444444445
190,241,0,714,265042,12.68421052631579
180,281,0,715,265323,15.61111111111111
180,199,0,716,265522,11.055555555555555
300,502,0,717,266024,16.733333333333334
130,213,0,718,266237,16.384615384615383
280,469,0,719,266706,16.75
190,271,0,720,266977,14.263157894736842
410,588,0,721,267565,14.341463414634147
130,195,0,722,267760,15.0
280,399,0,723,268159,14.25
210,268,0,724,268427,12.761904761904763
210,355,0,725,268782,16.904761904761905
110,174,0,726,268956,15.818181818181818
160,296,0,727,269252,18.5
200,212,0,728,269464,10.6
220,352,0,729,269816,16.0
220,326,0,730,270142,14.818181818181818
280,391,0,731,270533,13.964285714285714
220,290,0,732,270823,13.181818181818182
330,490,0,733,271313,14.848484848484848
250,326,0,734,271639,13.04
330,499,0,735,272138,15.121212121212121
80,112,0,736,272250,14.0
230,290,0,737,272540,12.608695652173912
200,287,0,738,272827,14.35
260,414,0,739,273241,15.923076923076923
360,550,0,740,273791,15.277777777777779
300,422,0,741,274213,14.066666666666666
310,405,0,742,274618,13.064516129032258
250,354,0,743,274972,14.16
410,643,0,744,275615,15.682926829268293
70,88,0,745,275703,12.571428571428571
380,614,0,746,276317,16.157894736842106
370,619,0,747,276936,16.72972972972973
290,357,0,748,277293,12.310344827586206
300,395,0,749,277688,13.166666666666666
310,401,0,750,278089,12.935483870967742
280,446,0,751,278535,15.928571428571429
180,301,0,752,278836,16.72222222222222
240,372,0,753,279208,15.5
340,521,0,754,279729,15.323529411764707
290,424,0,755,280153,14.620689655172415
310,518,0,756,280671,16.70967741935484
150,213,0,757,280884,14.2
250,332,0,758,281216,13.28
320,463,0,759,281679,14.46875
220,279,0,760,281958,12.681818181818182
260,398,0,761,282356,15.307692307692308
170,222,0,762,282578,13.058823529411764
350,505,0,763,283083,14.428571428571429
300,463,0,764,283546,15.433333333333334
160,204,0,765,283750,12.75
170,206,0,766,283956,12.117647058823529
380,561,0,767,284517,14.763157894736842
70,87,0,768,284604,12.428571428571429
350,480,0,769,285084,13.714285714285714
250,402,0,770,285486,16.08
80,91,0,771,285577,11.375
160,244,0,772,285821,15.25
260,342,0,773,286163,13.153846153846153
120,125,0,774,286288,10.416666666666666
260,347,0,775,286635,13.346153846153847
320,458,0,776,287093,14.3125
190,261,0,777,287354,13.736842105263158
190,289,0,778,287643,15.210526315789474
140,153,0,779,287796,10.928571428571429
130,140,0,780,287936,10.76923076923077
220,281,0,781,288217,12.772727272727273
190,246,0,782,288463,12.947368421052632
320,485,0,783,288948,15.15625
130,160,0,784,289108,12.307692307692308
410,589,0,785,289697,14.365853658536585
160,186,0,786,289883,11.625
310,556,0,787,290439,17.93548387096774
260,405,0,788,290844,15.576923076923077
270,404,0,789,291248,14.962962962962964
330,481,0,790,291729,14.575757575757576
220,285,0,791,292014,12.954545454545455
330,570,0,792,292584,17.272727272727273
410,574,0,793,293158,14.0
410,606,0,794,293764,14.78048780487805
250,370,0,795,294134,14.8
270,327,0,796,294461,12.11111111111111
420,697,0,797,295158,16.595238095238095
170,198,0,798,295356,11.647058823529411
330,546,0,799,295902,16.545454545454547
290,494,0,800,296396,17.03448275862069
220,250,0,801,296646,11.363636363636363
480,713,0,802,297359,14.854166666666666
130,225,0,803,297584,17.307692307692307
230,284,0,804,297868,12.347826086956522
260,405,0,805,298273,15.576923076923077
400,540,0,806,298813,13.5
300,359,0,807,299172,11.966666666666667
310,529,0,808,299701,17.06451612903226
120,160,0,809,299861,13.333333333333334
330,492,0,810,300353,14.909090909090908
180,254,0,811,300607,14.11111111111111
260,371,0,812,300978,14.26923076923077
270,425,0,813,301403,15.74074074074074
320,534,0,814,301937,16.6875
130,180,0,815,302117,13.846153846153847
190,232,0,816,302349,12.210526315789474
250,358,0,817,302707,14.32
240,353,0,818,303060,14.708333333333334
220,337,0,819,303397,15.318181818181818
210,328,0,820,303725,15.619047619047619
300,468,0,821,304193,15.6
340,486,0,822,304679,14.294117647058824
70,87,0,823,304766,12.428571428571429
290,423,0,824,305189,14.586206896551724
250,331,0,825,305520,13.24
330,512,0,826,306032,15.515151515151516
260,378,0,827,306410,14.538461538461538
240,358,0,828,306768,14.916666666666666
290,398,0,829,307166,13.724137931034482
180,236,0,830,307402,13.11111111111111
140,185,0,831,307587,13.214285714285714
430,654,0,832,308241,15.209302325581396
400,633,0,833,308874,15.825
250,341,0,834,309215,13.64
120,181,0,835,309396,15.083333333333334
190,319,0,836,309715,16.789473684210527
50,66,0,837,309781,13.2
340,565,0,838,310346,16.61764705882353
280,377,0,839,310723,13.464285714285714
180,256,0,840,310979,14.222222222222221
440,607,0,841,311586,13.795454545454545
290,428,0,842,312014,14.758620689655173
210,264,0,843,312278,12.571428571428571
80,98,0,844,312376,12.25
110,158,0,845,312534,14.363636363636363
280,396,0,846,312930,14.142857142857142
170,284,0,847,313214,16.705882352941178
290,539,0,848,313753,18.586206896551722
340,552,0,849,314305,16.235294117647058
140,206,0,850,314511,14.714285714285714
280,422,0,851,314933,15.071428571428571
180,267,0,852,315200,14.833333333333334
280,429,0,853,315629,15.321428571428571
210,247,0,854,315876,11.761904761904763
290,400,0,855,316276,13.793103448275861
130,173,0,856,316449,13.307692307692308
260,373,0,857,316822,14.346153846153847
120,169,0,858,316991,14.083333333333334
340,572,0,859,317563,16.823529411764707
240,280,0,860,317843,11.666666666666666
420,712,0,861,318555,16.952380952380953
400,681,0,862,319236,17.025
190,278,0,863,319514,14.631578947368421
210,232,0,864,319746,11.047619047619047
330,545,0,865,320291,16.515151515151516
390,553,0,866,320844,14.179487179487179
350,570,0,867,321414,16.285714285714285
270,448,0,868,321862,16.59259259259259
200,286,0,869,322148,14.3
190,243,0,870,322391,12.789473684210526
250,394,0,871,322785,15.76
310,524,0,872,323309,16.903225806451612
170,216,0,873,323525,12.705882352941176
240,391,0,874,323916,16.291666666666668
260,365,0,875,324281,14.038461538461538
280,420,0,876,324701,15.0
160,178,0,877,324879,11.125
460,729,0,878,325608,15.847826086956522
270,405,0,879,326013,15.0
260,340,0,880,326353,13.076923076923077
270,402,0,881,326755,14.88888888888889
220,334,0,882,327089,15.181818181818182
150,224,0,883,327313,14.933333333333334
120,154,0,884,327467,12.833333333333334
210,264,0,885,327731,12.571428571428571
220,298,0,886,328029,13.545454545454545
360,563,0,887,328592,15.63888888888889
320,478,0,888,329070,14.9375
240,356,0,889,329426,14.833333333333334
390,689,0,890,330115,17.666666666666668
170,231,0,891,330346,13.588235294117647
240,378,0,892,330724,15.75
110,105,0,893,330829,9.545454545454545
280,399,0,894,331228,14.25
170,234,0,895,331462,13.764705882352942
270,427,0,896,331889,15.814814814814815
310,424,0,897,332313,13.67741935483871
140,234,0,898,332547,16.714285714285715
230,407,0,899,332954,17.695652173913043
340,470,0,900,333424,13.823529411764707
340,490,0,901,333914,14.411764705882353
130,172,0,902,334086,13.23076923076923
230,348,0,903,334434,15.130434782608695
190,235,0,904,334669,12.368421052631579
230,321,0,905,334990,13.956521739130435
120,111,0,906,335101,9.25
170,273,0,907,335374,16.058823529411764
330,457,0,908,335831,13.848484848484848
390,529,0,909,336360,13.564102564102564
300,589,0,910,336949,19.633333333333333
410,589,0,911,337538,14.365853658536585
320,493,0,912,338031,15.40625
330,495,0,913,338526,15.0
120,144,0,914,338670,12.0
250,310,0,915,338980,12.4
510,705,0,916,339685,13.823529411764707
460,791,0,917,340476,17.195652173913043
70,106,0,918,340582,15.142857142857142
440,683,0,919,341265,15.522727272727273
310,479,0,920,341744,15.451612903225806
330,522,0,921,342266,15.818181818181818
450,699,0,922,342965,15.533333333333333
330,479,0,923,343444,14.515151515151516
310,426,0,924,343870,13.741935483870968
190,290,0,925,344160,15.263157894736842
150,195,0,926,344355,13.0
410,653,0,927,345008,15.926829268292684
390,708,0,928,345716,18.153846153846153
140,171,0,929,345887,12.214285714285714
160,212,0,930,346099,13.25
250,308,0,931,346407,12.32
280,456,0,932,346863,16.285714285714285
190,262,0,933,347125,13.789473684210526
370,542,0,934,347667,14.64864864864865
210,305,0,935,347972,14.523809523809524
330,596,0,936,348568,18.060606060606062
260,367,0,937,348935,14.115384615384615
320,428,0,938,349363,13.375
190,272,0,939,349635,14.31578947368421
250,356,0,940,349991,14.24
370,557,0,941,350548,15.054054054054054
490,760,0,942,351308,15.510204081632653
220,320,0,943,351628,14.545454545454545
200,252,0,944,351880,12.6
230,389,0,945,352269,16.91304347826087
200,310,0,946,352579,15.5
190,237,0,947,352816,12.473684210526315
180,285,0,948,353101,15.833333333333334
230,326,0,949,353427,14.173913043478262
200,315,0,950,353742,15.75
450,597,0,951,354339,13.266666666666667
260,382,0,952,354721,14.692307692307692
250,383,0,953,355104,15.32
190,327,0,954,355431,17.210526315789473
250,423,0,955,355854,16.92
350,535,0,956,356389,15.285714285714286
260,380,0,957,356769,14.615384615384615
340,454,0,958,357223,13.352941176470589
150,236,0,959,357459,15.733333333333333
270,412,0,960,357871,15.25925925925926
170,240,0,961,358111,14.117647058823529
440,809,0,962,358920,18.386363636363637
200,378,0,963,359298,18.9
380,574,0,964,359872,15.105263157894736
330,504,0,965,360376,15.272727272727273
180,285,0,966,360661,15.833333333333334
280,491,0,967,361152,17.535714285714285
140,162,0,968,361314,11.571428571428571
230,290,0,969,361604,12.608695652173912
180,249,0,970,361853,13.833333333333334
240,389,0,971,362242,16.208333333333332
170,285,0,972,362527,16.764705882352942
280,343,0,973,362870,12.25
260,465,0,974,363335,17.884615384615383
350,740,0,975,364075,21.142857142857142
150,187,0,976,364262,12.466666666666667
200,257,0,977,364519,12.85
220,405,0,978,364924,18.40909090909091
200,291,0,979,365215,14.55
400,636,0,980,365851,15.9
240,377,0,981,366228,15.708333333333334
470,752,0,982,366980,16.0
140,167,0,983,367147,11.928571428571429
250,391,0,984,367538,15.64
210,286,0,985,367824,13.619047619047619
250,360,0,986,368184,14.4
180,257,0,987,368441,14.277777777777779
80,78,0,988,368519,9.75
310,489,0,989,369008,15.774193548387096
190,255,0,990,369263,13.421052631578947
260,382,0,991,369645,14.692307692307692
190,243,0,992,369888,12.789473684210526
140,227,0,993,370115,16.214285714285715
220,318,0,994,370433,14.454545454545455
300,454,0,995,370887,15.133333333333333
260,323,0,996,371210,12.423076923076923
250,412,0,997,371622,16.48
190,267,0,998,371889,14.052631578947368
300,435,0,999,372324,14.5
150,225,0,1000,372549,15.0
400,653,0,1001,373202,16.325
430,641,0,1002,373843,14.906976744186046
260,372,0,1003,374215,14.307692307692308
210,329,0,1004,374544,15.666666666666666
220,372,0,1005,374916,16.90909090909091
180,285,0,1006,375201,15.833333333333334
250,383,0,1007,375584,15.32
200,299,0,1008,375883,14.95
240,393,0,1009,376276,16.375
160,216,0,1010,376492,13.5
180,242,0,1011,376734,13.444444444444445
220,282,0,1012,377016,12.818181818181818
380,521,0,1013,377537,13.710526315789474
230,288,0,1014,377825,12.521739130434783
340,598,0,1015,378423,17.58823529411765
190,250,0,1016,378673,13.157894736842104
310,528,0,1017,379201,17.032258064516128
200,259,0,1018,379460,12.95
160,226,0,1019,379686,14.125
270,457,0,1020,380143,16.925925925925927
250,369,0,1021,380512,14.76
350,610,0,1022,381122,17.428571428571427
290,432,0,1023,381554,14.89655172413793
240,367,0,1024,381921,15.291666666666666
80,156,0,1025,382077,19.5
270,337,0,1026,382414,12.481481481481481
190,291,0,1027,382705,15.31578947368421
150,260,0,1028,382965,17.333333333333332
280,399,0,1029,383364,14.25
430,679,0,1030,384043,15.790697674418604
150,235,0,1031,384278,15.666666666666666
300,428,0,1032,384706,14.266666666666667
280,418,0,1033,385124,14.928571428571429
350,488,0,1034,385612,13.942857142857143
240,300,0,1035,385912,12.5
220,275,0,1036,386187,12.5
210,307,0,1037,386494,14.619047619047619
370,589,0,1038,387083,15.91891891891892
150,250,0,1039,387333,16.666666666666668
200,307,0,1040,387640,15.35
330,467,0,1041,388107,14.151515151515152
180,230,0,1042,388337,12.777777777777779
300,503,0,1043,388840,16.766666666666666
180,237,0,1044,389077,13.166666666666666
200,288,0,1045,389365,14.4
270,446,0,1046,389811,16.51851851851852
160,220,0,1047,390031,13.75
160,225,0,1048,390256,14.0625
210,306,0,1049,390562,14.571428571428571
240,385,0,1050,390947,16.041666666666668
460,732,0,1051,391679,15.91304347826087
500,870,0,1052,392549,17.4
220,323,0,1053,392872,14.681818181818182
190,314,0,1054,393186,16.526315789473685
260,372,0,1055,393558,14.307692307692308
210,263,0,1056,393821,12.523809523809524
260,369,0,1057,394190,14.192307692307692
100,118,0,1058,394308,11.8
310,450,0,1059,394758,14.516129032258064
350,518,0,1060,395276,14.8
360,435,0,1061,395711,12.083333333333334
140,243,0,1062,395954,17.357142857142858
350,534,0,1063,396488,15.257142857142858
280,395,0,1064,396883,14.107142857142858
180,208,0,1065,397091,11.555555555555555
290,438,0,1066,397529,15.10344827586207
140,171,0,1067,397700,12.214285714285714
290,460,0,1068,398160,15.862068965517242
390,594,0,1069,398754,15.23076923076923
200,304,0,1070,399058,15.2
190,258,0,1071,399316,13.578947368421053
170,281,0,1072,399597,16.529411764705884
340,548,0,1073,400145,16.11764705882353
370,646,0,1074,400791,17.45945945945946
100,162,0,1075,400953,16.2
240,334,0,1076,401287,13.916666666666666
270,396,0,1077,401683,14.666666666666666
270,441,0,1078,402124,16.333333333333332
310,437,0,1079,402561,14.096774193548388
250,389,0,1080,402950,15.56
240,413,0,1081,403363,17.208333333333332
320,482,0,1082,403845,15.0625
160,240,0,1083,404085,15.0
240,335,0,1084,404420,13.958333333333334
120,123,0,1085,404543,10.25
250,390,0,1086,404933,15.6
230,373,0,1087,405306,16.217391304347824
260,476,0,1088,405782,18.307692307692307
210,281,0,1089,406063,13.380952380952381
280,472,0,1090,406535,16.857142857142858
140,246,0,1091,406781,17.571428571428573
160,235,0,1092,407016,14.6875
120,185,0,1093,407201,15.416666666666666
90,142,0,1094,407343,15.777777777777779
380,670,0,1095,408013,17.63157894736842
190,251,0,1096,408264,13.210526315789474
150,194,0,1097,408458,12.933333333333334
200,280,0,1098,408738,14.0
290,486,0,1099,409224,16.75862068965517
360,578,0,1100,409802,16.055555555555557
410,639,0,1101,410441,15.585365853658537
330,509,0,1102,410950,15.424242424242424
220,278,0,1103,411228,12.636363636363637
120,181,0,1104,411409,15.083333333333334
190,312,0,1105,411721,16.42105263157895
180,212,0,1106,411933,11.777777777777779
290,433,0,1107,412366,14.931034482758621
120,133,0,1108,412499,11.083333333333334
260,344,0,1109,412843,13.23076923076923
230,397,0,1110,413240,17.26086956521739
140,215,0,1111,413455,15.357142857142858
280,424,0,1112,413879,15.142857142857142
400,601,0,1113,414480,15.025
370,586,0,1114,415066,15.837837837837839
300,451,0,1115,415517,15.033333333333333
150,221,0,1116,415738,14.733333333333333
190,259,0,1117,415997,13.631578947368421
340,560,0,1118,416557,16.470588235294116
240,374,0,1119,416931,15.583333333333334
200,304,0,1120,417235,15.2
210,285,0,1121,417520,13.571428571428571
220,336,0,1122,417856,15.272727272727273
340,552,0,1123,418408,16.235294117647058
200,313,0,1124,418721,15.65
310,499,0,1125,419220,16.096774193548388
270,360,0,1126,419580,13.333333333333334
230,346,0,1127,419926,15.043478260869565
230,301,0,1128,420227,13.08695652173913
260,384,0,1129,420611,14.76923076923077
180,270,0,1130,420881,15.0
200,272,0,1131,421153,13.6
180,275,0,1132,421428,15.277777777777779
250,342,0,1133,421770,13.68
130,145,0,1134,421915,11.153846153846153
270,414,0,1135,422329,15.333333333333334
300,465,0,1136,422794,15.5
250,371,0,1137,423165,14.84
390,549,0,1138,423714,14.076923076923077
430,750,0,1139,424464,17.441860465116278
310,441,0,1140,424905,14.225806451612904
140,223,0,1141,425128,15.928571428571429
270,410,0,1142,425538,15.185185185185185
360,493,0,1143,426031,13.694444444444445
150,207,0,1144,426238,13.8
330,484,0,1145,426722,14.666666666666666
360,573,0,1146,427295,15.916666666666666
170,227,0,1147,427522,13.352941176470589
270,420,0,1148,427942,15.555555555555555
160,228,0,1149,428170,14.25
440,664,0,1150,428834,15.090909090909092
90,125,0,1151,428959,13.88888888888889
250,357,0,1152,429316,14.28
320,498,0,1153,429814,15.5625
220,308,0,1154,430122,14.0
190,273,0,1155,430395,14.368421052631579
160,237,0,1156,430632,14.8125
230,324,0,1157,430956,14.08695652173913
170,263,0,1158,431219,15.470588235294118
230,349,0,1159,431568,15.173913043478262
160,236,0,1160,431804,14.75
320,451,0,1161,432255,14.09375
210,263,0,1162,432518,12.523809523809524
290,436,0,1163,432954,15.03448275862069
170,266,0,1164,433220,15.647058823529411
390,600,0,1165,433820,15.384615384615385
310,415,0,1166,434235,13.387096774193548
390,588,0,1167,434823,15.076923076923077
130,182,0,1168,435005,14.0
130,215,0,1169,435220,16.53846153846154
200,278,0,1170,435498,13.9
210,356,0,1171,435854,16.952380952380953
130,159,0,1172,436013,12.23076923076923
440,632,0,1173,436645,14.363636363636363
280,372,0,1174,437017,13.285714285714286
240,351,0,1175,437368,14.625
330,508,0,1176,437876,15.393939393939394
230,363,0,1177,438239,15.782608695652174
370,625,0,1178,438864,16.89189189189189
350,465,0,1179,439329,13.285714285714286
470,716,0,1180,440045,15.23404255319149
160,260,0,1181,440305,16.25
280,424,0,1182,440729,15.142857142857142
120,141,0,1183,440870,11.75
390,716,0,1184,441586,18.358974358974358
240,372,0,1185,441958,15.5
260,381,0,1186,442339,14.653846153846153
180,234,0,1187,442573,13.0
80,95,0,1188,442668,11.875
340,559,0,1189,443227,16.441176470588236
170,225,0,1190,443452,13.235294117647058
290,395,0,1191,443847,13.620689655172415
410,699,0,1192,444546,17.048780487804876
240,324,0,1193,444870,13.5
330,523,0,1194,445393,15.848484848484848
200,230,0,1195,445623,11.5
190,215,0,1196,445838,11.31578947368421
410,629,0,1197,446467,15.341463414634147
310,464,0,1198,446931,14.96774193548387
350,531,0,1199,447462,15.17142857142857
280,458,0,1200,447920,16.357142857142858
310,456,0,1201,448376,14.709677419354838
110,128,0,1202,448504,11.636363636363637
290,380,0,1203,448884,13.10344827586207
220,323,0,1204,449207,14.681818181818182
330,488,0,1205,449695,14.787878787878787
290,448,0,1206,450143,15.448275862068966
260,388,0,1207,450531,14.923076923076923
440,739,0,1208,451270,16.795454545454547
130,152,0,1209,451422,11.692307692307692
180,177,0,1210,451599,9.833333333333334
460,615,0,1211,452214,13.369565217391305
190,244,0,1212,452458,12.842105263157896
170,227,0,1213,452685,13.352941176470589
220,316,0,1214,453001,14.363636363636363
290,456,0,1215,453457,15.724137931034482
320,480,0,1216,453937,15.0
170,276,0,1217,454213,16.235294117647058
570,912,0,1218,455125,16.0
160,228,0,1219,455353,14.25
250,369,0,1220,455722,14.76
280,454,0,1221,456176,16.214285714285715
320,466,0,1222,456642,14.5625
260,342,0,1223,456984,13.153846153846153
180,257,0,1224,457241,14.277777777777779
500,828,0,1225,458069,16.56
190,328,0,1226,458397,17.263157894736842
150,233,0,1227,458630,15.533333333333333
510,835,0,1228,459465,16.372549019607842
200,267,0,1229,459732,13.35
180,229,0,1230,459961,12.722222222222221
310,455,0,1231,460416,14.67741935483871
220,315,0,1232,460731,14.318181818181818
470,737,0,1233,461468,15.680851063829786
120,184,0,1234,461652,15.333333333333334
240,382,0,1235,462034,15.916666666666666
210,263,0,1236,462297,12.523809523809524
110,140,0,1237,462437,12.727272727272727
270,497,0,1238,462934,18.40740740740741
230,375,0,1239,463309,16.304347826086957
360,607,0,1240,463916,16.86111111111111
310,476,0,1241,464392,15.35483870967742
260,379,0,1242,464771,14.576923076923077
390,627,0,1243,465398,16.076923076923077
260,426,0,1244,465824,16.384615384615383
270,374,0,1245,466198,13.851851851851851
220,308,0,1246,466506,14.0
340,546,0,1247,467052,16.058823529411764
270,377,0,1248,467429,13.962962962962964
130,192,0,1249,467621,14.76923076923077
200,258,0,1250,467879,12.9
300,483,0,1251,468362,16.1
220,335,0,1252,468697,15.227272727272727
220,358,0,1253,469055,16.272727272727273
220,290,0,1254,469345,13.181818181818182
280,455,0,1255,469800,16.25
100,120,0,1256,469920,12.0
130,147,0,1257,470067,11.307692307692308
160,258,0,1258,470325,16.125
200,247,0,1259,470572,12.35
360,578,0,1260,471150,16.055555555555557
320,494,0,1261,471644,15.4375
210,351,0,1262,471995,16.714285714285715
170,272,0,1263,472267,16.0
370,598,0,1264,472865,16.16216216216216
300,441,0,1265,473306,14.7
240,341,0,1266,473647,14.208333333333334
360,501,0,1267,474148,13.916666666666666
200,265,0,1268,474413,13.25
370,548,0,1269,474961,14.81081081081081
220,352,0,1270,475313,16.0
300,437,0,1271,475750,14.566666666666666
110,145,0,1272,475895,13.181818181818182
200,322,0,1273,476217,16.1
180,249,0,1274,476466,13.833333333333334
380,572,0,1275,477038,15.052631578947368
290,460,0,1276,477498,15.862068965517242
80,123,0,1277,477621,15.375
360,512,0,1278,478133,14.222222222222221
250,359,0,1279,478492,14.36
100,157,0,1280,478649,15.7
330,461,0,1281,479110,13.969696969696969
220,390,0,1282,479500,17.727272727272727
280,490,0,1283,479990,17.5
190,275,0,1284,480265,14.473684210526315
90,123,0,1285,480388,13.666666666666666
230,298,0,1286,480686,12.956521739130435
360,536,0,1287,481222,14.88888888888889
210,332,0,1288,481554,15.80952380952381
80,83,0,1289,481637,10.375
150,243,0,1290,481880,16.2
160,202,0,1291,482082,12.625
190,263,0,1292,482345,13.842105263157896
320,510,0,1293,482855,15.9375
180,231,0,1294,483086,12.833333333333334
270,433,0,1295,483519,16.037037037037038
240,314,0,1296,483833,13.083333333333334
170,236,0,1297,484069,13.882352941176471
300,480,0,1298,484549,16.0
270,408,0,1299,484957,15.11111111111111
420,659,0,1300,485616,15.69047619047619
220,318,0,1301,485934,14.454545454545455
210,255,0,1302,486189,12.142857142857142
280,365,0,1303,486554,13.035714285714286
400,578,0,1304,487132,14.45
280,427,0,1305,487559,15.25
320,428,0,1306,487987,13.375
330,566,0,1307,488553,17.151515151515152
370,560,0,1308,489113,15.135135135135135
250,449,0,1309,489562,17.96
320,465,0,1310,490027,14.53125
200,304,0,1311,490331,15.2
200,245,0,1312,490576,12.25
260,380,0,1313,490956,14.615384615384615
230,367,0,1314,491323,15.956521739130435
340,437,0,1315,491760,12.852941176470589
450,757,0,1316,492517,16.822222222222223
240,335,0,1317,492852,13.958333333333334
340,545,0,1318,493397,16.029411764705884
240,338,0,1319,493735,14.083333333333334
230,358,0,1320,494093,15.565217391304348
230,363,0,1321,494456,15.782608695652174
350,518,0,1322,494974,14.8
230,319,0,1323,495293,13.869565217391305
230,363,0,1324,495656,15.782608695652174
280,370,0,1325,496026,13.214285714285714
180,229,0,1326,496255,12.722222222222221
220,322,0,1327,496577,14.636363636363637
280,419,0,1328,496996,14.964285714285714
150,197,0,1329,497193,13.133333333333333
400,575,0,1330,497768,14.375
160,283,0,1331,498051,17.6875
170,319,0,1332,498370,18.764705882352942
260,350,0,1333,498720,13.461538461538462
170,238,0,1334,498958,14.0
170,262,0,1335,499220,15.411764705882353
380,533,0,1336,499753,14.026315789473685
170,261,0,1337,500014,15.352941176470589
220,312,0,1338,500326,14.181818181818182
160,224,0,1339,500550,14.0
210,297,0,1340,500847,14.142857142857142
210,337,0,1341,501184,16.047619047619047
180,288,0,1342,501472,16.0
300,478,0,1343,501950,15.933333333333334
110,174,0,1344,502124,15.818181818181818
390,576,0,1345,502700,14.76923076923077
230,274,0,1346,502974,11.91304347826087
210,265,0,1347,503239,12.619047619047619
410,657,0,1348,503896,16.024390243902438
150,165,0,1349,504061,11.0
140,189,0,1350,504250,13.5
150,173,0,1351,504423,11.533333333333333
240,348,0,1352,504771,14.5
250,316,0,1353,505087,12.64
230,346,0,1354,505433,15.043478260869565
190,248,0,1355,505681,13.052631578947368
230,384,0,1356,506065,16.695652173913043
130,180,0,1357,506245,13.846153846153847
360,621,0,1358,506866,17.25
280,409,0,1359,507275,14.607142857142858
200,283,0,1360,507558,14.15
100,114,0,1361,507672,11.4
170,236,0,1362,507908,13.882352941176471
210,350,0,1363,508258,16.666666666666668
250,415,0,1364,508673,16.6
380,504,0,1365,509177,13.263157894736842
130,190,0,1366,509367,14.615384615384615
260,373,0,1367,509740,14.346153846153847
240,314,0,1368,510054,13.083333333333334
270,414,0,1369,510468,15.333333333333334
260,382,0,1370,510850,14.692307692307692
290,410,0,1371,511260,14.137931034482758
600,1009,0,1372,512269,16.816666666666666
410,579,0,1373,512848,14.121951219512194
360,495,0,1374,513343,13.75
200,212,0,1375,513555,10.6
300,484,0,1376,514039,16.133333333333333
380,532,0,1377,514571,14.0
210,336,0,1378,514907,16.0
150,156,0,1379,515063,10.4
100,149,0,1380,515212,14.9
400,575,0,1381,515787,14.375
150,220,0,1382,516007,14.666666666666666
210,294,0,1383,516301,14.0
200,267,0,1384,516568,13.35
310,451,0,1385,517019,14.548387096774194
240,341,0,1386,517360,14.208333333333334
240,300,0,1387,517660,12.5
570,900,0,1388,518560,15.789473684210526
270,379,0,1389,518939,14.037037037037036
210,228,0,1390,519167,10.857142857142858
220,342,0,1391,519509,15.545454545454545
230,359,0,1392,519868,15.608695652173912
300,459,0,1393,520327,15.3
190,361,0,1394,520688,19.0
220,328,0,1395,521016,14.909090909090908
280,420,0,1396,521436,15.0
370,637,0,1397,522073,17.216216216216218
170,211,0,1398,522284,12.411764705882353
270,452,0,1399,522736,16.74074074074074
100,168,0,1400,522904,16.8
150,224,0,1401,523128,14.933333333333334
130,138,0,1402,523266,10.615384615384615
410,697,0,1403,523963,17.0
260,425,0,1404,524388,16.346153846153847
150,204,0,1405,524592,13.6
180,245,0,1406,524837,13.61111111111111
170,271,0,1407,525108,15.941176470588236
190,256,0,1408,525364,13.473684210526315
140,198,0,1409,525562,14.142857142857142
320,562,0,1410,526124,17.5625
200,295,0,1411,526419,14.75
450,694,0,1412,527113,15.422222222222222
430,666,0,1413,527779,15.488372093023257
310,515,0,1414,528294,16.612903225806452
340,486,0,1415,528780,14.294117647058824
160,186,0,1416,528966,11.625
290,457,0,1417,529423,15.758620689655173
240,451,0,1418,529874,18.791666666666668
300,523,0,1419,530397,17.433333333333334
190,251,0,1420,530648,13.210526315789474
210,257,0,1421,530905,12.238095238095237
320,500,0,1422,531405,15.625
290,452,0,1423,531857,15.586206896551724
190,278,0,1424,532135,14.631578947368421
150,225,0,1425,532360,15.0
210,301,0,1426,532661,14.333333333333334
370,534,0,1427,533195,14.432432432432432
160,256,0,1428,533451,16.0
230,355,0,1429,533806,15.434782608695652
300,441,0,1430,534247,14.7
310,437,0,1431,534684,14.096774193548388
340,517,0,1432,535201,15.205882352941176
390,578,0,1433,535779,14.820512820512821
190,265,0,1434,536044,13.947368421052632
150,229,0,1435,536273,15.266666666666667
170,240,0,1436,536513,14.117647058823529
340,572,0,1437,537085,16.823529411764707
280,463,0,1438,537548,16.535714285714285
290,472,0,1439,538020,16.275862068965516
390,676,0,1440,538696,17.333333333333332
410,633,0,1441,539329,15.439024390243903
310,450,0,1442,539779,14.516129032258064
260,336,0,1443,540115,12.923076923076923
200,327,0,1444,540442,16.35
180,252,0,1445,540694,14.0
190,252,0,1446,540946,13.263157894736842
290,457,0,1447,541403,15.758620689655173
220,279,0,1448,541682,12.681818181818182
320,501,0,1449,542183,15.65625
150,219,0,1450,542402,14.6
370,614,0,1451,543016,16.594594594594593
230,374,0,1452,543390,16.26086956521739
190,316,0,1453,543706,16.63157894736842
250,351,0,1454,544057,14.04
80,107,0,1455,544164,13.375
420,617,0,1456,544781,14.69047619047619
160,156,0,1457,544937,9.75
90,124,0,1458,545061,13.777777777777779
330,493,0,1459,545554,14.93939393939394
240,320,0,1460,545874,13.333333333333334
310,487,0,1461,546361,15.709677419354838
250,356,0,1462,546717,14.24
260,362,0,1463,547079,13.923076923076923
170,256,0,1464,547335,15.058823529411764
100,114,0,1465,547449,11.4
230,338,0,1466,547787,14.695652173913043
150,229,0,1467,548016,15.266666666666667
250,376,0,1468,548392,15.04
110,163,0,1469,548555,14.818181818181818
310,441,0,1470,548996,14.225806451612904
320,441,0,1471,549437,13.78125
130,137,0,1472,549574,10.538461538461538
260,364,0,1473,549938,14.0
220,301,0,1474,550239,13.681818181818182
360,534,0,1475,550773,14.833333333333334
310,460,0,1476,551233,14.838709677419354
160,206,0,1477,551439,12.875
210,280,0,1478,551719,13.333333333333334
400,554,0,1479,552273,13.85
140,209,0,1480,552482,14.928571428571429
230,302,0,1481,552784,13.130434782608695
180,284,0,1482,553068,15.777777777777779
260,372,0,1483,553440,14.307692307692308
150,301,0,1484,553741,20.066666666666666
210,291,0,1485,554032,13.857142857142858
100,108,0,1486,554140,10.8
480,677,0,1487,554817,14.104166666666666
450,601,0,1488,555418,13.355555555555556
350,590,0,1489,556008,16.857142857142858
240,370,0,1490,556378,15.416666666666666
160,239,0,1491,556617,14.9375
120,174,0,1492,556791,14.5
250,360,0,1493,557151,14.4
250,462,0,1494,557613,18.48
150,192,0,1495,557805,12.8
190,381,0,1496,558186,20.05263157894737
420,647,0,1497,558833,15.404761904761905
200,302,0,1498,559135,15.1
240,399,0,1499,559534,16.625
240,341,0,1500,559875,14.208333333333334
210,296,0,1501,560171,14.095238095238095
200,254,0,1502,560425,12.7
380,528,0,1503,560953,13.894736842105264
330,457,0,1504,561410,13.848484848484848
160,257,0,1505,561667,16.0625
350,444,0,1506,562111,12.685714285714285
370,576,0,1507,562687,15.567567567567568
170,250,0,1508,562937,14.705882352941176
460,709,0,1509,563646,15.41304347826087
350,548,0,1510,564194,15.657142857142857
200,348,0,1511,564542,17.4
320,454,0,1512,564996,14.1875
190,317,0,1513,565313,16.68421052631579
150,186,0,1514,565499,12.4
60,85,0,1515,565584,14.166666666666666
480,685,0,1516,566269,14.270833333333334
400,651,0,1517,566920,16.275
180,301,0,1518,567221,16.72222222222222
180,215,0,1519,567436,11.944444444444445
180,254,0,1520,567690,14.11111111111111
250,315,0,1521,568005,12.6
190,300,0,1522,568305,15.789473684210526
280,421,0,1523,568726,15.035714285714286
220,284,0,1524,569010,12.909090909090908
300,497,0,1525,569507,16.566666666666666
290,525,0,1526,570032,18.103448275862068
90,165,0,1527,570197,18.333333333333332
270,344,0,1528,570541,12.74074074074074
200,294,0,1529,570835,14.7
90,108,0,1530,570943,12.0
160,237,0,1531,571180,14.8125
270,344,0,1532,571524,12.74074074074074
360,609,0,1533,572133,16.916666666666668
250,371,0,1534,572504,14.84
380,679,0,1535,573183,17.86842105263158
310,386,0,1536,573569,12.451612903225806
520,838,0,1537,574407,16.115384615384617
340,605,0,1538,575012,17.794117647058822
300,444,0,1539,575456,14.8
300,387,0,1540,575843,12.9
160,262,0,1541,576105,16.375
250,408,0,1542,576513,16.32
280,387,0,1543,576900,13.821428571428571
400,535,0,1544,577435,13.375
410,666,0,1545,578101,16.24390243902439
190,218,0,1546,578319,11.473684210526315
210,289,0,1547,578608,13.761904761904763
520,886,0,1548,579494,17.03846153846154
240,389,0,1549,579883,16.208333333333332
180,206,0,1550,580089,11.444444444444445
290,431,0,1551,580520,14.862068965517242
220,308,0,1552,580828,14.0
310,430,0,1553,581258,13.870967741935484
160,195,0,1554,581453,12.1875
180,237,0,1555,581690,13.166666666666666
290,440,0,1556,582130,15.172413793103448
410,676,0,1557,582806,16.48780487804878
240,357,0,1558,583163,14.875
220,317,0,1559,583480,14.409090909090908
250,375,0,1560,583855,15.0
240,358,0,1561,584213,14.916666666666666
250,369,0,1562,584582,14.76
190,287,0,1563,584869,15.105263157894736
220,327,0,1564,585196,14.863636363636363
340,452,0,1565,585648,13.294117647058824
120,179,0,1566,585827,14.916666666666666
190,231,0,1567,586058,12.157894736842104
290,395,0,1568,586453,13.620689655172415
380,666,0,1569,587119,17.526315789473685
280,333,0,1570,587452,11.892857142857142
80,91,0,1571,587543,11.375
410,665,0,1572,588208,16.21951219512195
230,295,0,1573,588503,12.826086956521738
380,632,0,1574,589135,16.63157894736842
160,221,0,1575,589356,13.8125
280,386,0,1576,589742,13.785714285714286
170,221,0,1577,589963,13.0
270,411,0,1578,590374,15.222222222222221
150,204,0,1579,590578,13.6
300,437,0,1580,591015,14.566666666666666
290,496,0,1581,591511,17.103448275862068
240,364,0,1582,591875,15.166666666666666
140,212,0,1583,592087,15.142857142857142
210,286,0,1584,592373,13.619047619047619
140,163,0,1585,592536,11.642857142857142
120,160,0,1586,592696,13.333333333333334
270,421,0,1587,593117,15.592592592592593
410,711,0,1588,593828,17.341463414634145
290,476,0,1589,594304,16.413793103448278
280,396,0,1590,594700,14.142857142857142
330,503,0,1591,595203,15.242424242424242
140,177,0,1592,595380,12.642857142857142
130,196,0,1593,595576,15.076923076923077
300,494,0,1594,596070,16.466666666666665
210,288,0,1595,596358,13.714285714285714
250,394,0,1596,596752,15.76
370,614,0,1597,597366,16.594594594594593
170,295,0,1598,597661,17.352941176470587
210,273,0,1599,597934,13.0
270,341,0,1600,598275,12.62962962962963
210,320,0,1601,598595,15.238095238095237
220,320,0,1602,598915,14.545454545454545
450,699,0,1603,599614,15.533333333333333
180,281,0,1604,599895,15.61111111111111
230,306,0,1605,600201,13.304347826086957
270,393,0,1606,600594,14.555555555555555
270,359,0,1607,600953,13.296296296296296
230,318,0,1608,601271,13.826086956521738
120,188,0,1609,601459,15.666666666666666
330,568,0,1610,602027,17.21212121212121
410,649,0,1611,602676,15.829268292682928
280,457,0,1612,603133,16.321428571428573
300,404,0,1613,603537,13.466666666666667
260,442,0,1614,603979,17.0
290,398,0,1615,604377,13.724137931034482
260,380,0,1616,604757,14.615384615384615
250,341,0,1617,605098,13.64
380,570,0,1618,605668,15.0
370,635,0,1619,606303,17.16216216216216
290,422,0,1620,606725,14.551724137931034
130,178,0,1621,606903,13.692307692307692
240,399,0,1622,607302,16.625
130,148,0,1623,607450,11.384615384615385
190,242,0,1624,607692,12.736842105263158
320,450,0,1625,608142,14.0625
200,262,0,1626,608404,13.1
150,286,0,1627,608690,19.066666666666666
310,440,0,1628,609130,14.193548387096774
260,450,0,1629,609580,17.307692307692307
270,393,0,1630,609973,14.555555555555555
450,819,0,1631,610792,18.2
210,313,0,1632,611105,14.904761904761905
180,276,0,1633,611381,15.333333333333334
220,333,0,1634,611714,15.136363636363637
140,203,0,1635,611917,14.5
420,683,0,1636,612600,16.261904761904763
130,168,0,1637,612768,12.923076923076923
90,108,0,1638,612876,12.0
100,131,0,1639,613007,13.1
270,366,0,1640,613373,13.555555555555555
340,552,0,1641,613925,16.235294117647058
310,423,0,1642,614348,13.64516129032258
380,600,0,1643,614948,15.789473684210526
210,277,0,1644,615225,13.19047619047619
230,363,0,1645,615588,15.782608695652174
140,176,0,1646,615764,12.571428571428571
270,371,0,1647,616135,13.74074074074074
460,644,0,1648,616779,14.0
360,534,0,1649,617313,14.833333333333334
340,536,0,1650,617849,15.764705882352942
120,190,0,1651,618039,15.833333333333334
480,696,0,1652,618735,14.5
140,189,0,1653,618924,13.5
360,403,0,1654,619327,11.194444444444445
360,552,0,1655,619879,15.333333333333334
280,363,0,1656,620242,12.964285714285714
140,203,0,1657,620445,14.5
270,411,0,1658,620856,15.222222222222221
290,401,0,1659,621257,13.827586206896552
210,327,0,1660,621584,15.571428571428571
450,666,0,1661,622250,14.8
140,191,0,1662,622441,13.642857142857142
350,528,0,1663,622969,15.085714285714285
390,727,0,1664,623696,18.641025641025642
340,423,0,1665,624119,12.441176470588236
290,413,0,1666,624532,14.241379310344827
440,560,0,1667,625092,12.727272727272727
280,483,0,1668,625575,17.25
350,516,0,1669,626091,14.742857142857142
310,453,0,1670,626544,14.612903225806452
390,546,0,1671,627090,14.0
340,517,0,1672,627607,15.205882352941176
240,276,0,1673,627883,11.5
280,405,0,1674,628288,14.464285714285714
220,352,0,1675,628640,16.0
440,626,0,1676,629266,14.227272727272727
140,206,0,1677,629472,14.714285714285714
130,184,0,1678,629656,14.153846153846153
350,507,0,1679,630163,14.485714285714286
290,405,0,1680,630568,13.96551724137931
210,279,0,1681,630847,13.285714285714286
140,186,0,1682,631033,13.285714285714286
220,355,0,1683,631388,16.136363636363637
170,217,0,1684,631605,12.764705882352942
360,587,0,1685,632192,16.305555555555557
400,656,0,1686,632848,16.4
360,532,0,1687,633380,14.777777777777779
300,452,0,1688,633832,15.066666666666666
350,462,0,1689,634294,13.2
140,185,0,1690,634479,13.214285714285714
160,208,0,1691,634687,13.0
220,365,0,1692,635052,16.59090909090909
370,568,0,1693,635620,15.35135135135135
190,299,0,1694,635919,15.736842105263158
90,92,0,1695,636011,10.222222222222221
270,401,0,1696,636412,14.851851851851851
270,410,0,1697,636822,15.185185185185185
180,269,0,1698,637091,14.944444444444445
370,619,0,1699,637710,16.72972972972973
60,53,0,1700,637763,8.833333333333334
80,124,0,1701,637887,15.5
360,499,0,1702,638386,13.86111111111111
250,372,0,1703,638758,14.88
350,565,0,1704,639323,16.142857142857142
340,537,0,1705,639860,15.794117647058824
180,270,0,1706,640130,15.0
290,436,0,1707,640566,15.03448275862069
190,325,0,1708,640891,17.105263157894736
210,241,0,1709,641132,11.476190476190476
330,453,0,1710,641585,13.727272727272727
130,152,0,1711,641737,11.692307692307692
370,519,0,1712,642256,14.027027027027026
270,421,0,1713,642677,15.592592592592593
140,225,0,1714,642902,16.071428571428573
140,195,0,1715,643097,13.928571428571429
180,198,0,1716,643295,11.0
450,659,0,1717,643954,14.644444444444444
260,357,0,1718,644311,13.73076923076923
230,303,0,1719,644614,13.173913043478262
190,290,0,1720,644904,15.263157894736842
160,251,0,1721,645155,15.6875
190,271,0,1722,645426,14.263157894736842
220,350,0,1723,645776,15.909090909090908
240,296,0,1724,646072,12.333333333333334
110,114,0,1725,646186,10.363636363636363
370,619,0,1726,646805,16.72972972972973
270,397,0,1727,647202,14.703703703703704
230,368,0,1728,647570,16.0
460,851,0,1729,648421,18.5
370,584,0,1730,649005,15.783783783783784
320,498,0,1731,649503,15.5625
270,287,0,1732,649790,10.62962962962963
320,458,0,1733,650248,14.3125
300,439,0,1734,650687,14.633333333333333
180,287,0,1735,650974,15.944444444444445
210,290,0,1736,651264,13.80952380952381
220,414,0,1737,651678,18.818181818181817
460,668,0,1738,652346,14.521739130434783
260,360,0,1739,652706,13.846153846153847
200,241,0,1740,652947,12.05
240,395,0,1741,653342,16.458333333333332
280,435,0,1742,653777,15.535714285714286
210,353,0,1743,654130,16.80952380952381
270,380,0,1744,654510,14.074074074074074
230,341,0,1745,654851,14.826086956521738
290,370,0,1746,655221,12.758620689655173
110,140,0,1747,655361,12.727272727272727
120,176,0,1748,655537,14.666666666666666
380,627,0,1749,656164,16.5
220,381,0,1750,656545,17.318181818181817
230,382,0,1751,656927,16.608695652173914
240,401,0,1752,657328,16.708333333333332
150,200,0,1753,657528,13.333333333333334
180,285,0,1754,657813,15.833333333333334
310,529,0,1755,658342,17.06451612903226
420,646,0,1756,658988,15.380952380952381
210,334,0,1757,659322,15.904761904761905
200,323,0,1758,659645,16.15
300,436,0,1759,660081,14.533333333333333
150,234,0,1760,660315,15.6
250,333,0,1761,660648,13.32
310,435,0,1762,661083,14.03225806451613
230,281,0,1763,661364,12.217391304347826
210,360,0,1764,661724,17.142857142857142
320,462,0,1765,662186,14.4375
320,567,0,1766,662753,17.71875
570,905,0,1767,663658,15.87719298245614
380,666,0,1768,664324,17.526315789473685
380,509,0,1769,664833,13.394736842105264
330,480,0,1770,665313,14.545454545454545
240,328,0,1771,665641,13.666666666666666
230,289,0,1772,665930,12.565217391304348
260,275,0,1773,666205,10.576923076923077
310,448,0,1774,666653,14.451612903225806
190,243,0,1775,666896,12.789473684210526
160,223,0,1776,667119,13.9375
210,289,0,1777,667408,13.761904761904763
320,468,0,1778,667876,14.625
410,677,0,1779,668553,16.51219512195122
340,548,0,1780,669101,16.11764705882353
270,387,0,1781,669488,14.333333333333334
360,583,0,1782,670071,16.194444444444443
360,601,0,1783,670672,16.694444444444443
230,358,0,1784,671030,15.565217391304348
180,266,0,1785,671296,14.777777777777779
410,777,0,1786,672073,18.951219512195124
160,242,0,1787,672315,15.125
190,257,0,1788,672572,13.526315789473685
260,365,0,1789,672937,14.038461538461538
250,337,0,1790,673274,13.48
250,340,0,1791,673614,13.6
170,286,0,1792,673900,16.823529411764707
210,256,0,1793,674156,12.19047619047619
250,419,0,1794,674575,16.76
340,655,0,1795,675230,19.264705882352942
180,169,0,1796,675399,9.38888888888889
410,634,0,1797,676033,15.463414634146341
160,210,0,1798,676243,13.125
650,973,0,1799,677216,14.96923076923077
250,340,0,1800,677556,13.6
250,364,0,1801,677920,14.56
220,302,0,1802,678222,13.727272727272727
290,418,0,1803,678640,14.413793103448276
120,144,0,1804,678784,12.0
260,346,0,1805,679130,13.307692307692308
220,316,0,1806,679446,14.363636363636363
170,241,0,1807,679687,14.176470588235293
290,409,0,1808,680096,14.10344827586207
210,351,0,1809,680447,16.714285714285715
300,485,0,1810,680932,16.166666666666668
210,319,0,1811,681251,15.19047619047619
250,392,0,1812,681643,15.68
250,323,0,1813,681966,12.92
210,285,0,1814,682251,13.571428571428571
80,93,0,1815,682344,11.625
290,497,0,1816,682841,17.137931034482758
320,449,0,1817,683290,14.03125
190,306,0,1818,683596,16.105263157894736
300,501,0,1819,684097,16.7
290,454,0,1820,684551,15.655172413793103
280,419,0,1821,684970,14.964285714285714
190,244,0,1822,685214,12.842105263157896
210,267,0,1823,685481,12.714285714285714
300,438,0,1824,685919,14.6
370,569,0,1825,686488,15.378378378378379
260,311,0,1826,686799,11.961538461538462
230,342,0,1827,687141,14.869565217391305
130,223,0,1828,687364,17.153846153846153
510,796,0,1829,688160,15.607843137254902
400,713,0,1830,688873,17.825
250,379,0,1831,689252,15.16
280,467,0,1832,689719,16.678571428571427
400,647,0,1833,690366,16.175
130,175,0,1834,690541,13.461538461538462
240,357,0,1835,690898,14.875
320,496,0,1836,691394,15.5
140,226,0,1837,691620,16.142857142857142
140,248,0,1838,691868,17.714285714285715
250,369,0,1839,692237,14.76
120,150,0,1840,692387,12.5
380,637,0,1841,693024,16.763157894736842
320,513,0,1842,693537,16.03125
180,286,0,1843,693823,15.88888888888889
410,687,0,1844,694510,16.75609756097561
140,187,0,1845,694697,13.357142857142858
280,431,0,1846,695128,15.392857142857142
130,146,0,1847,695274,11.23076923076923
100,123,0,1848,695397,12.3
440,768,0,1849,696165,17.454545454545453
310,481,0,1850,696646,15.516129032258064
190,326,0,1851,696972,17.157894736842106
250,354,0,1852,697326,14.16
390,610,0,1853,697936,15.64102564102564
190,282,0,1854,698218,14.842105263157896
150,189,0,1855,698407,12.6
490,751,0,1856,699158,15.326530612244898
340,417,0,1857,699575,12.264705882352942
250,413,0,1858,699988,16.52
180,263,0,1859,700251,14.61111111111111
280,391,0,1860,700642,13.964285714285714
350,519,0,1861,701161,14.82857142857143
200,287,0,1862,701448,14.35
400,594,0,1863,702042,14.85
190,250,0,1864,702292,13.157894736842104
240,352,0,1865,702644,14.666666666666666
170,198,0,1866,702842,11.647058823529411
200,286,0,1867,703128,14.3
180,218,0,1868,703346,12.11111111111111
200,338,0,1869,703684,16.9
120,180,0,1870,703864,15.0
210,286,0,1871,704150,13.619047619047619
160,235,0,1872,704385,14.6875
140,207,0,1873,704592,14.785714285714286
150,179,0,1874,704771,11.933333333333334
250,432,0,1875,705203,17.28
260,391,0,1876,705594,15.038461538461538
540,949,0,1877,706543,17.574074074074073
360,514,0,1878,707057,14.277777777777779
140,162,0,1879,707219,11.571428571428571
120,146,0,1880,707365,12.166666666666666
230,337,0,1881,707702,14.652173913043478
240,386,0,1882,708088,16.083333333333332
220,285,0,1883,708373,12.954545454545455
280,418,0,1884,708791,14.928571428571429
160,264,0,1885,709055,16.5
330,437,0,1886,709492,13.242424242424242
140,170,0,1887,709662,12.142857142857142
310,465,0,1888,710127,15.0
240,267,0,1889,710394,11.125
270,435,0,1890,710829,16.11111111111111
120,151,0,1891,710980,12.583333333333334
370,561,0,1892,711541,15.162162162162161
240,359,0,1893,711900,14.958333333333334
220,295,0,1894,712195,13.409090909090908
260,363,0,1895,712558,13.961538461538462
270,406,0,1896,712964,15.037037037037036
170,217,0,1897,713181,12.764705882352942
310,481,0,1898,713662,15.516129032258064
280,399,0,1899,714061,14.25
200,258,0,1900,714319,12.9
110,158,0,1901,714477,14.363636363636363
240,370,0,1902,714847,15.416666666666666
300,465,0,1903,715312,15.5
170,240,0,1904,715552,14.117647058823529
130,187,0,1905,715739,14.384615384615385
220,285,0,1906,716024,12.954545454545455
200,274,0,1907,716298,13.7
310,501,0,1908,716799,16.161290322580644
150,166,0,1909,716965,11.066666666666666
270,405,0,1910,717370,15.0
350,448,0,1911,717818,12.8
360,522,0,1912,718340,14.5
310,537,0,1913,718877,17.322580645161292
170,213,0,1914,719090,12.529411764705882
110,168,0,1915,719258,15.272727272727273
280,443,0,1916,719701,15.821428571428571
500,833,0,1917,720534,16.66
200,263,0,1918,720797,13.15
280,393,0,1919,721190,14.035714285714286
320,486,0,1920,721676,15.1875
320,486,0,1921,722162,15.1875
380,602,0,1922,722764,15.842105263157896
260,373,0,1923,723137,14.346153846153847
90,93,0,1924,723230,10.333333333333334
290,420,0,1925,723650,14.482758620689655
470,830,0,1926,724480,17.659574468085108
230,363,0,1927,724843,15.782608695652174
300,499,0,1928,725342,16.633333333333333
310,413,0,1929,725755,13.32258064516129
150,199,0,1930,725954,13.266666666666667
320,547,0,1931,726501,17.09375
310,577,0,1932,727078,18.612903225806452
310,420,0,1933,727498,13.548387096774194
250,359,0,1934,727857,14.36
190,276,0,1935,728133,14.526315789473685
180,240,0,1936,728373,13.333333333333334
390,674,0,1937,729047,17.28205128205128
280,394,0,1938,729441,14.071428571428571
240,334,0,1939,729775,13.916666666666666
310,425,0,1940,730200,13.709677419354838
330,479,0,1941,730679,14.515151515151516
210,304,0,1942,730983,14.476190476190476
140,192,0,1943,731175,13.714285714285714
270,407,0,1944,731582,15.074074074074074
180,232,0,1945,731814,12.88888888888889
270,419,0,1946,732233,15.518518518518519
460,773,0,1947,733006,16.804347826086957
190,260,0,1948,733266,13.68421052631579
290,398,0,1949,733664,13.724137931034482
180,222,0,1950,733886,12.333333333333334
260,465,0,1951,734351,17.884615384615383
380,570,0,1952,734921,15.0
260,397,0,1953,735318,15.26923076923077
370,544,0,1954,735862,14.702702702702704
290,379,0,1955,736241,13.068965517241379
300,447,0,1956,736688,14.9
390,608,0,1957,737296,15.58974358974359
510,934,0,1958,738230,18.313725490196077
280,396,0,1959,738626,14.142857142857142
240,428,0,1960,739054,17.833333333333332
150,126,0,1961,739180,8.4
240,378,0,1962,739558,15.75
410,573,0,1963,740131,13.975609756097562
220,342,0,1964,740473,15.545454545454545
110,151,0,1965,740624,13.727272727272727
360,512,0,1966,741136,14.222222222222221
290,528,0,1967,741664,18.20689655172414
370,684,0,1968,742348,18.486486486486488
340,540,0,1969,742888,15.882352941176471
100,111,0,1970,742999,11.1
440,742,0,1971,743741,16.863636363636363
330,547,0,1972,744288,16.575757575757574
270,318,0,1973,744606,11.777777777777779
330,438,0,1974,745044,13.272727272727273
180,218,0,1975,745262,12.11111111111111
270,397,0,1976,745659,14.703703703703704
220,345,0,1977,746004,15.681818181818182
200,298,0,1978,746302,14.9
130,171,0,1979,746473,13.153846153846153
220,243,0,1980,746716,11.045454545454545
250,328,0,1981,747044,13.12
220,332,0,1982,747376,15.090909090909092
370,505,0,1983,747881,13.64864864864865
260,421,0,1984,748302,16.192307692307693
160,239,0,1985,748541,14.9375
60,83,0,1986,748624,13.833333333333334
220,296,0,1987,748920,13.454545454545455
140,204,0,1988,749124,14.571428571428571
220,314,0,1989,749438,14.272727272727273
250,436,0,1990,749874,17.44
100,126,0,1991,750000,12.6
340,568,0,1992,750568,16.705882352941178
160,237,0,1993,750805,14.8125
180,226,0,1994,751031,12.555555555555555
230,322,0,1995,751353,14.0
200,311,0,1996,751664,15.55
480,709,0,1997,752373,14.770833333333334
180,263,0,1998,752636,14.61111111111111
280,429,0,1999,753065,15.321428571428571
250,415,0,2000,753480,16.6
210,273,0,2001,753753,13.0
390,635,0,2002,754388,16.28205128205128
330,478,0,2003,754866,14.484848484848484
110,191,0,2004,755057,17.363636363636363
360,539,0,2005,755596,14.972222222222221
220,261,0,2006,755857,11.863636363636363
250,314,0,2007,756171,12.56
320,485,0,2008,756656,15.15625
240,347,0,2009,757003,14.458333333333334
240,396,0,2010,757399,16.5
330,517,0,2011,757916,15.666666666666666
150,185,0,2012,758101,12.333333333333334
150,195,0,2013,758296,13.0
250,373,0,2014,758669,14.92
140,240,0,2015,758909,17.142857142857142
300,422,0,2016,759331,14.066666666666666
270,414,0,2017,759745,15.333333333333334
250,478,0,2018,760223,19.12
210,337,0,2019,760560,16.047619047619047
230,339,0,2020,760899,14.73913043478261
280,379,0,2021,761278,13.535714285714286
240,349,0,2022,761627,14.541666666666666
120,126,0,2023,761753,10.5
110,170,0,2024,761923,15.454545454545455
300,461,0,2025,762384,15.366666666666667
230,348,0,2026,762732,15.130434782608695
190,321,0,2027,763053,16.894736842105264
360,470,0,2028,763523,13.055555555555555
180,229,0,2029,763752,12.722222222222221
240,376,0,2030,764128,15.666666666666666
400,595,0,2031,764723,14.875
270,373,0,2032,765096,13.814814814814815
270,431,0,2033,765527,15.962962962962964
300,492,0,2034,766019,16.4
240,356,0,2035,766375,14.833333333333334
120,151,0,2036,766526,12.583333333333334
110,196,0,2037,766722,17.818181818181817
330,581,0,2038,767303,17.606060606060606
290,496,0,2039,767799,17.103448275862068
150,208,0,2040,768007,13.866666666666667
550,905,0,2041,768912,16.454545454545453
150,169,0,2042,769081,11.266666666666667
200,274,0,2043,769355,13.7
240,442,0,2044,769797,18.416666666666668
240,319,0,2045,770116,13.291666666666666
90,97,0,2046,770213,10.777777777777779
240,420,0,2047,770633,17.5
180,262,0,2048,770895,14.555555555555555
260,422,0,2049,771317,16.23076923076923
170,276,0,2050,771593,16.235294117647058
410,571,0,2051,772164,13.926829268292684
100,124,0,2052,772288,12.4
170,222,0,2053,772510,13.058823529411764
200,255,0,2054,772765,12.75
260,314,0,2055,773079,12.076923076923077
170,306,0,2056,773385,18.0
410,615,0,2057,774000,15.0
140,187,0,2058,774187,13.357142857142858
350,537,0,2059,774724,15.342857142857143
320,453,0,2060,775177,14.15625
170,297,0,2061,775474,17.470588235294116
300,376,0,2062,775850,12.533333333333333
440,751,0,2063,776601,17.068181818181817
210,270,0,2064,776871,12.857142857142858
310,382,0,2065,777253,12.32258064516129
350,521,0,2066,777774,14.885714285714286
250,318,0,2067,778092,12.72
340,506,0,2068,778598,14.882352941176471
190,238,0,2069,778836,12.526315789473685
310,490,0,2070,779326,15.806451612903226
170,256,0,2071,779582,15.058823529411764
340,553,0,2072,780135,16.264705882352942
240,359,0,2073,780494,14.958333333333334
330,504,0,2074,780998,15.272727272727273
130,170,0,2075,781168,13.076923076923077
190,287,0,2076,781455,15.105263157894736
120,151,0,2077,781606,12.583333333333334
240,318,0,2078,781924,13.25
130,136,0,2079,782060,10.461538461538462
200,252,0,2080,782312,12.6
190,264,0,2081,782576,13.894736842105264
270,419,0,2082,782995,15.518518518518519
290,450,0,2083,783445,15.517241379310345
230,325,0,2084,783770,14.130434782608695
560,973,0,2085,784743,17.375
330,531,0,2086,785274,16.09090909090909
280,424,0,2087,785698,15.142857142857142
330,567,0,2088,786265,17.181818181818183
100,154,0,2089,786419,15.4
200,244,0,2090,786663,12.2
300,432,0,2091,787095,14.4
260,372,0,2092,787467,14.307692307692308
350,447,0,2093,787914,12.771428571428572
110,130,0,2094,788044,11.818181818181818
190,271,0,2095,788315,14.263157894736842
260,375,0,2096,788690,14.423076923076923
170,273,0,2097,788963,16.058823529411764
210,326,0,2098,789289,15.523809523809524
350,549,0,2099,789838,15.685714285714285
150,181,0,2100,790019,12.066666666666666
290,393,0,2101,790412,13.551724137931034
330,448,0,2102,790860,13.575757575757576
170,247,0,2103,791107,14.529411764705882
80,161,0,2104,791268,20.125
250,446,0,2105,791714,17.84
220,360,0,2106,792074,16.363636363636363
250,329,0,2107,792403,13.16
230,335,0,2108,792738,14.565217391304348
360,475,0,2109,793213,13.194444444444445
360,571,0,2110,793784,15.86111111111111
250,345,0,2111,794129,13.8
130,157,0,2112,794286,12.076923076923077
340,599,0,2113,794885,17.61764705882353
150,215,0,2114,795100,14.333333333333334
140,164,0,2115,795264,11.714285714285714
370,527,0,2116,795791,14.243243243243244
90,107,0,2117,795898,11.88888888888889
290,455,0,2118,796353,15.689655172413794
210,305,0,2119,796658,14.523809523809524
250,305,0,2120,796963,12.2
240,397,0,2121,797360,16.541666666666668
180,247,0,2122,797607,13.722222222222221
260,388,0,2123,797995,14.923076923076923
250,388,0,2124,798383,15.52
180,235,0,2125,798618,13.055555555555555
280,481,0,2126,799099,17.178571428571427
310,455,0,2127,799554,14.67741935483871
150,227,0,2128,799781,15.133333333333333
260,425,0,2129,800206,16.346153846153847
400,566,0,2130,800772,14.15
160,250,0,2131,801022,15.625
200,316,0,2132,801338,15.8
260,336,0,2133,801674,12.923076923076923
220,258,0,2134,801932,11.727272727272727
180,260,0,2135,802192,14.444444444444445
370,613,0,2136,802805,16.56756756756757
130,149,0,2137,802954,11.461538461538462
370,505,0,2138,803459,13.64864864864865
100,168,0,2139,803627,16.8
300,480,0,2140,804107,16.0
210,214,0,2141,804321,10.19047619047619
230,300,0,2142,804621,13.043478260869565
350,564,0,2143,805185,16.114285714285714
290,415,0,2144,805600,14.310344827586206
170,241,0,2145,805841,14.176470588235293
180,267,0,2146,806108,14.833333333333334
190,241,0,2147,806349,12.68421052631579
180,232,0,2148,806581,12.88888888888889
220,429,0,2149,807010,19.5
190,241,0,2150,807251,12.68421052631579
400,710,0,2151,807961,17.75
250,333,0,2152,808294,13.32
190,286,0,2153,808580,15.052631578947368
340,552,0,2154,809132,16.235294117647058
200,294,0,2155,809426,14.7
170,193,0,2156,809619,11.352941176470589
230,302,0,2157,809921,13.130434782608695
390,691,0,2158,810612,17.71794871794872
280,427,0,2159,811039,15.25
200,331,0,2160,811370,16.55
330,429,0,2161,811799,13.0
340,526,0,2162,812325,15.470588235294118
210,291,0,2163,812616,13.857142857142858
250,416,0,2164,813032,16.64
100,143,0,2165,813175,14.3
60,66,0,2166,813241,11.0
250,381,0,2167,813622,15.24
70,65,0,2168,813687,9.285714285714286
240,366,0,2169,814053,15.25
170,260,0,2170,814313,15.294117647058824
200,276,0,2171,814589,13.8
390,737,0,2172,815326,18.897435897435898
180,255,0,2173,815581,14.166666666666666
500,781,0,2174,816362,15.62
170,222,0,2175,816584,13.058823529411764
250,378,0,2176,816962,15.12
240,342,0,2177,817304,14.25
250,401,0,2178,817705,16.04
190,237,0,2179,817942,12.473684210526315
230,344,0,2180,818286,14.956521739130435
280,430,0,2181,818716,15.357142857142858
350,534,0,2182,819250,15.257142857142858
180,268,0,2183,819518,14.88888888888889
240,435,0,2184,819953,18.125
210,276,0,2185,820229,13.142857142857142
260,395,0,2186,820624,15.192307692307692
220,318,0,2187,820942,14.454545454545455
410,694,0,2188,821636,16.926829268292682
220,345,0,2189,821981,15.681818181818182
470,708,0,2190,822689,15.063829787234043
180,214,0,2191,822903,11.88888888888889
180,252,0,2192,823155,14.0
250,325,0,2193,823480,13.0
280,373,0,2194,823853,13.321428571428571
200,243,0,2195,824096,12.15
110,127,0,2196,824223,11.545454545454545
170,221,0,2197,824444,13.0
180,206,0,2198,824650,11.444444444444445
280,391,0,2199,825041,13.964285714285714
300,487,0,2200,825528,16.233333333333334
250,385,0,2201,825913,15.4
190,261,0,2202,826174,13.736842105263158
190,299,0,2203,826473,15.736842105263158
380,586,0,2204,827059,15.421052631578947
330,477,0,2205,827536,14.454545454545455
300,482,0,2206,828018,16.066666666666666
470,745,0,2207,828763,15.851063829787234
300,470,0,2208,829233,15.666666666666666
450,664,0,2209,829897,14.755555555555556
330,508,0,2210,830405,15.393939393939394
260,320,0,2211,830725,12.307692307692308
160,232,0,2212,830957,14.5
350,453,0,2213,831410,12.942857142857143
190,286,0,2214,831696,15.052631578947368
260,338,0,2215,832034,13.0
180,251,0,2216,832285,13.944444444444445
240,356,0,2217,832641,14.833333333333334
510,740,0,2218,833381,14.509803921568627
250,334,0,2219,833715,13.36
330,461,0,2220,834176,13.969696969696969
230,315,0,2221,834491,13.695652173913043
170,187,0,2222,834678,11.0
200,291,0,2223,834969,14.55
160,250,0,2224,835219,15.625
300,470,0,2225,835689,15.666666666666666
370,460,0,2226,836149,12.432432432432432
510,1007,0,2227,837156,19.745098039215687
170,215,0,2228,837371,12.647058823529411
300,509,0,2229,837880,16.966666666666665
230,293,0,2230,838173,12.73913043478261
100,142,0,2231,838315,14.2
370,581,0,2232,838896,15.702702702702704
180,264,0,2233,839160,14.666666666666666
170,273,0,2234,839433,16.058823529411764
180,302,0,2235,839735,16.77777777777778
370,546,0,2236,840281,14.756756756756756
490,766,0,2237,841047,15.63265306122449
350,632,0,2238,841679,18.057142857142857
200,380,0,2239,842059,19.0
180,209,0,2240,842268,11.61111111111111
140,188,0,2241,842456,13.428571428571429
100,117,0,2242,842573,11.7
220,332,0,2243,842905,15.090909090909092
220,386,0,2244,843291,17.545454545454547
190,296,0,2245,843587,15.578947368421053
210,282,0,2246,843869,13.428571428571429
240,347,0,2247,844216,14.458333333333334
100,104,0,2248,844320,10.4
330,548,0,2249,844868,16.606060606060606
220,368,0,2250,845236,16.727272727272727
250,300,0,2251,845536,12.0
190,301,0,2252,845837,15.842105263157896
170,206,0,2253,846043,12.117647058823529
260,394,0,2254,846437,15.153846153846153
80,111,0,2255,846548,13.875
320,422,0,2256,846970,13.1875
110,144,0,2257,847114,13.090909090909092
290,435,0,2258,847549,15.0
180,243,0,2259,847792,13.5
280,407,0,2260,848199,14.535714285714286
110,156,0,2261,848355,14.181818181818182
110,160,0,2262,848515,14.545454545454545
200,307,0,2263,848822,15.35
320,434,0,2264,849256,13.5625
170,287,0,2265,849543,16.88235294117647
180,208,0,2266,849751,11.555555555555555
400,633,0,2267,850384,15.825
270,374,0,2268,850758,13.851851851851851
270,413,0,2269,851171,15.296296296296296
130,180,0,2270,851351,13.846153846153847
80,89,0,2271,851440,11.125
360,581,0,2272,852021,16.13888888888889
500,843,0,2273,852864,16.86
270,365,0,2274,853229,13.518518518518519
310,530,0,2275,853759,17.096774193548388
370,685,0,2276,854444,18.513513513513512
360,538,0,2277,854982,14.944444444444445
230,312,0,2278,855294,13.565217391304348
420,721,0,2279,856015,17.166666666666668
250,378,0,2280,856393,15.12
350,493,0,2281,856886,14.085714285714285
230,332,0,2282,857218,14.434782608695652
190,212,0,2283,857430,11.157894736842104
330,519,0,2284,857949,15.727272727272727
140,175,0,2285,858124,12.5
160,218,0,2286,858342,13.625
310,439,0,2287,858781,14.161290322580646
370,605,0,2288,859386,16.35135135135135
170,273,0,2289,859659,16.058823529411764
280,395,0,2290,860054,14.107142857142858
260,368,0,2291,860422,14.153846153846153
470,647,0,2292,861069,13.76595744680851
210,319,0,2293,861388,15.19047619047619
300,442,0,2294,861830,14.733333333333333
150,213,0,2295,862043,14.2
200,339,0,2296,862382,16.95
230,309,0,2297,862691,13.434782608695652
260,348,0,2298,863039,13.384615384615385
230,307,0,2299,863346,13.347826086956522
270,401,0,2300,863747,14.851851851851851
300,411,0,2301,864158,13.7
400,844,0,2302,865002,21.1
180,266,0,2303,865268,14.777777777777779
320,439,0,2304,865707,13.71875
300,435,0,2305,866142,14.5
100,153,0,2306,866295,15.3
340,522,0,2307,866817,15.352941176470589
210,283,0,2308,867100,13.476190476190476
330,501,0,2309,867601,15.181818181818182
220,269,0,2310,867870,12.227272727272727
170,207,0,2311,868077,12.176470588235293
220,353,0,2312,868430,16.045454545454547
210,258,0,2313,868688,12.285714285714286
240,339,0,2314,869027,14.125
240,370,0,2315,869397,15.416666666666666
240,324,0,2316,869721,13.5
190,255,0,2317,869976,13.421052631578947
240,433,0,2318,870409,18.041666666666668
270,452,0,2319,870861,16.74074074074074
270,410,0,2320,871271,15.185185185185185
270,388,0,2321,871659,14.37037037037037
290,446,0,2322,872105,15.379310344827585
140,176,0,2323,872281,12.571428571428571
270,351,0,2324,872632,13.0
350,525,0,2325,873157,15.0
330,486,0,2326,873643,14.727272727272727
180,284,0,2327,873927,15.777777777777779
190,303,0,2328,874230,15.947368421052632
330,419,0,2329,874649,12.696969696969697
300,482,0,2330,875131,16.066666666666666
140,205,0,2331,875336,14.642857142857142
340,531,0,2332,875867,15.617647058823529
230,297,0,2333,876164,12.91304347826087
350,510,0,2334,876674,14.571428571428571
220,315,0,2335,876989,14.318181818181818
250,365,0,2336,877354,14.6
300,482,0,2337,877836,16.066666666666666
380,593,0,2338,878429,15.605263157894736
260,471,0,2339,878900,18.115384615384617
290,470,0,2340,879370,16.20689655172414
220,297,0,2341,879667,13.5
270,372,0,2342,880039,13.777777777777779
140,193,0,2343,880232,13.785714285714286
300,445,0,2344,880677,14.833333333333334
190,258,0,2345,880935,13.578947368421053
210,278,0,2346,881213,13.238095238095237
100,162,0,2347,881375,16.2
230,323,0,2348,881698,14.043478260869565
200,362,0,2349,882060,18.1
120,148,0,2350,882208,12.333333333333334
240,370,0,2351,882578,15.416666666666666
320,465,0,2352,883043,14.53125
430,653,0,2353,883696,15.186046511627907
300,396,0,2354,884092,13.2
260,393,0,2355,884485,15.115384615384615
220,285,0,2356,884770,12.954545454545455
180,250,0,2357,885020,13.88888888888889
380,596,0,2358,885616,15.68421052631579
370,657,0,2359,886273,17.756756756756758
440,850,0,2360,887123,19.318181818181817
450,718,0,2361,887841,15.955555555555556
220,325,0,2362,888166,14.772727272727273
290,436,0,2363,888602,15.03448275862069
180,187,0,2364,888789,10.38888888888889
120,141,0,2365,888930,11.75
160,210,0,2366,889140,13.125
140,143,0,2367,889283,10.214285714285714
240,341,0,2368,889624,14.208333333333334
130,201,0,2369,889825,15.461538461538462
190,314,0,2370,890139,16.526315789473685
190,253,0,2371,890392,13.31578947368421
90,106,0,2372,890498,11.777777777777779
250,374,0,2373,890872,14.96
280,408,0,2374,891280,14.571428571428571
220,371,0,2375,891651,16.863636363636363
300,431,0,2376,892082,14.366666666666667
250,374,0,2377,892456,14.96
110,118,0,2378,892574,10.727272727272727
180,281,0,2379,892855,15.61111111111111
300,448,0,2380,893303,14.933333333333334
410,604,0,2381,893907,14.731707317073171
260,412,0,2382,894319,15.846153846153847
370,545,0,2383,894864,14.72972972972973
370,621,0,2384,895485,16.783783783783782
210,280,0,2385,895765,13.333333333333334
260,402,0,2386,896167,15.461538461538462
200,292,0,2387,896459,14.6
340,544,0,2388,897003,16.0
520,800,0,2389,897803,15.384615384615385
230,315,0,2390,898118,13.695652173913043
150,124,0,2391,898242,8.266666666666667
280,365,0,2392,898607,13.035714285714286
220,372,0,2393,898979,16.90909090909091
260,346,0,2394,899325,13.307692307692308
180,263,0,2395,899588,14.61111111111111
390,649,0,2396,900237,16.641025641025642
170,255,0,2397,900492,15.0
180,249,0,2398,900741,13.833333333333334
360,581,0,2399,901322,16.13888888888889
370,559,0,2400,901881,15.108108108108109
410,586,0,2401,902467,14.292682926829269
380,574,0,2402,903041,15.105263157894736
230,383,0,2403,903424,16.652173913043477
250,378,0,2404,903802,15.12
330,526,0,2405,904328,15.93939393939394
380,546,0,2406,904874,14.368421052631579
280,435,0,2407,905309,15.535714285714286
170,251,0,2408,905560,14.764705882352942
230,321,0,2409,905881,13.956521739130435
280,420,0,2410,906301,15.0
240,330,0,2411,906631,13.75
170,271,0,2412,906902,15.941176470588236
360,531,0,2413,907433,14.75
80,129,0,2414,907562,16.125
210,285,0,2415,907847,13.571428571428571
260,441,0,2416,908288,16.96153846153846
300,506,0,2417,908794,16.866666666666667
340,496,0,2418,909290,14.588235294117647
250,384,0,2419,909674,15.36
340,578,0,2420,910252,17.0
320,517,0,2421,910769,16.15625
310,498,0,2422,911267,16.06451612903226
280,352,0,2423,911619,12.571428571428571
290,432,0,2424,912051,14.89655172413793
210,306,0,2425,912357,14.571428571428571
230,338,0,2426,912695,14.695652173913043
150,203,0,2427,912898,13.533333333333333
250,373,0,2428,913271,14.92
190,256,0,2429,913527,13.473684210526315
220,291,0,2430,913818,13.227272727272727
270,423,0,2431,914241,15.666666666666666
440,702,0,2432,914943,15.954545454545455
260,371,0,2433,915314,14.26923076923077
130,174,0,2434,915488,13.384615384615385
530,906,0,2435,916394,17.09433962264151
190,266,0,2436,916660,14.0
190,263,0,2437,916923,13.842105263157896
110,104,0,2438,917027,9.454545454545455
330,519,0,2439,917546,15.727272727272727
170,189,0,2440,917735,11.117647058823529
240,347,0,2441,918082,14.458333333333334
330,519,0,2442,918601,15.727272727272727
130,152,0,2443,918753,11.692307692307692
150,213,0,2444,918966,14.2
250,373,0,2445,919339,14.92
160,279,0,2446,919618,17.4375
200,325,0,2447,919943,16.25
130,156,0,2448,920099,12.0
470,787,0,2449,920886,16.74468085106383
310,479,0,2450,921365,15.451612903225806
210,275,0,2451,921640,13.095238095238095
270,477,0,2452,922117,17.666666666666668
230,406,0,2453,922523,17.652173913043477
200,217,0,2454,922740,10.85
180,230,0,2455,922970,12.777777777777779
220,324,0,2456,923294,14.727272727272727
230,353,0,2457,923647,15.347826086956522
270,439,0,2458,924086,16.25925925925926
450,684,0,2459,924770,15.2
170,181,0,2460,924951,10.647058823529411
70,79,0,2461,925030,11.285714285714286
210,265,0,2462,925295,12.619047619047619
140,211,0,2463,925506,15.071428571428571
150,232,0,2464,925738,15.466666666666667
90,121,0,2465,925859,13.444444444444445
230,305,0,2466,926164,13.26086956521739
170,217,0,2467,926381,12.764705882352942
230,305,0,2468,926686,13.26086956521739
320,530,0,2469,927216,16.5625
160,209,0,2470,927425,13.0625
60,77,0,2471,927502,12.833333333333334
210,303,0,2472,927805,14.428571428571429
120,142,0,2473,927947,11.833333333333334
410,517,0,2474,928464,12.609756097560975
210,297,0,2475,928761,14.142857142857142
230,300,0,2476,929061,13.043478260869565
330,530,0,2477,929591,16.060606060606062
120,149,0,2478,929740,12.416666666666666
250,348,0,2479,930088,13.92
310,547,0,2480,930635,17.64516129032258
140,156,0,2481,930791,11.142857142857142
390,616,0,2482,931407,15.794871794871796
230,330,0,2483,931737,14.347826086956522
270,364,0,2484,932101,13.481481481481481
100,134,0,2485,932235,13.4
280,362,0,2486,932597,12.928571428571429
120,191,0,2487,932788,15.916666666666666
280,438,0,2488,933226,15.642857142857142
200,306,0,2489,933532,15.3
140,213,0,2490,933745,15.214285714285714
230,332,0,2491,934077,14.434782608695652
240,367,0,2492,934444,15.291666666666666
370,565,0,2493,935009,15.27027027027027
370,586,0,2494,935595,15.837837837837839
520,869,0,2495,936464,16.71153846153846
150,263,0,2496,936727,17.533333333333335
290,431,0,2497,937158,14.862068965517242
290,406,0,2498,937564,14.0
170,257,0,2499,937821,15.117647058823529
400,616,0,2500,938437,15.4
360,542,0,2501,938979,15.055555555555555
220,338,0,2502,939317,15.363636363636363
100,123,0,2503,939440,12.3
270,321,0,2504,939761,11.88888888888889
280,370,0,2505,940131,13.214285714285714
230,329,0,2506,940460,14.304347826086957
210,300,0,2507,940760,14.285714285714286
130,179,0,2508,940939,13.76923076923077
260,352,0,2509,941291,13.538461538461538
320,485,0,2510,941776,15.15625
80,113,0,2511,941889,14.125
310,439,0,2512,942328,14.161290322580646
280,480,0,2513,942808,17.142857142857142
90,130,0,2514,942938,14.444444444444445
210,281,0,2515,943219,13.380952380952381
360,586,0,2516,943805,16.27777777777778
210,256,0,2517,944061,12.19047619047619
250,387,0,2518,944448,15.48
270,473,0,2519,944921,17.51851851851852
330,576,0,2520,945497,17.454545454545453
250,318,0,2521,945815,12.72
150,178,0,2522,945993,11.866666666666667
200,310,0,2523,946303,15.5
190,291,0,2524,946594,15.31578947368421
260,384,0,2525,946978,14.76923076923077
500,824,0,2526,947802,16.48
210,225,0,2527,948027,10.714285714285714
270,430,0,2528,948457,15.925925925925926
210,270,0,2529,948727,12.857142857142858
230,401,0,2530,949128,17.434782608695652
400,697,0,2531,949825,17.425
300,452,0,2532,950277,15.066666666666666
420,642,0,2533,950919,15.285714285714286
190,244,0,2534,951163,12.842105263157896
350,560,0,2535,951723,16.0
160,239,0,2536,951962,14.9375
360,530,0,2537,952492,14.722222222222221
270,373,0,2538,952865,13.814814814814815
290,410,0,2539,953275,14.137931034482758
240,330,0,2540,953605,13.75
270,432,0,2541,954037,16.0
170,246,0,2542,954283,14.470588235294118
210,304,0,2543,954587,14.476190476190476
490,972,0,2544,955559,19.836734693877553
250,367,0,2545,955926,14.68
60,98,0,2546,956024,16.333333333333332
420,598,0,2547,956622,14.238095238095237
180,191,0,2548,956813,10.61111111111111
360,557,0,2549,957370,15.472222222222221
230,305,0,2550,957675,13.26086956521739
420,659,0,2551,958334,15.69047619047619
210,295,0,2552,958629,14.047619047619047
380,591,0,2553,959220,15.552631578947368
300,419,0,2554,959639,13.966666666666667
180,244,0,2555,959883,13.555555555555555
360,559,0,2556,960442,15.527777777777779
300,429,0,2557,960871,14.3
380,654,0,2558,961525,17.210526315789473
350,519,0,2559,962044,14.82857142857143
450,869,0,2560,962913,19.31111111111111
230,335,0,2561,963248,14.565217391304348
130,179,0,2562,963427,13.76923076923077
190,237,0,2563,963664,12.473684210526315
200,244,0,2564,963908,12.2
350,540,0,2565,964448,15.428571428571429
170,235,0,2566,964683,13.823529411764707
260,391,0,2567,965074,15.038461538461538
160,224,0,2568,965298,14.0
240,333,0,2569,965631,13.875
330,465,0,2570,966096,14.090909090909092
270,410,0,2571,966506,15.185185185185185
340,526,0,2572,967032,15.470588235294118
120,163,0,2573,967195,13.583333333333334
120,137,0,2574,967332,11.416666666666666
310,428,0,2575,967760,13.806451612903226
390,651,0,2576,968411,16.692307692307693
230,323,0,2577,968734,14.043478260869565
170,184,0,2578,968918,10.823529411764707
360,445,0,2579,969363,12.36111111111111
80,122,0,2580,969485,15.25
410,684,0,2581,970169,16.682926829268293
160,249,0,2582,970418,15.5625
370,583,0,2583,971001,15.756756756756756
320,601,0,2584,971602,18.78125
430,757,0,2585,972359,17.6046511627907
140,156,0,2586,972515,11.142857142857142
240,294,0,2587,972809,12.25
240,310,0,2588,973119,12.916666666666666
160,211,0,2589,973330,13.1875
150,206,0,2590,973536,13.733333333333333
470,891,0,2591,974427,18.95744680851064
240,364,0,2592,974791,15.166666666666666
290,390,0,2593,975181,13.448275862068966
90,132,0,2594,975313,14.666666666666666
290,390,0,2595,975703,13.448275862068966
180,224,0,2596,975927,12.444444444444445
290,461,0,2597,976388,15.89655172413793
300,486,0,2598,976874,16.2
360,653,0,2599,977527,18.13888888888889
310,510,0,2600,978037,16.451612903225808
340,494,0,2601,978531,14.529411764705882
210,284,0,2602,978815,13.523809523809524
180,232,0,2603,979047,12.88888888888889
120,193,0,2604,979240,16.083333333333332
190,334,0,2605,979574,17.57894736842105
140,211,0,2606,979785,15.071428571428571
250,345,0,2607,980130,13.8
100,153,0,2608,980283,15.3
280,397,0,2609,980680,14.178571428571429
140,186,0,2610,980866,13.285714285714286
240,303,0,2611,981169,12.625
260,421,0,2612,981590,16.192307692307693
280,398,0,2613,981988,14.214285714285714
370,614,0,2614,982602,16.594594594594593
290,453,0,2615,983055,15.620689655172415
320,428,0,2616,983483,13.375
170,359,0,2617,983842,21.11764705882353
250,279,0,2618,984121,11.16
230,305,0,2619,984426,13.26086956521739
130,152,0,2620,984578,11.692307692307692
230,396,0,2621,984974,17.217391304347824
390,712,0,2622,985686,18.256410256410255
350,572,0,2623,986258,16.34285714285714
240,353,0,2624,986611,14.708333333333334
250,411,0,2625,987022,16.44
230,382,0,2626,987404,16.608695652173914
140,212,0,2627,987616,15.142857142857142
130,170,0,2628,987786,13.076923076923077
330,437,0,2629,988223,13.242424242424242
440,594,0,2630,988817,13.5
180,241,0,2631,989058,13.38888888888889
50,52,0,2632,989110,10.4
230,315,0,2633,989425,13.695652173913043
460,689,0,2634,990114,14.978260869565217
260,367,0,2635,990481,14.115384615384615
290,396,0,2636,990877,13.655172413793103
270,330,0,2637,991207,12.222222222222221
100,128,0,2638,991335,12.8
70,73,0,2639,991408,10.428571428571429
300,480,0,2640,991888,16.0
250,309,0,2641,992197,12.36
200,284,0,2642,992481,14.2
250,362,0,2643,992843,14.48
430,533,0,2644,993376,12.395348837209303
350,502,0,2645,993878,14.342857142857143
230,385,0,2646,994263,16.73913043478261
210,271,0,2647,994534,12.904761904761905
270,461,0,2648,994995,17.074074074074073
210,313,0,2649,995308,14.904761904761905
220,300,0,2650,995608,13.636363636363637
240,428,0,2651,996036,17.833333333333332
250,351,0,2652,996387,14.04
430,686,0,2653,997073,15.953488372093023
240,364,0,2654,997437,15.166666666666666
320,549,0,2655,997986,17.15625
500,857,0,2656,998843,17.14
170,254,0,2657,999097,14.941176470588236
120,183,0,2658,999280,15.25
160,281,0,2659,999561,17.5625
150,252,0,2660,999813,16.8
240,281,0,2661,1000094,11.708333333333334
250,350,0,2662,1000444,14.0
230,370,0,2663,1000814,16.08695652173913
170,213,0,2664,1001027,12.529411764705882
240,361,0,2665,1001388,15.041666666666666
210,265,0,2666,1001653,12.619047619047619
200,242,0,2667,1001895,12.1
280,409,0,2668,1002304,14.607142857142858
300,454,0,2669,1002758,15.133333333333333
210,285,0,2670,1003043,13.571428571428571
170,232,0,2671,1003275,13.647058823529411
210,246,0,2672,1003521,11.714285714285714
220,329,0,2673,1003850,14.954545454545455
550,914,0,2674,1004764,16.618181818181817
200,307,0,2675,1005071,15.35
270,417,0,2676,1005488,15.444444444444445
210,247,0,2677,1005735,11.761904761904763
270,401,0,2678,1006136,14.851851851851851
230,258,0,2679,1006394,11.217391304347826
380,578,0,2680,1006972,15.210526315789474
470,660,0,2681,1007632,14.042553191489361
300,450,0,2682,1008082,15.0
310,389,0,2683,1008471,12.548387096774194
270,383,0,2684,1008854,14.185185185185185
220,306,0,2685,1009160,13.909090909090908
180,233,0,2686,1009393,12.944444444444445
150,232,0,2687,1009625,15.466666666666667
150,227,0,2688,1009852,15.133333333333333
220,334,0,2689,1010186,15.181818181818182
430,727,0,2690,1010913,16.906976744186046
260,433,0,2691,1011346,16.653846153846153
220,447,0,2692,1011793,20.318181818181817
290,387,0,2693,1012180,13.344827586206897
130,178,0,2694,1012358,13.692307692307692
530,873,0,2695,1013231,16.471698113207548
110,137,0,2696,1013368,12.454545454545455
500,630,0,2697,1013998,12.6
280,468,0,2698,1014466,16.714285714285715
240,366,0,2699,1014832,15.25
270,346,0,2700,1015178,12.814814814814815
250,321,0,2701,1015499,12.84
200,275,0,2702,1015774,13.75
190,255,0,2703,1016029,13.421052631578947
250,393,0,2704,1016422,15.72
300,413,0,2705,1016835,13.766666666666667
220,293,0,2706,1017128,13.318181818181818
400,602,0,2707,1017730,15.05
250,411,0,2708,1018141,16.44
310,469,0,2709,1018610,15.129032258064516
270,420,0,2710,1019030,15.555555555555555
290,418,0,2711,1019448,14.413793103448276
180,271,0,2712,1019719,15.055555555555555
320,432,0,2713,1020151,13.5
220,367,0,2714,1020518,16.681818181818183
290,465,0,2715,1020983,16.03448275862069
130,138,0,2716,1021121,10.615384615384615
290,507,0,2717,1021628,17.482758620689655
340,537,0,2718,1022165,15.794117647058824
200,216,0,2719,1022381,10.8
250,331,0,2720,1022712,13.24
130,135,0,2721,1022847,10.384615384615385
490,710,0,2722,1023557,14.489795918367347
250,401,0,2723,1023958,16.04
320,457,0,2724,1024415,14.28125
100,145,0,2725,1024560,14.5
310,369,0,2726,1024929,11.903225806451612
380,569,0,2727,1025498,14.973684210526315
240,375,0,2728,1025873,15.625
310,440,0,2729,1026313,14.193548387096774
250,309,0,2730,1026622,12.36
370,548,0,2731,1027170,14.81081081081081
270,354,0,2732,1027524,13.11111111111111
220,332,0,2733,1027856,15.090909090909092
360,659,0,2734,1028515,18.305555555555557
90,122,0,2735,1028637,13.555555555555555
190,227,0,2736,1028864,11.947368421052632
390,615,0,2737,1029479,15.76923076923077
210,302,0,2738,1029781,14.380952380952381
300,463,0,2739,1030244,15.433333333333334
110,134,0,2740,1030378,12.181818181818182
310,558,0,2741,1030936,18.0
280,393,0,2742,1031329,14.035714285714286
160,257,0,2743,1031586,16.0625
310,474,0,2744,1032060,15.290322580645162
160,209,0,2745,1032269,13.0625
370,569,0,2746,1032838,15.378378378378379
390,562,0,2747,1033400,14.41025641025641
260,332,0,2748,1033732,12.76923076923077
320,475,0,2749,1034207,14.84375
340,510,0,2750,1034717,15.0
370,629,0,2751,1035346,17.0
90,138,0,2752,1035484,15.333333333333334
190,258,0,2753,1035742,13.578947368421053
140,279,0,2754,1036021,19.928571428571427
120,179,0,2755,1036200,14.916666666666666
290,495,0,2756,1036695,17.06896551724138
230,308,0,2757,1037003,13.391304347826088
320,473,0,2758,1037476,14.78125
220,321,0,2759,1037797,14.590909090909092
270,410,0,2760,1038207,15.185185185185185
190,230,0,2761,1038437,12.105263157894736
160,196,0,2762,1038633,12.25
130,145,0,2763,1038778,11.153846153846153
390,638,0,2764,1039416,16.358974358974358
300,435,0,2765,1039851,14.5
250,335,0,2766,1040186,13.4
270,399,0,2767,1040585,14.777777777777779
310,545,0,2768,1041130,17.580645161290324
520,812,0,2769,1041942,15.615384615384615
390,605,0,2770,1042547,15.512820512820513
210,229,0,2771,1042776,10.904761904761905
160,187,0,2772,1042963,11.6875
190,292,0,2773,1043255,15.368421052631579
170,230,0,2774,1043485,13.529411764705882
210,260,0,2775,1043745,12.380952380952381
240,354,0,2776,1044099,14.75
130,204,0,2777,1044303,15.692307692307692
220,325,0,2778,1044628,14.772727272727273
280,390,0,2779,1045018,13.928571428571429
450,769,0,2780,1045787,17.08888888888889
120,140,0,2781,1045927,11.666666666666666
260,313,0,2782,1046240,12.038461538461538
270,377,0,2783,1046617,13.962962962962964
190,220,0,2784,1046837,11.578947368421053
290,391,0,2785,1047228,13.482758620689655
290,422,0,2786,1047650,14.551724137931034
360,447,0,2787,1048097,12.416666666666666
230,346,0,2788,1048443,15.043478260869565
290,449,0,2789,1048892,15.482758620689655
380,542,0,2790,1049434,14.263157894736842
270,467,0,2791,1049901,17.296296296296298
340,547,0,2792,1050448,16.08823529411765
280,394,0,2793,1050842,14.071428571428571
380,605,0,2794,1051447,15.921052631578947
330,575,0,2795,1052022,17.424242424242426
310,468,0,2796,1052490,15.096774193548388
500,839,0,2797,1053329,16.78
110,160,0,2798,1053489,14.545454545454545
350,440,0,2799,1053929,12.571428571428571
360,504,0,2800,1054433,14.0
250,319,0,2801,1054752,12.76
140,216,0,2802,1054968,15.428571428571429
220,294,0,2803,1055262,13.363636363636363
260,361,0,2804,1055623,13.884615384615385
390,598,0,2805,1056221,15.333333333333334
330,495,0,2806,1056716,15.0
170,204,0,2807,1056920,12.0
200,252,0,2808,1057172,12.6
250,362,0,2809,1057534,14.48
140,147,0,2810,1057681,10.5
240,340,0,2811,1058021,14.166666666666666
300,531,0,2812,1058552,17.7
170,211,0,2813,1058763,12.411764705882353
190,277,0,2814,1059040,14.578947368421053
420,727,0,2815,1059767,17.30952380952381
290,363,0,2816,1060130,12.517241379310345
160,218,0,2817,1060348,13.625
270,357,0,2818,1060705,13.222222222222221
350,534,0,2819,1061239,15.257142857142858
280,410,0,2820,1061649,14.642857142857142
250,342,0,2821,1061991,13.68
210,337,0,2822,1062328,16.047619047619047
220,294,0,2823,1062622,13.363636363636363
90,100,0,2824,1062722,11.11111111111111
280,376,0,2825,1063098,13.428571428571429
340,462,0,2826,1063560,13.588235294117647
240,391,0,2827,1063951,16.291666666666668
270,400,0,2828,1064351,14.814814814814815
300,415,0,2829,1064766,13.833333333333334
410,624,0,2830,1065390,15.21951219512195
360,553,0,2831,1065943,15.36111111111111
190,266,0,2832,1066209,14.0
200,230,0,2833,1066439,11.5
150,222,0,2834,1066661,14.8
250,346,0,2835,1067007,13.84
120,149,0,2836,1067156,12.416666666666666
190,264,0,2837,1067420,13.894736842105264
290,417,0,2838,1067837,14.379310344827585
170,244,0,2839,1068081,14.352941176470589
340,566,0,2840,1068647,16.647058823529413
110,180,0,2841,1068827,16.363636363636363
290,389,0,2842,1069216,13.413793103448276
160,205,0,2843,1069421,12.8125
210,305,0,2844,1069726,14.523809523809524
280,367,0,2845,1070093,13.107142857142858
240,380,0,2846,1070473,15.833333333333334
240,350,0,2847,1070823,14.583333333333334
250,295,0,2848,1071118,11.8
240,395,0,2849,1071513,16.458333333333332
120,142,0,2850,1071655,11.833333333333334
290,421,0,2851,1072076,14.517241379310345
240,402,0,2852,1072478,16.75
170,243,0,2853,1072721,14.294117647058824
70,59,0,2854,1072780,8.428571428571429
220,362,0,2855,1073142,16.454545454545453
130,170,0,2856,1073312,13.076923076923077
130,178,0,2857,1073490,13.692307692307692
520,829,0,2858,1074319,15.942307692307692
140,209,0,2859,1074528,14.928571428571429
270,366,0,2860,1074894,13.555555555555555
490,757,0,2861,1075651,15.448979591836734
210,301,0,2862,1075952,14.333333333333334
270,399,0,2863,1076351,14.777777777777779
240,333,0,2864,1076684,13.875
270,403,0,2865,1077087,14.925925925925926
270,411,0,2866,1077498,15.222222222222221
190,265,0,2867,1077763,13.947368421052632
170,232,0,2868,1077995,13.647058823529411
130,155,0,2869,1078150,11.923076923076923
440,686,0,2870,1078836,15.590909090909092
300,445,0,2871,1079281,14.833333333333334
250,339,0,2872,1079620,13.56
440,748,0,2873,1080368,17.0
160,248,0,2874,1080616,15.5
250,354,0,2875,1080970,14.16
210,333,0,2876,1081303,15.857142857142858
150,232,0,2877,1081535,15.466666666666667
240,349,0,2878,1081884,14.541666666666666
150,179,0,2879,1082063,11.933333333333334
190,318,0,2880,1082381,16.736842105263158
330,538,0,2881,1082919,16.303030303030305
160,231,0,2882,1083150,14.4375
210,259,0,2883,1083409,12.333333333333334
410,622,0,2884,1084031,15.170731707317072
430,574,0,2885,1084605,13.348837209302326
270,382,0,2886,1084987,14.148148148148149
270,359,0,2887,1085346,13.296296296296296
300,448,0,2888,1085794,14.933333333333334
150,189,0,2889,1085983,12.6
310,434,0,2890,1086417,14.0
180,239,0,2891,1086656,13.277777777777779
210,311,0,2892,1086967,14.80952380952381
180,279,0,2893,1087246,15.5
200,288,0,2894,1087534,14.4
280,390,0,2895,1087924,13.928571428571429
260,425,0,2896,1088349,16.346153846153847
360,579,0,2897,1088928,16.083333333333332
210,305,0,2898,1089233,14.523809523809524
280,460,0,2899,1089693,16.428571428571427
140,213,0,2900,1089906,15.214285714285714
200,350,0,2901,1090256,17.5
230,338,0,2902,1090594,14.695652173913043
190,265,0,2903,1090859,13.947368421052632
210,323,0,2904,1091182,15.380952380952381
290,426,0,2905,1091608,14.689655172413794
160,244,0,2906,1091852,15.25
240,351,0,2907,1092203,14.625
290,449,0,2908,1092652,15.482758620689655
330,514,0,2909,1093166,15.575757575757576
220,377,0,2910,1093543,17.136363636363637
120,174,0,2911,1093717,14.5
240,344,0,2912,1094061,14.333333333333334
240,384,0,2913,1094445,16.0
150,236,0,2914,1094681,15.733333333333333
330,499,0,2915,1095180,15.121212121212121
440,712,0,2916,1095892,16.181818181818183
80,104,0,2917,1095996,13.0
210,295,0,2918,1096291,14.047619047619047
380,603,0,2919,1096894,15.868421052631579
200,257,0,2920,1097151,12.85
350,448,0,2921,1097599,12.8
270,375,0,2922,1097974,13.88888888888889
170,255,0,2923,1098229,15.0
340,569,0,2924,1098798,16.735294117647058
300,551,0,2925,1099349,18.366666666666667
190,213,0,2926,1099562,11.210526315789474
180,276,0,2927,1099838,15.333333333333334
320,466,0,2928,1100304,14.5625
370,676,0,2929,1100980,18.27027027027027
220,318,0,2930,1101298,14.454545454545455
170,258,0,2931,1101556,15.176470588235293
290,501,0,2932,1102057,17.275862068965516
300,385,0,2933,1102442,12.833333333333334
300,449,0,2934,1102891,14.966666666666667
340,492,0,2935,1103383,14.470588235294118
150,228,0,2936,1103611,15.2
190,281,0,2937,1103892,14.789473684210526
240,296,0,2938,1104188,12.333333333333334
240,361,0,2939,1104549,15.041666666666666
200,263,0,2940,1104812,13.15
250,379,0,2941,1105191,15.16
210,328,0,2942,1105519,15.619047619047619
200,321,0,2943,1105840,16.05
220,324,0,2944,1106164,14.727272727272727
270,390,0,2945,1106554,14.444444444444445
180,230,0,2946,1106784,12.777777777777779
240,296,0,2947,1107080,12.333333333333334
280,403,0,2948,1107483,14.392857142857142
230,330,0,2949,1107813,14.347826086956522
70,100,0,2950,1107913,14.285714285714286
120,182,0,2951,1108095,15.166666666666666
100,113,0,2952,1108208,11.3
130,217,0,2953,1108425,16.692307692307693
240,391,0,2954,1108816,16.291666666666668
270,348,0,2955,1109164,12.88888888888889
360,550,0,2956,1109714,15.277777777777779
260,333,0,2957,1110047,12.807692307692308
390,619,0,2958,1110666,15.871794871794872
380,594,0,2959,1111260,15.631578947368421
220,363,0,2960,1111623,16.5
340,481,0,2961,1112104,14.147058823529411
300,498,0,2962,1112602,16.6
290,442,0,2963,1113044,15.241379310344827
210,318,0,2964,1113362,15.142857142857142
120,168,0,2965,1113530,14.0
190,305,0,2966,1113835,16.05263157894737
240,380,0,2967,1114215,15.833333333333334
210,363,0,2968,1114578,17.285714285714285
290,421,0,2969,1114999,14.517241379310345
260,431,0,2970,1115430,16.576923076923077
190,295,0,2971,1115725,15.526315789473685
340,487,0,2972,1116212,14.323529411764707
260,363,0,2973,1116575,13.961538461538462
240,273,0,2974,1116848,11.375
200,325,0,2975,1117173,16.25
90,140,0,2976,1117313,15.555555555555555
290,433,0,2977,1117746,14.931034482758621
120,154,0,2978,1117900,12.833333333333334
210,460,0,2979,1118360,21.904761904761905
300,423,0,2980,1118783,14.1
90,113,0,2981,1118896,12.555555555555555
190,242,0,2982,1119138,12.736842105263158
120,114,0,2983,1119252,9.5
230,307,0,2984,1119559,13.347826086956522
90,120,0,2985,1119679,13.333333333333334
180,246,0,2986,1119925,13.666666666666666
330,530,0,2987,1120455,16.060606060606062
60,90,0,2988,1120545,15.0
180,231,0,2989,1120776,12.833333333333334
140,173,0,2990,1120949,12.357142857142858
140,206,0,2991,1121155,14.714285714285714
340,529,0,2992,1121684,15.558823529411764
170,171,0,2993,1121855,10.058823529411764
350,527,0,2994,1122382,15.057142857142857
260,426,0,2995,1122808,16.384615384615383
300,466,0,2996,1123274,15.533333333333333
200,299,0,2997,1123573,14.95
390,648,0,2998,1124221,16.615384615384617
190,261,0,2999,1124482,13.736842105263158
350,599,0,3000,1125081,17.114285714285714
140,196,0,3001,1125277,14.0
150,192,0,3002,1125469,12.8
510,830,0,3003,1126299,16.274509803921568
270,361,0,3004,1126660,13.37037037037037
350,525,0,3005,1127185,15.0
100,149,0,3006,1127334,14.9
440,732,0,3007,1128066,16.636363636363637
230,324,0,3008,1128390,14.08695652173913
400,623,0,3009,1129013,15.575
320,454,0,3010,1129467,14.1875
200,270,0,3011,1129737,13.5
310,443,0,3012,1130180,14.290322580645162
150,182,0,3013,1130362,12.133333333333333
280,398,0,3014,1130760,14.214285714285714
230,352,0,3015,1131112,15.304347826086957
260,340,0,3016,1131452,13.076923076923077
260,420,0,3017,1131872,16.153846153846153
300,425,0,3018,1132297,14.166666666666666
240,342,0,3019,1132639,14.25
340,451,0,3020,1133090,13.264705882352942
330,527,0,3021,1133617,15.969696969696969
330,464,0,3022,1134081,14.06060606060606
210,252,0,3023,1134333,12.0
160,245,0,3024,1134578,15.3125
190,254,0,3025,1134832,13.368421052631579
180,299,0,3026,1135131,16.61111111111111
200,307,0,3027,1135438,15.35
160,290,0,3028,1135728,18.125
430,666,0,3029,1136394,15.488372093023257
140,191,0,3030,1136585,13.642857142857142
230,321,0,3031,1136906,13.956521739130435
170,245,0,3032,1137151,14.411764705882353
390,691,0,3033,1137842,17.71794871794872
340,515,0,3034,1138357,15.147058823529411
240,353,0,3035,1138710,14.708333333333334
230,326,0,3036,1139036,14.173913043478262
330,571,0,3037,1139607,17.303030303030305
400,648,0,3038,1140255,16.2
140,155,0,3039,1140410,11.071428571428571
220,310,0,3040,1140720,14.090909090909092
250,364,0,3041,1141084,14.56
250,325,0,3042,1141409,13.0
500,750,0,3043,1142159,15.0
330,515,0,3044,1142674,15.606060606060606
170,193,0,3045,1142867,11.352941176470589
240,347,0,3046,1143214,14.458333333333334
380,542,0,3047,1143756,14.263157894736842
190,260,0,3048,1144016,13.68421052631579
270,448,0,3049,1144464,16.59259259259259
250,384,0,3050,1144848,15.36
180,206,0,3051,1145054,11.444444444444445
210,373,0,3052,1145427,17.761904761904763
290,426,0,3053,1145853,14.689655172413794
80,102,0,3054,1145955,12.75
500,803,0,3055,1146758,16.06
170,251,0,3056,1147009,14.764705882352942
260,378,0,3057,1147387,14.538461538461538
100,112,0,3058,1147499,11.2
260,436,0,3059,1147935,16.76923076923077
320,553,0,3060,1148488,17.28125
200,284,0,3061,1148772,14.2
300,507,0,3062,1149279,16.9
320,491,0,3063,1149770,15.34375
250,272,0,3064,1150042,10.88
290,412,0,3065,1150454,14.206896551724139
120,127,0,3066,1150581,10.583333333333334
360,481,0,3067,1151062,13.36111111111111
280,439,0,3068,1151501,15.678571428571429
180,269,0,3069,1151770,14.944444444444445
170,298,0,3070,1152068,17.529411764705884
200,314,0,3071,1152382,15.7
270,422,0,3072,1152804,15.62962962962963
350,591,0,3073,1153395,16.885714285714286
200,278,0,3074,1153673,13.9
170,228,0,3075,1153901,13.411764705882353
300,395,0,3076,1154296,13.166666666666666
200,297,0,3077,1154593,14.85
260,356,0,3078,1154949,13.692307692307692
280,438,0,3079,1155387,15.642857142857142
330,489,0,3080,1155876,14.818181818181818
370,562,0,3081,1156438,15.18918918918919
170,232,0,3082,1156670,13.647058823529411
210,273,0,3083,1156943,13.0
260,327,0,3084,1157270,12.576923076923077
220,330,0,3085,1157600,15.0
350,539,0,3086,1158139,15.4
300,411,0,3087,1158550,13.7
400,595,0,3088,1159145,14.875
330,397,0,3089,1159542,12.030303030303031
160,246,0,3090,1159788,15.375
380,588,0,3091,1160376,15.473684210526315
200,273,0,3092,1160649,13.65
290,352,0,3093,1161001,12.137931034482758
340,549,0,3094,1161550,16.147058823529413
270,366,0,3095,1161916,13.555555555555555
190,259,0,3096,1162175,13.631578947368421
210,333,0,3097,1162508,15.857142857142858
330,506,0,3098,1163014,15.333333333333334
230,306,0,3099,1163320,13.304347826086957
150,200,0,3100,1163520,13.333333333333334
350,596,0,3101,1164116,17.02857142857143
280,364,0,3102,1164480,13.0
190,303,0,3103,1164783,15.947368421052632
190,223,0,3104,1165006,11.736842105263158
270,435,0,3105,1165441,16.11111111111111
260,387,0,3106,1165828,14.884615384615385
420,639,0,3107,1166467,15.214285714285714
290,388,0,3108,1166855,13.379310344827585
280,409,0,3109,1167264,14.607142857142858
400,609,0,3110,1167873,15.225
110,127,0,3111,1168000,11.545454545454545
300,566,0,3112,1168566,18.866666666666667
380,593,0,3113,1169159,15.605263157894736
360,486,0,3114,1169645,13.5
340,491,0,3115,1170136,14.441176470588236
260,396,0,3116,1170532,15.23076923076923
200,305,0,3117,1170837,15.25
200,351,0,3118,1171188,17.55
280,528,0,3119,1171716,18.857142857142858
130,167,0,3120,1171883,12.846153846153847
490,966,0,3121,1172849,19.714285714285715
250,379,0,3122,1173228,15.16
210,265,0,3123,1173493,12.619047619047619
240,327,0,3124,1173820,13.625
250,329,0,3125,1174149,13.16
280,439,0,3126,1174588,15.678571428571429
240,367,0,3127,1174955,15.291666666666666
300,477,0,3128,1175432,15.9
200,260,0,3129,1175692,13.0
260,362,0,3130,1176054,13.923076923076923
250,482,0,3131,1176536,19.28
300,423,0,3132,1176959,14.1
120,168,0,3133,1177127,14.0
210,282,0,3134,1177409,13.428571428571429
200,307,0,3135,1177716,15.35
150,202,0,3136,1177918,13.466666666666667
240,375,0,3137,1178293,15.625
110,153,0,3138,1178446,13.909090909090908
200,301,0,3139,1178747,15.05
270,429,0,3140,1179176,15.88888888888889
200,273,0,3141,1179449,13.65
260,360,0,3142,1179809,13.846153846153847
220,323,0,3143,1180132,14.681818181818182
340,577,0,3144,1180709,16.970588235294116
320,469,0,3145,1181178,14.65625
290,384,0,3146,1181562,13.241379310344827
350,628,0,3147,1182190,17.942857142857143
170,236,0,3148,1182426,13.882352941176471
260,369,0,3149,1182795,14.192307692307692
300,475,0,3150,1183270,15.833333333333334
290,465,0,3151,1183735,16.03448275862069
230,384,0,3152,1184119,16.695652173913043
210,276,0,3153,1184395,13.142857142857142
470,921,0,3154,1185316,19.595744680851062
200,245,0,3155,1185561,12.25
170,222,0,3156,1185783,13.058823529411764
310,470,0,3157,1186253,15.161290322580646
330,394,0,3158,1186647,11.93939393939394
220,306,0,3159,1186953,13.909090909090908
360,537,0,3160,1187490,14.916666666666666
150,168,0,3161,1187658,11.2
160,236,0,3162,1187894,14.75
240,375,0,3163,1188269,15.625
150,198,0,3164,1188467,13.2
400,589,0,3165,1189056,14.725
420,597,0,3166,1189653,14.214285714285714
210,345,0,3167,1189998,16.428571428571427
340,524,0,3168,1190522,15.411764705882353
240,401,0,3169,1190923,16.708333333333332
420,740,0,3170,1191663,17.61904761904762
280,446,0,3171,1192109,15.928571428571429
330,514,0,3172,1192623,15.575757575757576
620,1149,0,3173,1193772,18.532258064516128
350,466,0,3174,1194238,13.314285714285715
390,645,0,3175,1194883,16.53846153846154
210,297,0,3176,1195180,14.142857142857142
330,471,0,3177,1195651,14.272727272727273
410,647,0,3178,1196298,15.78048780487805
290,386,0,3179,1196684,13.310344827586206
260,435,0,3180,1197119,16.73076923076923
210,299,0,3181,1197418,14.238095238095237
280,415,0,3182,1197833,14.821428571428571
220,319,0,3183,1198152,14.5
360,529,0,3184,1198681,14.694444444444445
210,283,0,3185,1198964,13.476190476190476
230,335,0,3186,1199299,14.565217391304348
190,239,0,3187,1199538,12.578947368421053
270,386,0,3188,1199924,14.296296296296296
250,384,0,3189,1200308,15.36
300,447,0,3190,1200755,14.9
330,618,0,3191,1201373,18.727272727272727
240,361,0,3192,1201734,15.041666666666666
130,163,0,3193,1201897,12.538461538461538
350,472,0,3194,1202369,13.485714285714286
350,632,0,3195,1203001,18.057142857142857
100,111,0,3196,1203112,11.1
250,382,0,3197,1203494,15.28
290,414,0,3198,1203908,14.275862068965518
230,303,0,3199,1204211,13.173913043478262
290,410,0,3200,1204621,14.137931034482758
130,166,0,3201,1204787,12.76923076923077
180,212,0,3202,1204999,11.777777777777779
260,397,0,3203,1205396,15.26923076923077
250,335,0,3204,1205731,13.4
340,495,0,3205,1206226,14.558823529411764
150,264,0,3206,1206490,17.6
410,718,0,3207,1207208,17.51219512195122
250,359,0,3208,1207567,14.36
470,726,0,3209,1208293,15.446808510638299
200,280,0,3210,1208573,14.0
460,682,0,3211,1209255,14.826086956521738
330,521,0,3212,1209776,15.787878787878787
260,407,0,3213,1210183,15.653846153846153
180,266,0,3214,1210449,14.777777777777779
150,175,0,3215,1210624,11.666666666666666
290,496,0,3216,1211120,17.103448275862068
290,428,0,3217,1211548,14.758620689655173
220,389,0,3218,1211937,17.681818181818183
550,984,0,3219,1212921,17.89090909090909
360,635,0,3220,1213556,17.63888888888889
330,538,0,3221,1214094,16.303030303030305
360,549,0,3222,1214643,15.25
190,266,0,3223,1214909,14.0
200,334,0,3224,1215243,16.7
280,387,0,3225,1215630,13.821428571428571
180,252,0,3226,1215882,14.0
120,157,0,3227,1216039,13.083333333333334
270,366,0,3228,1216405,13.555555555555555
350,533,0,3229,1216938,15.228571428571428
120,141,0,3230,1217079,11.75
150,206,0,3231,1217285,13.733333333333333
100,148,0,3232,1217433,14.8
70,81,0,3233,1217514,11.571428571428571
240,341,0,3234,1217855,14.208333333333334
180,266,0,3235,1218121,14.777777777777779
150,224,0,3236,1218345,14.933333333333334
300,375,0,3237,1218720,12.5
210,350,0,3238,1219070,16.666666666666668
140,208,0,3239,1219278,14.857142857142858
280,470,0,3240,1219748,16.785714285714285
260,386,0,3241,1220134,14.846153846153847
100,136,0,3242,1220270,13.6
70,92,0,3243,1220362,13.142857142857142
230,336,0,3244,1220698,14.608695652173912
250,362,0,3245,1221060,14.48
210,308,0,3246,1221368,14.666666666666666
490,737,0,3247,1222105,15.040816326530612
340,566,0,3248,1222671,16.647058823529413
290,455,0,3249,1223126,15.689655172413794
320,518,0,3250,1223644,16.1875
320,565,0,3251,1224209,17.65625
270,479,0,3252,1224688,17.74074074074074
180,239,0,3253,1224927,13.277777777777779
130,207,0,3254,1225134,15.923076923076923
130,186,0,3255,1225320,14.307692307692308
160,211,0,3256,1225531,13.1875
330,514,0,3257,1226045,15.575757575757576
400,590,0,3258,1226635,14.75
110,110,0,3259,1226745,10.0
220,371,0,3260,1227116,16.863636363636363
180,305,0,3261,1227421,16.944444444444443
220,296,0,3262,1227717,13.454545454545455
310,517,0,3263,1228234,16.677419354838708
140,194,0,3264,1228428,13.857142857142858
320,436,0,3265,1228864,13.625
90,88,0,3266,1228952,9.777777777777779
120,167,0,3267,1229119,13.916666666666666
360,555,0,3268,1229674,15.416666666666666
270,345,0,3269,1230019,12.777777777777779
240,395,0,3270,1230414,16.458333333333332
310,556,0,3271,1230970,17.93548387096774
230,369,0,3272,1231339,16.043478260869566
240,358,0,3273,1231697,14.916666666666666
190,253,0,3274,1231950,13.31578947368421
100,161,0,3275,1232111,16.1
110,142,0,3276,1232253,12.909090909090908
100,136,0,3277,1232389,13.6
190,289,0,3278,1232678,15.210526315789474
190,263,0,3279,1232941,13.842105263157896
360,569,0,3280,1233510,15.805555555555555
250,332,0,3281,1233842,13.28
90,113,0,3282,1233955,12.555555555555555
270,429,0,3283,1234384,15.88888888888889
300,446,0,3284,1234830,14.866666666666667
440,604,0,3285,1235434,13.727272727272727
310,442,0,3286,1235876,14.258064516129032
130,193,0,3287,1236069,14.846153846153847
200,296,0,3288,1236365,14.8
210,266,0,3289,1236631,12.666666666666666
280,434,0,3290,1237065,15.5
460,619,0,3291,1237684,13.456521739130435
280,474,0,3292,1238158,16.928571428571427
160,250,0,3293,1238408,15.625
260,435,0,3294,1238843,16.73076923076923
240,289,0,3295,1239132,12.041666666666666
200,316,0,3296,1239448,15.8
460,734,0,3297,1240182,15.956521739130435
200,289,0,3298,1240471,14.45
90,90,0,3299,1240561,10.0
220,303,0,3300,1240864,13.772727272727273
340,451,0,3301,1241315,13.264705882352942
190,227,0,3302,1241542,11.947368421052632
320,478,0,3303,1242020,14.9375
200,290,0,3304,1242310,14.5
170,205,0,3305,1242515,12.058823529411764
220,249,0,3306,1242764,11.318181818181818
190,297,0,3307,1243061,15.631578947368421
190,279,0,3308,1243340,14.68421052631579
200,310,0,3309,1243650,15.5
330,562,0,3310,1244212,17.03030303030303
80,125,0,3311,1244337,15.625
270,381,0,3312,1244718,14.11111111111111
210,294,0,3313,1245012,14.0
360,581,0,3314,1245593,16.13888888888889
200,314,0,3315,1245907,15.7
250,353,0,3316,1246260,14.12
360,652,0,3317,1246912,18.11111111111111
60,56,0,3318,1246968,9.333333333333334
190,214,0,3319,1247182,11.263157894736842
120,238,0,3320,1247420,19.833333333333332
180,258,0,3321,1247678,14.333333333333334
290,413,0,3322,1248091,14.241379310344827
260,370,0,3323,1248461,14.23076923076923
120,152,0,3324,1248613,12.666666666666666
130,162,0,3325,1248775,12.461538461538462
150,244,0,3326,1249019,16.266666666666666
310,461,0,3327,1249480,14.870967741935484
320,435,0,3328,1249915,13.59375
140,203,0,3329,1250118,14.5
320,501,0,3330,1250619,15.65625
120,111,0,3331,1250730,9.25
270,361,0,3332,1251091,13.37037037037037
340,501,0,3333,1251592,14.735294117647058
420,653,0,3334,1252245,15.547619047619047
270,400,0,3335,1252645,14.814814814814815
330,513,0,3336,1253158,15.545454545454545
320,529,0,3337,1253687,16.53125
320,552,0,3338,1254239,17.25
310,425,0,3339,1254664,13.709677419354838
250,366,0,3340,1255030,14.64
190,252,0,3341,1255282,13.263157894736842
160,242,0,3342,1255524,15.125
390,623,0,3343,1256147,15.974358974358974
260,370,0,3344,1256517,14.23076923076923
140,201,0,3345,1256718,14.357142857142858
180,269,0,3346,1256987,14.944444444444445
220,313,0,3347,1257300,14.227272727272727
120,135,0,3348,1257435,11.25
200,303,0,3349,1257738,15.15
400,573,0,3350,1258311,14.325
140,191,0,3351,1258502,13.642857142857142
270,393,0,3352,1258895,14.555555555555555
460,776,0,3353,1259671,16.869565217391305
260,379,0,3354,1260050,14.576923076923077
240,357,0,3355,1260407,14.875
390,636,0,3356,1261043,16.307692307692307
350,621,0,3357,1261664,17.742857142857144
210,381,0,3358,1262045,18.142857142857142
310,404,0,3359,1262449,13.03225806451613
280,467,0,3360,1262916,16.678571428571427
310,398,0,3361,1263314,12.838709677419354
250,366,0,3362,1263680,14.64
370,569,0,3363,1264249,15.378378378378379
380,679,0,3364,1264928,17.86842105263158
270,449,0,3365,1265377,16.62962962962963
170,225,0,3366,1265602,13.235294117647058
170,214,0,3367,1265816,12.588235294117647
430,700,0,3368,1266516,16.27906976744186
220,305,0,3369,1266821,13.863636363636363
290,467,0,3370,1267288,16.103448275862068
240,335,0,3371,1267623,13.958333333333334
240,327,0,3372,1267950,13.625
140,185,0,3373,1268135,13.214285714285714
190,210,0,3374,1268345,11.052631578947368
140,153,0,3375,1268498,10.928571428571429
210,315,0,3376,1268813,15.0
190,283,0,3377,1269096,14.894736842105264
160,201,0,3378,1269297,12.5625
490,771,0,3379,1270068,15.73469387755102
310,434,0,3380,1270502,14.0
440,724,0,3381,1271226,16.454545454545453
160,239,0,3382,1271465,14.9375
100,93,0,3383,1271558,9.3
190,310,0,3384,1271868,16.31578947368421
210,310,0,3385,1272178,14.761904761904763
200,257,0,3386,1272435,12.85
330,472,0,3387,1272907,14.303030303030303
400,649,0,3388,1273556,16.225
210,338,0,3389,1273894,16.095238095238095
220,304,0,3390,1274198,13.818181818181818
190,246,0,3391,1274444,12.947368421052632
280,433,0,3392,1274877,15.464285714285714
270,426,0,3393,1275303,15.777777777777779
320,456,0,3394,1275759,14.25
430,733,0,3395,1276492,17.046511627906977
360,583,0,3396,1277075,16.194444444444443
310,433,0,3397,1277508,13.96774193548387
170,280,0,3398,1277788,16.470588235294116
150,185,0,3399,1277973,12.333333333333334
330,533,0,3400,1278506,16.151515151515152
370,665,0,3401,1279171,17.972972972972972
330,532,0,3402,1279703,16.12121212121212
400,667,0,3403,1280370,16.675
230,349,0,3404,1280719,15.173913043478262
370,501,0,3405,1281220,13.54054054054054
250,324,0,3406,1281544,12.96
140,169,0,3407,1281713,12.071428571428571
110,172,0,3408,1281885,15.636363636363637
230,306,0,3409,1282191,13.304347826086957
210,370,0,3410,1282561,17.61904761904762
210,299,0,3411,1282860,14.238095238095237
400,723,0,3412,1283583,18.075
260,411,0,3413,1283994,15.807692307692308
150,255,0,3414,1284249,17.0
340,524,0,3415,1284773,15.411764705882353
320,383,0,3416,1285156,11.96875
220,266,0,3417,1285422,12.090909090909092
290,434,0,3418,1285856,14.96551724137931
240,340,0,3419,1286196,14.166666666666666
340,500,0,3420,1286696,14.705882352941176
320,404,0,3421,1287100,12.625
300,393,0,3422,1287493,13.1
190,249,0,3423,1287742,13.105263157894736
380,556,0,3424,1288298,14.631578947368421
270,411,0,3425,1288709,15.222222222222221
140,194,0,3426,1288903,13.857142857142858
420,688,0,3427,1289591,16.38095238095238
520,936,0,3428,1290527,18.0
220,277,0,3429,1290804,12.590909090909092
270,311,0,3430,1291115,11.518518518518519
310,505,0,3431,1291620,16.29032258064516
240,327,0,3432,1291947,13.625
350,501,0,3433,1292448,14.314285714285715
250,372,0,3434,1292820,14.88
260,411,0,3435,1293231,15.807692307692308
450,846,0,3436,1294077,18.8
310,487,0,3437,1294564,15.709677419354838
330,520,0,3438,1295084,15.757575757575758
360,559,0,3439,1295643,15.527777777777779
300,534,0,3440,1296177,17.8
260,439,0,3441,1296616,16.884615384615383
170,264,0,3442,1296880,15.529411764705882
330,525,0,3443,1297405,15.909090909090908
270,461,0,3444,1297866,17.074074074074073
280,447,0,3445,1298313,15.964285714285714
350,491,0,3446,1298804,14.028571428571428
110,141,0,3447,1298945,12.818181818181818
210,395,0,3448,1299340,18.80952380952381
60,53,0,3449,1299393,8.833333333333334
130,163,0,3450,1299556,12.538461538461538
180,260,0,3451,1299816,14.444444444444445
280,400,0,3452,1300216,14.285714285714286
180,261,0,3453,1300477,14.5
200,251,0,3454,1300728,12.55
360,514,0,3455,1301242,14.277777777777779
80,94,0,3456,1301336,11.75
140,157,0,3457,1301493,11.214285714285714
200,310,0,3458,1301803,15.5
180,211,0,3459,1302014,11.722222222222221
180,200,0,3460,1302214,11.11111111111111
360,561,0,3461,1302775,15.583333333333334
120,164,0,3462,1302939,13.666666666666666
210,300,0,3463,1303239,14.285714285714286
260,374,0,3464,1303613,14.384615384615385
170,291,0,3465,1303904,17.11764705882353
200,273,0,3466,1304177,13.65
90,125,0,3467,1304302,13.88888888888889
270,425,0,3468,1304727,15.74074074074074
230,332,0,3469,1305059,14.434782608695652
140,211,0,3470,1305270,15.071428571428571
360,621,0,3471,1305891,17.25
400,623,0,3472,1306514,15.575
360,553,0,3473,1307067,15.36111111111111
50,57,0,3474,1307124,11.4
230,350,0,3475,1307474,15.217391304347826
210,304,0,3476,1307778,14.476190476190476
140,238,0,3477,1308016,17.0
240,341,0,3478,1308357,14.208333333333334
110,157,0,3479,1308514,14.272727272727273
180,241,0,3480,1308755,13.38888888888889
90,141,0,3481,1308896,15.666666666666666
210,375,0,3482,1309271,17.857142857142858
310,459,0,3483,1309730,14.806451612903226
160,238,0,3484,1309968,14.875
190,290,0,3485,1310258,15.263157894736842
250,364,0,3486,1310622,14.56
160,225,0,3487,1310847,14.0625
360,500,0,3488,1311347,13.88888888888889
260,378,0,3489,1311725,14.538461538461538
420,555,0,3490,1312280,13.214285714285714
430,660,0,3491,1312940,15.348837209302326
110,103,0,3492,1313043,9.363636363636363
180,281,0,3493,1313324,15.61111111111111
360,593,0,3494,1313917,16.47222222222222
200,278,0,3495,1314195,13.9
180,277,0,3496,1314472,15.38888888888889
140,156,0,3497,1314628,11.142857142857142
300,475,0,3498,1315103,15.833333333333334
370,555,0,3499,1315658,15.0
210,313,0,3500,1315971,14.904761904761905
330,556,0,3501,1316527,16.848484848484848
340,488,0,3502,1317015,14.352941176470589
120,175,0,3503,1317190,14.583333333333334
230,282,0,3504,1317472,12.26086956521739
100,90,0,3505,1317562,9.0
140,247,0,3506,1317809,17.642857142857142
170,199,0,3507,1318008,11.705882352941176
280,415,0,3508,1318423,14.821428571428571
280,488,0,3509,1318911,17.428571428571427
380,579,0,3510,1319490,15.236842105263158
250,425,0,3511,1319915,17.0
340,548,0,3512,1320463,16.11764705882353
160,244,0,3513,1320707,15.25
100,146,0,3514,1320853,14.6
140,170,0,3515,1321023,12.142857142857142
80,101,0,3516,1321124,12.625
110,163,0,3517,1321287,14.818181818181818
280,358,0,3518,1321645,12.785714285714286
180,243,0,3519,1321888,13.5
310,468,0,3520,1322356,15.096774193548388
230,306,0,3521,1322662,13.304347826086957
480,859,0,3522,1323521,17.895833333333332
320,443,0,3523,1323964,13.84375
330,414,0,3524,1324378,12.545454545454545
240,341,0,3525,1324719,14.208333333333334
250,452,0,3526,1325171,18.08
80,113,0,3527,1325284,14.125
480,722,0,3528,1326006,15.041666666666666
120,197,0,3529,1326203,16.416666666666668
130,188,0,3530,1326391,14.461538461538462
200,238,0,3531,1326629,11.9
460,698,0,3532,1327327,15.173913043478262
430,705,0,3533,1328032,16.3953488372093
390,571,0,3534,1328603,14.64102564102564
190,277,0,3535,1328880,14.578947368421053
230,344,0,3536,1329224,14.956521739130435
200,243,0,3537,1329467,12.15
400,542,0,3538,1330009,13.55
440,652,0,3539,1330661,14.818181818181818
140,222,0,3540,1330883,15.857142857142858
310,584,0,3541,1331467,18.838709677419356
220,305,0,3542,1331772,13.863636363636363
380,542,0,3543,1332314,14.263157894736842
150,224,0,3544,1332538,14.933333333333334
300,483,0,3545,1333021,16.1
180,302,0,3546,1333323,16.77777777777778
360,551,0,3547,1333874,15.305555555555555
220,336,0,3548,1334210,15.272727272727273
130,155,0,3549,1334365,11.923076923076923
240,391,0,3550,1334756,16.291666666666668
380,634,0,3551,1335390,16.68421052631579
440,765,0,3552,1336155,17.386363636363637
280,398,0,3553,1336553,14.214285714285714
130,207,0,3554,1336760,15.923076923076923
270,384,0,3555,1337144,14.222222222222221
230,348,0,3556,1337492,15.130434782608695
160,197,0,3557,1337689,12.3125
410,747,0,3558,1338436,18.21951219512195
260,320,0,3559,1338756,12.307692307692308
110,186,0,3560,1338942,16.90909090909091
190,269,0,3561,1339211,14.157894736842104
310,455,0,3562,1339666,14.67741935483871
370,526,0,3563,1340192,14.216216216216216
300,459,0,3564,1340651,15.3
250,377,0,3565,1341028,15.08
350,624,0,3566,1341652,17.82857142857143
350,574,0,3567,1342226,16.4
160,191,0,3568,1342417,11.9375
260,432,0,3569,1342849,16.615384615384617
320,467,0,3570,1343316,14.59375
160,191,0,3571,1343507,11.9375
250,334,0,3572,1343841,13.36
310,513,0,3573,1344354,16.548387096774192
330,542,0,3574,1344896,16.424242424242426
280,375,0,3575,1345271,13.392857142857142
290,412,0,3576,1345683,14.206896551724139
250,398,0,3577,1346081,15.92
500,878,0,3578,1346959,17.56
300,461,0,3579,1347420,15.366666666666667
300,370,0,3580,1347790,12.333333333333334
260,352,0,3581,1348142,13.538461538461538
250,366,0,3582,1348508,14.64
240,344,0,3583,1348852,14.333333333333334
330,437,0,3584,1349289,13.242424242424242
330,491,0,3585,1349780,14.878787878787879
240,390,0,3586,1350170,16.25
340,615,0,3587,1350785,18.08823529411765
240,315,0,3588,1351100,13.125
120,143,0,3589,1351243,11.916666666666666
340,425,0,3590,1351668,12.5
340,548,0,3591,1352216,16.11764705882353
150,171,0,3592,1352387,11.4
410,682,0,3593,1353069,16.634146341463413
320,520,0,3594,1353589,16.25
130,173,0,3595,1353762,13.307692307692308
110,160,0,3596,1353922,14.545454545454545
250,386,0,3597,1354308,15.44
230,322,0,3598,1354630,14.0
300,436,0,3599,1355066,14.533333333333333
220,372,0,3600,1355438,16.90909090909091
250,387,0,3601,1355825,15.48
400,640,0,3602,1356465,16.0
180,240,0,3603,1356705,13.333333333333334
170,274,0,3604,1356979,16.11764705882353
180,250,0,3605,1357229,13.88888888888889
270,368,0,3606,1357597,13.62962962962963
190,305,0,3607,1357902,16.05263157894737
230,392,0,3608,1358294,17.043478260869566
300,460,0,3609,1358754,15.333333333333334
310,460,0,3610,1359214,14.838709677419354
140,219,0,3611,1359433,15.642857142857142
160,205,0,3612,1359638,12.8125
390,624,0,3613,1360262,16.0
210,321,0,3614,1360583,15.285714285714286
60,75,0,3615,1360658,12.5
440,801,0,3616,1361459,18.204545454545453
210,277,0,3617,1361736,13.19047619047619
300,414,0,3618,1362150,13.8
270,450,0,3619,1362600,16.666666666666668
300,449,0,3620,1363049,14.966666666666667
280,407,0,3621,1363456,14.535714285714286
420,684,0,3622,1364140,16.285714285714285
120,143,0,3623,1364283,11.916666666666666
290,351,0,3624,1364634,12.10344827586207
290,402,0,3625,1365036,13.862068965517242
250,366,0,3626,1365402,14.64
340,532,0,3627,1365934,15.647058823529411
320,513,0,3628,1366447,16.03125
560,848,0,3629,1367295,15.142857142857142
120,163,0,3630,1367458,13.583333333333334
200,312,0,3631,1367770,15.6
290,454,0,3632,1368224,15.655172413793103
370,590,0,3633,1368814,15.945945945945946
250,329,0,3634,1369143,13.16
90,142,0,3635,1369285,15.777777777777779
160,261,0,3636,1369546,16.3125
260,392,0,3637,1369938,15.076923076923077
510,759,0,3638,1370697,14.882352941176471
170,261,0,3639,1370958,15.352941176470589
270,393,0,3640,1371351,14.555555555555555
200,336,0,3641,1371687,16.8
230,326,0,3642,1372013,14.173913043478262
370,576,0,3643,1372589,15.567567567567568
180,238,0,3644,1372827,13.222222222222221
360,580,0,3645,1373407,16.11111111111111
260,391,0,3646,1373798,15.038461538461538
240,345,0,3647,1374143,14.375
220,299,0,3648,1374442,13.590909090909092
270,406,0,3649,1374848,15.037037037037036
190,266,0,3650,1375114,14.0
230,418,0,3651,1375532,18.17391304347826
330,470,0,3652,1376002,14.242424242424242
430,720,0,3653,1376722,16.74418604651163
130,136,0,3654,1376858,10.461538461538462
270,452,0,3655,1377310,16.74074074074074
250,341,0,3656,1377651,13.64
160,204,0,3657,1377855,12.75
350,438,0,3658,1378293,12.514285714285714
470,738,0,3659,1379031,15.702127659574469
140,252,0,3660,1379283,18.0
410,649,0,3661,1379932,15.829268292682928
230,390,0,3662,1380322,16.956521739130434
210,349,0,3663,1380671,16.61904761904762
330,495,0,3664,1381166,15.0
330,404,0,3665,1381570,12.242424242424242
330,464,0,3666,1382034,14.06060606060606
110,171,0,3667,1382205,15.545454545454545
130,166,0,3668,1382371,12.76923076923077
250,342,0,3669,1382713,13.68
220,220,0,3670,1382933,10.0
420,635,0,3671,1383568,15.119047619047619
310,437,0,3672,1384005,14.096774193548388
120,146,0,3673,1384151,12.166666666666666
430,710,0,3674,1384861,16.511627906976745
200,258,0,3675,1385119,12.9
290,467,0,3676,1385586,16.103448275862068
190,272,0,3677,1385858,14.31578947368421
190,277,0,3678,1386135,14.578947368421053
190,321,0,3679,1386456,16.894736842105264
240,320,0,3680,1386776,13.333333333333334
360,571,0,3681,1387347,15.86111111111111
330,515,0,3682,1387862,15.606060606060606
360,526,0,3683,1388388,14.61111111111111
420,596,0,3684,1388984,14.19047619047619
190,272,0,3685,1389256,14.31578947368421
310,579,0,3686,1389835,18.677419354838708
290,401,0,3687,1390236,13.827586206896552
230,372,0,3688,1390608,16.17391304347826
330,498,0,3689,1391106,15.090909090909092
280,381,0,3690,1391487,13.607142857142858
310,519,0,3691,1392006,16.741935483870968
240,283,0,3692,1392289,11.791666666666666
310,511,0,3693,1392800,16.483870967741936
230,294,0,3694,1393094,12.782608695652174
280,483,0,3695,1393577,17.25
210,343,0,3696,1393920,16.333333333333332
370,487,0,3697,1394407,13.162162162162161
200,272,0,3698,1394679,13.6
410,723,0,3699,1395402,17.634146341463413
150,212,0,3700,1395614,14.133333333333333
370,563,0,3701,1396177,15.216216216216216
330,538,0,3702,1396715,16.303030303030305
320,548,0,3703,1397263,17.125
280,468,0,3704,1397731,16.714285714285715
250,322,0,3705,1398053,12.88
210,289,0,3706,1398342,13.761904761904763
300,434,0,3707,1398776,14.466666666666667
440,649,0,3708,1399425,14.75
170,238,0,3709,1399663,14.0
90,135,0,3710,1399798,15.0
280,393,0,3711,1400191,14.035714285714286
260,374,0,3712,1400565,14.384615384615385
170,210,0,3713,1400775,12.352941176470589
280,406,0,3714,1401181,14.5
250,310,0,3715,1401491,12.4
130,156,0,3716,1401647,12.0
170,173,0,3717,1401820,10.176470588235293
420,749,0,3718,1402569,17.833333333333332
340,568,0,3719,1403137,16.705882352941178
240,246,0,3720,1403383,10.25
420,713,0,3721,1404096,16.976190476190474
270,382,0,3722,1404478,14.148148148148149
360,529,0,3723,1405007,14.694444444444445
110,171,0,3724,1405178,15.545454545454545
190,238,0,3725,1405416,12.526315789473685
360,542,0,3726,1405958,15.055555555555555
130,203,0,3727,1406161,15.615384615384615
420,726,0,3728,1406887,17.285714285714285
250,365,0,3729,1407252,14.6
270,386,0,3730,1407638,14.296296296296296
280,369,0,3731,1408007,13.178571428571429
320,466,0,3732,1408473,14.5625
290,474,0,3733,1408947,16.344827586206897
160,260,0,3734,1409207,16.25
290,352,0,3735,1409559,12.137931034482758
210,327,0,3736,1409886,15.571428571428571
320,439,0,3737,1410325,13.71875
270,426,0,3738,1410751,15.777777777777779
230,345,0,3739,1411096,15.0
230,317,0,3740,1411413,13.782608695652174
210,293,0,3741,1411706,13.952380952380953
430,717,0,3742,1412423,16.674418604651162
300,461,0,3743,1412884,15.366666666666667
180,288,0,3744,1413172,16.0
230,303,0,3745,1413475,13.173913043478262
350,581,0,3746,1414056,16.6
170,226,0,3747,1414282,13.294117647058824
320,530,0,3748,1414812,16.5625
200,285,0,3749,1415097,14.25
340,484,0,3750,1415581,14.235294117647058
290,427,0,3751,1416008,14.724137931034482
180,312,0,3752,1416320,17.333333333333332
340,537,0,3753,1416857,15.794117647058824
250,343,0,3754,1417200,13.72
200,276,0,3755,1417476,13.8
190,241,0,3756,1417717,12.68421052631579
280,452,0,3757,1418169,16.142857142857142
270,393,0,3758,1418562,14.555555555555555
400,634,0,3759,1419196,15.85
280,450,0,3760,1419646,16.071428571428573
370,538,0,3761,1420184,14.54054054054054
530,1091,0,3762,1421275,20.58490566037736
270,443,0,3763,1421718,16.40740740740741
390,603,0,3764,1422321,15.461538461538462
310,426,0,3765,1422747,13.741935483870968
320,449,0,3766,1423196,14.03125
270,340,0,3767,1423536,12.592592592592593
240,372,0,3768,1423908,15.5
130,165,0,3769,1424073,12.692307692307692
310,412,0,3770,1424485,13.290322580645162
140,195,0,3771,1424680,13.928571428571429
240,305,0,3772,1424985,12.708333333333334
250,336,0,3773,1425321,13.44
200,269,0,3774,1425590,13.45
290,428,0,3775,1426018,14.758620689655173
200,305,0,3776,1426323,15.25
220,288,0,3777,1426611,13.090909090909092
290,475,0,3778,1427086,16.379310344827587
330,486,0,3779,1427572,14.727272727272727
400,763,0,3780,1428335,19.075
160,163,0,3781,1428498,10.1875
230,346,0,3782,1428844,15.043478260869565
270,406,0,3783,1429250,15.037037037037036
120,157,0,3784,1429407,13.083333333333334
270,392,0,3785,1429799,14.518518518518519
240,322,0,3786,1430121,13.416666666666666
380,538,0,3787,1430659,14.157894736842104
200,278,0,3788,1430937,13.9
220,348,0,3789,1431285,15.818181818181818
310,406,0,3790,1431691,13.096774193548388
200,318,0,3791,1432009,15.9
330,460,0,3792,1432469,13.93939393939394
570,1019,0,3793,1433488,17.87719298245614
430,678,0,3794,1434166,15.767441860465116
270,395,0,3795,1434561,14.62962962962963
200,284,0,3796,1434845,14.2
310,481,0,3797,1435326,15.516129032258064
200,307,0,3798,1435633,15.35
200,266,0,3799,1435899,13.3
230,302,0,3800,1436201,13.130434782608695
320,453,0,3801,1436654,14.15625
110,122,0,3802,1436776,11.090909090909092
290,403,0,3803,1437179,13.89655172413793
340,612,0,3804,1437791,18.0
150,262,0,3805,1438053,17.466666666666665
240,358,0,3806,1438411,14.916666666666666
280,522,0,3807,1438933,18.642857142857142
100,110,0,3808,1439043,11.0
270,433,0,3809,1439476,16.037037037037038
200,310,0,3810,1439786,15.5
360,516,0,3811,1440302,14.333333333333334
180,236,0,3812,1440538,13.11111111111111
130,169,0,3813,1440707,13.0
190,301,0,3814,1441008,15.842105263157896
240,345,0,3815,1441353,14.375
160,166,0,3816,1441519,10.375
250,395,0,3817,1441914,15.8
160,211,0,3818,1442125,13.1875
250,328,0,3819,1442453,13.12
150,245,0,3820,1442698,16.333333333333332
160,251,0,3821,1442949,15.6875
240,326,0,3822,1443275,13.583333333333334
160,210,0,3823,1443485,13.125
450,644,0,3824,1444129,14.311111111111112
290,419,0,3825,1444548,14.448275862068966
340,536,0,3826,1445084,15.764705882352942
290,393,0,3827,1445477,13.551724137931034
150,228,0,3828,1445705,15.2
340,560,0,3829,1446265,16.470588235294116
210,300,0,3830,1446565,14.285714285714286
240,360,0,3831,1446925,15.0
380,606,0,3832,1447531,15.947368421052632
450,659,0,3833,1448190,14.644444444444444
260,441,0,3834,1448631,16.96153846153846
150,200,0,3835,1448831,13.333333333333334
70,76,0,3836,1448907,10.857142857142858
150,235,0,3837,1449142,15.666666666666666
260,385,0,3838,1449527,14.807692307692308
350,573,0,3839,1450100,16.37142857142857
240,374,0,3840,1450474,15.583333333333334
140,184,0,3841,1450658,13.142857142857142
370,480,0,3842,1451138,12.972972972972974
360,592,0,3843,1451730,16.444444444444443
160,227,0,3844,1451957,14.1875
210,295,0,3845,1452252,14.047619047619047
150,194,0,3846,1452446,12.933333333333334
220,286,0,3847,1452732,13.0
260,305,0,3848,1453037,11.73076923076923
260,404,0,3849,1453441,15.538461538461538
160,282,0,3850,1453723,17.625
200,249,0,3851,1453972,12.45
180,207,0,3852,1454179,11.5
250,383,0,3853,1454562,15.32
360,606,0,3854,1455168,16.833333333333332
190,296,0,3855,1455464,15.578947368421053
190,263,0,3856,1455727,13.842105263157896
390,624,0,3857,1456351,16.0
470,812,0,3858,1457163,17.27659574468085
270,339,0,3859,1457502,12.555555555555555
170,270,0,3860,1457772,15.882352941176471
430,695,0,3861,1458467,16.162790697674417
290,354,0,3862,1458821,12.206896551724139
240,361,0,3863,1459182,15.041666666666666
410,694,0,3864,1459876,16.926829268292682
370,578,0,3865,1460454,15.621621621621621
110,135,0,3866,1460589,12.272727272727273
170,231,0,3867,1460820,13.588235294117647
200,325,0,3868,1461145,16.25
130,184,0,3869,1461329,14.153846153846153
190,277,0,3870,1461606,14.578947368421053
190,263,0,3871,1461869,13.842105263157896
170,235,0,3872,1462104,13.823529411764707
270,395,0,3873,1462499,14.62962962962963
160,214,0,3874,1462713,13.375
280,374,0,3875,1463087,13.357142857142858
470,746,0,3876,1463833,15.872340425531915
350,475,0,3877,1464308,13.571428571428571
260,369,0,3878,1464677,14.192307692307692
250,368,0,3879,1465045,14.72
170,259,0,3880,1465304,15.235294117647058
550,968,0,3881,1466272,17.6
200,257,0,3882,1466529,12.85
350,551,0,3883,1467080,15.742857142857142
200,276,0,3884,1467356,13.8
330,502,0,3885,1467858,15.212121212121213
470,892,0,3886,1468750,18.97872340425532
420,690,0,3887,1469440,16.428571428571427
230,376,0,3888,1469816,16.347826086956523
250,427,0,3889,1470243,17.08
280,354,0,3890,1470597,12.642857142857142
260,381,0,3891,1470978,14.653846153846153
290,392,0,3892,1471370,13.517241379310345
250,349,0,3893,1471719,13.96
300,389,0,3894,1472108,12.966666666666667
210,362,0,3895,1472470,17.238095238095237
310,503,0,3896,1472973,16.225806451612904
220,325,0,3897,1473298,14.772727272727273
300,449,0,3898,1473747,14.966666666666667
230,344,0,3899,1474091,14.956521739130435
130,169,0,3900,1474260,13.0
300,456,0,3901,1474716,15.2
380,646,0,3902,1475362,17.0
180,254,0,3903,1475616,14.11111111111111
230,342,0,3904,1475958,14.869565217391305
380,580,0,3905,1476538,15.263157894736842
160,228,0,3906,1476766,14.25
360,579,0,3907,1477345,16.083333333333332
380,581,0,3908,1477926,15.289473684210526
280,442,0,3909,1478368,15.785714285714286
130,207,0,3910,1478575,15.923076923076923
180,259,0,3911,1478834,14.38888888888889
90,110,0,3912,1478944,12.222222222222221
120,190,0,3913,1479134,15.833333333333334
410,633,0,3914,1479767,15.439024390243903
230,353,0,3915,1480120,15.347826086956522
490,725,0,3916,1480845,14.795918367346939
160,222,0,3917,1481067,13.875
190,276,0,3918,1481343,14.526315789473685
110,203,0,3919,1481546,18.454545454545453
110,99,0,3920,1481645,9.0
250,303,0,3921,1481948,12.12
250,396,0,3922,1482344,15.84
320,499,0,3923,1482843,15.59375
400,669,0,3924,1483512,16.725
200,256,0,3925,1483768,12.8
200,247,0,3926,1484015,12.35
200,264,0,3927,1484279,13.2
200,301,0,3928,1484580,15.05
160,212,0,3929,1484792,13.25
170,255,0,3930,1485047,15.0
300,463,0,3931,1485510,15.433333333333334
360,559,0,3932,1486069,15.527777777777779
160,223,0,3933,1486292,13.9375
240,314,0,3934,1486606,13.083333333333334
140,191,0,3935,1486797,13.642857142857142
370,544,0,3936,1487341,14.702702702702704
240,367,0,3937,1487708,15.291666666666666
260,413,0,3938,1488121,15.884615384615385
280,384,0,3939,1488505,13.714285714285714
340,412,0,3940,1488917,12.117647058823529
110,183,0,3941,1489100,16.636363636363637
160,219,0,3942,1489319,13.6875
100,154,0,3943,1489473,15.4
70,80,0,3944,1489553,11.428571428571429
120,217,0,3945,1489770,18.083333333333332
370,549,0,3946,1490319,14.837837837837839
150,236,0,3947,1490555,15.733333333333333
190,317,0,3948,1490872,16.68421052631579
320,521,0,3949,1491393,16.28125
210,343,0,3950,1491736,16.333333333333332
180,248,0,3951,1491984,13.777777777777779
250,347,0,3952,1492331,13.88
150,217,0,3953,1492548,14.466666666666667
290,382,0,3954,1492930,13.172413793103448
330,576,0,3955,1493506,17.454545454545453
260,370,0,3956,1493876,14.23076923076923
190,272,0,3957,1494148,14.31578947368421
170,253,0,3958,1494401,14.882352941176471
240,351,0,3959,1494752,14.625
380,637,0,3960,1495389,16.763157894736842
140,216,0,3961,1495605,15.428571428571429
290,430,0,3962,1496035,14.827586206896552
280,386,0,3963,1496421,13.785714285714286
170,244,0,3964,1496665,14.352941176470589
400,677,0,3965,1497342,16.925
280,394,0,3966,1497736,14.071428571428571
150,225,0,3967,1497961,15.0
170,176,0,3968,1498137,10.352941176470589
110,147,0,3969,1498284,13.363636363636363
210,283,0,3970,1498567,13.476190476190476
320,512,0,3971,1499079,16.0
350,510,0,3972,1499589,14.571428571428571
290,388,0,3973,1499977,13.379310344827585
140,199,0,3974,1500176,14.214285714285714
190,265,0,3975,1500441,13.947368421052632
100,121,0,3976,1500562,12.1
200,278,0,3977,1500840,13.9
300,431,0,3978,1501271,14.366666666666667
200,274,0,3979,1501545,13.7
210,298,0,3980,1501843,14.19047619047619
210,351,0,3981,1502194,16.714285714285715
160,203,0,3982,1502397,12.6875
240,377,0,3983,1502774,15.708333333333334
150,172,0,3984,1502946,11.466666666666667
290,423,0,3985,1503369,14.586206896551724
310,507,0,3986,1503876,16.35483870967742
330,502,0,3987,1504378,15.212121212121213
390,577,0,3988,1504955,14.794871794871796
330,565,0,3989,1505520,17.12121212121212
240,364,0,3990,1505884,15.166666666666666
390,581,0,3991,1506465,14.897435897435898
220,341,0,3992,1506806,15.5
300,499,0,3993,1507305,16.633333333333333
240,320,0,3994,1507625,13.333333333333334
200,318,0,3995,1507943,15.9
200,288,0,3996,1508231,14.4
280,426,0,3997,1508657,15.214285714285714
130,151,0,3998,1508808,11.615384615384615
210,297,0,3999,1509105,14.142857142857142
210,319,0,4000,1509424,15.19047619047619
370,679,0,4001,1510103,18.35135135135135
350,602,0,4002,1510705,17.2
340,504,0,4003,1511209,14.823529411764707
240,324,0,4004,1511533,13.5
160,184,0,4005,1511717,11.5
380,608,0,4006,1512325,16.0
100,106,0,4007,1512431,10.6
150,240,0,4008,1512671,16.0
320,410,0,4009,1513081,12.8125
200,314,0,4010,1513395,15.7
220,365,0,4011,1513760,16.59090909090909
150,193,0,4012,1513953,12.866666666666667
250,380,0,4013,1514333,15.2
290,386,0,4014,1514719,13.310344827586206
190,293,0,4015,1515012,15.421052631578947
380,561,0,4016,1515573,14.763157894736842
330,402,0,4017,1515975,12.181818181818182
370,570,0,4018,1516545,15.405405405405405
100,147,0,4019,1516692,14.7
450,747,0,4020,1517439,16.6
130,176,0,4021,1517615,13.538461538461538
370,512,0,4022,1518127,13.837837837837839
190,295,0,4023,1518422,15.526315789473685
450,778,0,4024,1519200,17.288888888888888
150,144,0,4025,1519344,9.6
230,303,0,4026,1519647,13.173913043478262
90,125,0,4027,1519772,13.88888888888889
280,439,0,4028,1520211,15.678571428571429
370,597,0,4029,1520808,16.135135135135137
220,323,0,4030,1521131,14.681818181818182
120,152,0,4031,1521283,12.666666666666666
330,511,0,4032,1521794,15.484848484848484
210,291,0,4033,1522085,13.857142857142858
360,644,0,4034,1522729,17.88888888888889
140,196,0,4035,1522925,14.0
330,489,0,4036,1523414,14.818181818181818
320,571,0,4037,1523985,17.84375
400,650,0,4038,1524635,16.25
110,159,0,4039,1524794,14.454545454545455
200,267,0,4040,1525061,13.35
260,389,0,4041,1525450,14.961538461538462
280,404,0,4042,1525854,14.428571428571429
360,518,0,4043,1526372,14.38888888888889
150,270,0,4044,1526642,18.0
290,368,0,4045,1527010,12.689655172413794
320,538,0,4046,1527548,16.8125
250,373,0,4047,1527921,14.92
60,66,0,4048,1527987,11.0
420,724,0,4049,1528711,17.238095238095237
90,122,0,4050,1528833,13.555555555555555
370,589,0,4051,1529422,15.91891891891892
150,218,0,4052,1529640,14.533333333333333
160,268,0,4053,1529908,16.75
420,651,0,4054,1530559,15.5
190,243,0,4055,1530802,12.789473684210526
350,562,0,4056,1531364,16.057142857142857
450,654,0,4057,1532018,14.533333333333333
120,191,0,4058,1532209,15.916666666666666
150,236,0,4059,1532445,15.733333333333333
220,362,0,4060,1532807,16.454545454545453
350,554,0,4061,1533361,15.82857142857143
410,699,0,4062,1534060,17.048780487804876
100,122,0,4063,1534182,12.2
320,583,0,4064,1534765,18.21875
340,504,0,4065,1535269,14.823529411764707
140,219,0,4066,1535488,15.642857142857142
330,482,0,4067,1535970,14.606060606060606
370,524,0,4068,1536494,14.162162162162161
200,296,0,4069,1536790,14.8
330,477,0,4070,1537267,14.454545454545455
250,336,0,4071,1537603,13.44
420,739,0,4072,1538342,17.595238095238095
260,384,0,4073,1538726,14.76923076923077
200,289,0,4074,1539015,14.45
360,588,0,4075,1539603,16.333333333333332
360,591,0,4076,1540194,16.416666666666668
240,275,0,4077,1540469,11.458333333333334
300,493,0,4078,1540962,16.433333333333334
340,518,0,4079,1541480,15.235294117647058
260,418,0,4080,1541898,16.076923076923077
310,409,0,4081,1542307,13.193548387096774
210,291,0,4082,1542598,13.857142857142858
130,198,0,4083,1542796,15.23076923076923
440,773,0,4084,1543569,17.568181818181817
100,176,0,4085,1543745,17.6
270,426,0,4086,1544171,15.777777777777779
220,362,0,4087,1544533,16.454545454545453
280,391,0,4088,1544924,13.964285714285714
140,153,0,4089,1545077,10.928571428571429
270,347,0,4090,1545424,12.851851851851851
80,103,0,4091,1545527,12.875
140,167,0,4092,1545694,11.928571428571429
200,255,0,4093,1545949,12.75
260,386,0,4094,1546335,14.846153846153847
440,717,0,4095,1547052,16.295454545454547
90,135,0,4096,1547187,15.0
110,169,0,4097,1547356,15.363636363636363
240,299,0,4098,1547655,12.458333333333334
300,404,0,4099,1548059,13.466666666666667
90,113,0,4100,1548172,12.555555555555555
340,523,0,4101,1548695,15.382352941176471
330,417,0,4102,1549112,12.636363636363637
270,421,0,4103,1549533,15.592592592592593
340,481,0,4104,1550014,14.147058823529411
310,513,0,4105,1550527,16.548387096774192
300,414,0,4106,1550941,13.8
330,556,0,4107,1551497,16.848484848484848
330,454,0,4108,1551951,13.757575757575758
240,321,0,4109,1552272,13.375
310,528,0,4110,1552800,17.032258064516128
440,760,0,4111,1553560,17.272727272727273
200,310,0,4112,1553870,15.5
190,235,0,4113,1554105,12.368421052631579
170,230,0,4114,1554335,13.529411764705882
370,623,0,4115,1554958,16.83783783783784
160,232,0,4116,1555190,14.5
80,98,0,4117,1555288,12.25
200,253,0,4118,1555541,12.65
250,304,0,4119,1555845,12.16
270,345,0,4120,1556190,12.777777777777779
370,587,0,4121,1556777,15.864864864864865
160,210,0,4122,1556987,13.125
150,154,0,4123,1557141,10.266666666666667
140,163,0,4124,1557304,11.642857142857142
260,397,0,4125,1557701,15.26923076923077
330,491,0,4126,1558192,14.878787878787879
300,471,0,4127,1558663,15.7
570,1031,0,4128,1559694,18.087719298245613
260,338,0,4129,1560032,13.0
250,383,0,4130,1560415,15.32
170,209,0,4131,1560624,12.294117647058824
420,616,0,4132,1561240,14.666666666666666
130,188,0,4133,1561428,14.461538461538462
170,214,0,4134,1561642,12.588235294117647
140,176,0,4135,1561818,12.571428571428571
340,597,0,4136,1562415,17.558823529411764
320,504,0,4137,1562919,15.75
170,237,0,4138,1563156,13.941176470588236
220,340,0,4139,1563496,15.454545454545455
240,370,0,4140,1563866,15.416666666666666
500,692,0,4141,1564558,13.84
180,227,0,4142,1564785,12.61111111111111
230,308,0,4143,1565093,13.391304347826088
260,326,0,4144,1565419,12.538461538461538
360,520,0,4145,1565939,14.444444444444445
350,615,0,4146,1566554,17.571428571428573
340,578,0,4147,1567132,17.0
300,472,0,4148,1567604,15.733333333333333
440,679,0,4149,1568283,15.431818181818182
290,448,0,4150,1568731,15.448275862068966
410,592,0,4151,1569323,14.439024390243903
220,321,0,4152,1569644,14.590909090909092
270,448,0,4153,1570092,16.59259259259259
210,338,0,4154,1570430,16.095238095238095
140,217,0,4155,1570647,15.5
200,246,0,4156,1570893,12.3
360,579,0,4157,1571472,16.083333333333332
260,427,0,4158,1571899,16.423076923076923
430,792,0,4159,1572691,18.41860465116279
350,524,0,4160,1573215,14.971428571428572
220,376,0,4161,1573591,17.09090909090909
200,278,0,4162,1573869,13.9
270,395,0,4163,1574264,14.62962962962963
180,252,0,4164,1574516,14.0
210,362,0,4165,1574878,17.238095238095237
320,564,0,4166,1575442,17.625
140,220,0,4167,1575662,15.714285714285714
340,466,0,4168,1576128,13.705882352941176
230,311,0,4169,1576439,13.521739130434783
160,185,0,4170,1576624,11.5625
340,589,0,4171,1577213,17.323529411764707
90,117,0,4172,1577330,13.0
250,397,0,4173,1577727,15.88
160,204,0,4174,1577931,12.75
140,221,0,4175,1578152,15.785714285714286
150,211,0,4176,1578363,14.066666666666666
200,288,0,4177,1578651,14.4
380,523,0,4178,1579174,13.763157894736842
190,303,0,4179,1579477,15.947368421052632
220,308,0,4180,1579785,14.0
350,502,0,4181,1580287,14.342857142857143
290,494,0,4182,1580781,17.03448275862069
110,152,0,4183,1580933,13.818181818181818
230,332,0,4184,1581265,14.434782608695652
270,395,0,4185,1581660,14.62962962962963
210,329,0,4186,1581989,15.666666666666666
200,341,0,4187,1582330,17.05
320,530,0,4188,1582860,16.5625
180,279,0,4189,1583139,15.5
200,329,0,4190,1583468,16.45
250,441,0,4191,1583909,17.64
280,401,0,4192,1584310,14.321428571428571
190,267,0,4193,1584577,14.052631578947368
320,532,0,4194,1585109,16.625
220,323,0,4195,1585432,14.681818181818182
340,484,0,4196,1585916,14.235294117647058
330,494,0,4197,1586410,14.969696969696969
150,237,0,4198,1586647,15.8
340,482,0,4199,1587129,14.176470588235293
300,428,0,4200,1587557,14.266666666666667
270,413,0,4201,1587970,15.296296296296296
330,483,0,4202,1588453,14.636363636363637
230,328,0,4203,1588781,14.26086956521739
370,414,0,4204,1589195,11.18918918918919
170,261,0,4205,1589456,15.352941176470589
260,336,0,4206,1589792,12.923076923076923
280,505,0,4207,1590297,18.035714285714285
140,198,0,4208,1590495,14.142857142857142
270,365,0,4209,1590860,13.518518518518519
370,647,0,4210,1591507,17.486486486486488
390,666,0,4211,1592173,17.076923076923077
210,334,0,4212,1592507,15.904761904761905
210,364,0,4213,1592871,17.333333333333332
180,270,0,4214,1593141,15.0
370,594,0,4215,1593735,16.054054054054053
190,239,0,4216,1593974,12.578947368421053
370,604,0,4217,1594578,16.324324324324323
270,411,0,4218,1594989,15.222222222222221
480,903,0,4219,1595892,18.8125
190,239,0,4220,1596131,12.578947368421053
280,410,0,4221,1596541,14.642857142857142
310,408,0,4222,1596949,13.161290322580646
80,85,0,4223,1597034,10.625
180,259,0,4224,1597293,14.38888888888889
390,591,0,4225,1597884,15.153846153846153
130,160,0,4226,1598044,12.307692307692308
250,376,0,4227,1598420,15.04
190,255,0,4228,1598675,13.421052631578947
230,325,0,4229,1599000,14.130434782608695
240,374,0,4230,1599374,15.583333333333334
390,589,0,4231,1599963,15.102564102564102
190,252,0,4232,1600215,13.263157894736842
140,175,0,4233,1600390,12.5
310,410,0,4234,1600800,13.225806451612904
390,571,0,4235,1601371,14.64102564102564
180,238,0,4236,1601609,13.222222222222221
130,147,0,4237,1601756,11.307692307692308
310,406,0,4238,1602162,13.096774193548388
90,120,0,4239,1602282,13.333333333333334
260,365,0,4240,1602647,14.038461538461538
190,296,0,4241,1602943,15.578947368421053
470,926,0,4242,1603869,19.70212765957447
210,252,0,4243,1604121,12.0
140,175,0,4244,1604296,12.5
230,310,0,4245,1604606,13.478260869565217
260,477,0,4246,1605083,18.346153846153847
240,334,0,4247,1605417,13.916666666666666
290,410,0,4248,1605827,14.137931034482758
290,473,0,4249,1606300,16.310344827586206
90,100,0,4250,1606400,11.11111111111111
320,480,0,4251,1606880,15.0
350,604,0,4252,1607484,17.257142857142856
330,483,0,4253,1607967,14.636363636363637
320,438,0,4254,1608405,13.6875
140,216,0,4255,1608621,15.428571428571429
210,356,0,4256,1608977,16.952380952380953
250,388,0,4257,1609365,15.52
410,631,0,4258,1609996,15.390243902439025
240,414,0,4259,1610410,17.25
230,311,0,4260,1610721,13.521739130434783
120,214,0,4261,1610935,17.833333333333332
340,524,0,4262,1611459,15.411764705882353
170,190,0,4263,1611649,11.176470588235293
180,281,0,4264,1611930,15.61111111111111
310,538,0,4265,1612468,17.35483870967742
230,346,0,4266,1612814,15.043478260869565
300,492,0,4267,1613306,16.4
240,360,0,4268,1613666,15.0
430,614,0,4269,1614280,14.279069767441861
230,379,0,4270,1614659,16.47826086956522
180,244,0,4271,1614903,13.555555555555555
300,458,0,4272,1615361,15.266666666666667
200,285,0,4273,1615646,14.25
400,626,0,4274,1616272,15.65
240,300,0,4275,1616572,12.5
110,151,0,4276,1616723,13.727272727272727
200,313,0,4277,1617036,15.65
160,226,0,4278,1617262,14.125
310,406,0,4279,1617668,13.096774193548388
550,887,0,4280,1618555,16.12727272727273
260,362,0,4281,1618917,13.923076923076923
140,160,0,4282,1619077,11.428571428571429
500,802,0,4283,1619879,16.04
410,596,0,4284,1620475,14.536585365853659
380,786,0,4285,1621261,20.68421052631579
110,166,0,4286,1621427,15.090909090909092
310,464,0,4287,1621891,14.96774193548387
340,540,0,4288,1622431,15.882352941176471
430,725,0,4289,1623156,16.86046511627907
50,72,0,4290,1623228,14.4
290,331,0,4291,1623559,11.413793103448276
320,473,0,4292,1624032,14.78125
360,551,0,4293,1624583,15.305555555555555
490,752,0,4294,1625335,15.346938775510203
440,746,0,4295,1626081,16.954545454545453
250,342,0,4296,1626423,13.68
130,153,0,4297,1626576,11.76923076923077
410,597,0,4298,1627173,14.560975609756097
280,433,0,4299,1627606,15.464285714285714
340,523,0,4300,1628129,15.382352941176471
340,513,0,4301,1628642,15.088235294117647
290,433,0,4302,1629075,14.931034482758621
320,485,0,4303,1629560,15.15625
410,576,0,4304,1630136,14.048780487804878
330,622,0,4305,1630758,18.848484848484848
300,504,0,4306,1631262,16.8
150,199,0,4307,1631461,13.266666666666667
240,294,0,4308,1631755,12.25
170,204,0,4309,1631959,12.0
170,280,0,4310,1632239,16.470588235294116
160,191,0,4311,1632430,11.9375
260,331,0,4312,1632761,12.73076923076923
190,272,0,4313,1633033,14.31578947368421
310,476,0,4314,1633509,15.35483870967742
120,201,0,4315,1633710,16.75
270,400,0,4316,1634110,14.814814814814815
230,427,0,4317,1634537,18.565217391304348
230,315,0,4318,1634852,13.695652173913043
220,378,0,4319,1635230,17.181818181818183
190,352,0,4320,1635582,18.526315789473685
170,267,0,4321,1635849,15.705882352941176
400,624,0,4322,1636473,15.6
220,325,0,4323,1636798,14.772727272727273
300,434,0,4324,1637232,14.466666666666667
200,218,0,4325,1637450,10.9
280,375,0,4326,1637825,13.392857142857142
300,432,0,4327,1638257,14.4
280,329,0,4328,1638586,11.75
270,413,0,4329,1638999,15.296296296296296
160,220,0,4330,1639219,13.75
250,398,0,4331,1639617,15.92
120,173,0,4332,1639790,14.416666666666666
130,196,0,4333,1639986,15.076923076923077
100,135,0,4334,1640121,13.5
170,280,0,4335,1640401,16.470588235294116
210,250,0,4336,1640651,11.904761904761905
190,256,0,4337,1640907,13.473684210526315
180,255,0,4338,1641162,14.166666666666666
380,581,0,4339,1641743,15.289473684210526
380,663,0,4340,1642406,17.44736842105263
230,338,0,4341,1642744,14.695652173913043
90,116,0,4342,1642860,12.88888888888889
280,367,0,4343,1643227,13.107142857142858
160,244,0,4344,1643471,15.25
180,328,0,4345,1643799,18.22222222222222
280,371,0,4346,1644170,13.25
160,240,0,4347,1644410,15.0
270,405,0,4348,1644815,15.0
90,127,0,4349,1644942,14.11111111111111
120,146,0,4350,1645088,12.166666666666666
410,615,0,4351,1645703,15.0
300,464,0,4352,1646167,15.466666666666667
260,403,0,4353,1646570,15.5
140,190,0,4354,1646760,13.571428571428571
100,136,0,4355,1646896,13.6
180,256,0,4356,1647152,14.222222222222221
290,475,0,4357,1647627,16.379310344827587
170,233,0,4358,1647860,13.705882352941176
190,276,0,4359,1648136,14.526315789473685
320,547,0,4360,1648683,17.09375
170,299,0,4361,1648982,17.58823529411765
310,421,0,4362,1649403,13.580645161290322
320,408,0,4363,1649811,12.75
230,323,0,4364,1650134,14.043478260869565
480,744,0,4365,1650878,15.5
540,827,0,4366,1651705,15.314814814814815
90,146,0,4367,1651851,16.22222222222222
190,259,0,4368,1652110,13.631578947368421
430,655,0,4369,1652765,15.232558139534884
360,487,0,4370,1653252,13.527777777777779
250,414,0,4371,1653666,16.56
210,305,0,4372,1653971,14.523809523809524
320,537,0,4373,1654508,16.78125
320,497,0,4374,1655005,15.53125
200,324,0,4375,1655329,16.2
140,203,0,4376,1655532,14.5
280,354,0,4377,1655886,12.642857142857142
250,425,0,4378,1656311,17.0
300,476,0,4379,1656787,15.866666666666667
190,287,0,4380,1657074,15.105263157894736
260,354,0,4381,1657428,13.615384615384615
120,164,0,4382,1657592,13.666666666666666
330,493,0,4383,1658085,14.93939393939394
260,390,0,4384,1658475,15.0
340,489,0,4385,1658964,14.382352941176471
340,524,0,4386,1659488,15.411764705882353
70,104,0,4387,1659592,14.857142857142858
330,526,0,4388,1660118,15.93939393939394
350,516,0,4389,1660634,14.742857142857142
130,172,0,4390,1660806,13.23076923076923
140,173,0,4391,1660979,12.357142857142858
100,115,0,4392,1661094,11.5
230,350,0,4393,1661444,15.217391304347826
60,96,0,4394,1661540,16.0
260,444,0,4395,1661984,17.076923076923077
270,428,0,4396,1662412,15.851851851851851
250,359,0,4397,1662771,14.36
520,821,0,4398,1663592,15.788461538461538
300,416,0,4399,1664008,13.866666666666667
320,516,0,4400,1664524,16.125
220,332,0,4401,1664856,15.090909090909092
490,790,0,4402,1665646,16.122448979591837
190,243,0,4403,1665889,12.789473684210526
190,311,0,4404,1666200,16.36842105263158
370,616,0,4405,1666816,16.64864864864865
190,274,0,4406,1667090,14.421052631578947
350,538,0,4407,1667628,15.371428571428572
230,342,0,4408,1667970,14.869565217391305
220,258,0,4409,1668228,11.727272727272727
220,345,0,4410,1668573,15.681818181818182
250,356,0,4411,1668929,14.24
110,165,0,4412,1669094,15.0
210,293,0,4413,1669387,13.952380952380953
230,312,0,4414,1669699,13.565217391304348
420,688,0,4415,1670387,16.38095238095238
290,387,0,4416,1670774,13.344827586206897
220,362,0,4417,1671136,16.454545454545453
350,563,0,4418,1671699,16.085714285714285
150,227,0,4419,1671926,15.133333333333333
160,197,0,4420,1672123,12.3125
360,504,0,4421,1672627,14.0
170,282,0,4422,1672909,16.58823529411765
240,332,0,4423,1673241,13.833333333333334
220,294,0,4424,1673535,13.363636363636363
300,448,0,4425,1673983,14.933333333333334
210,300,0,4426,1674283,14.285714285714286
350,580,0,4427,1674863,16.571428571428573
210,286,0,4428,1675149,13.619047619047619
210,316,0,4429,1675465,15.047619047619047
90,100,0,4430,1675565,11.11111111111111
320,513,0,4431,1676078,16.03125
230,364,0,4432,1676442,15.826086956521738
290,371,0,4433,1676813,12.793103448275861
180,254,0,4434,1677067,14.11111111111111
340,484,0,4435,1677551,14.235294117647058
250,340,0,4436,1677891,13.6
310,523,0,4437,1678414,16.870967741935484
140,256,0,4438,1678670,18.285714285714285
170,238,0,4439,1678908,14.0
280,356,0,4440,1679264,12.714285714285714
280,470,0,4441,1679734,16.785714285714285
250,388,0,4442,1680122,15.52
150,239,0,4443,1680361,15.933333333333334
280,415,0,4444,1680776,14.821428571428571
340,551,0,4445,1681327,16.205882352941178
340,571,0,4446,1681898,16.794117647058822
230,373,0,4447,1682271,16.217391304347824
390,584,0,4448,1682855,14.974358974358974
140,182,0,4449,1683037,13.0
120,150,0,4450,1683187,12.5
260,394,0,4451,1683581,15.153846153846153
220,336,0,4452,1683917,15.272727272727273
300,429,0,4453,1684346,14.3
430,600,0,4454,1684946,13.953488372093023
350,442,0,4455,1685388,12.628571428571428
180,229,0,4456,1685617,12.722222222222221
200,277,0,4457,1685894,13.85
170,243,0,4458,1686137,14.294117647058824
410,650,0,4459,1686787,15.853658536585366
260,351,0,4460,1687138,13.5
350,622,0,4461,1687760,17.771428571428572
250,378,0,4462,1688138,15.12
170,223,0,4463,1688361,13.117647058823529
180,214,0,4464,1688575,11.88888888888889
100,146,0,4465,1688721,14.6
290,411,0,4466,1689132,14.172413793103448
180,293,0,4467,1689425,16.27777777777778
290,400,0,4468,1689825,13.793103448275861
170,270,0,4469,1690095,15.882352941176471
270,367,0,4470,1690462,13.592592592592593
240,362,0,4471,1690824,15.083333333333334
280,467,0,4472,1691291,16.678571428571427
520,1012,0,4473,1692303,19.46153846153846
280,477,0,4474,1692780,17.035714285714285
350,524,0,4475,1693304,14.971428571428572
380,585,0,4476,1693889,15.394736842105264
370,604,0,4477,1694493,16.324324324324323
230,304,0,4478,1694797,13.217391304347826
110,142,0,4479,1694939,12.909090909090908
250,403,0,4480,1695342,16.12
780,1701,0,4481,1697043,21.807692307692307
280,448,0,4482,1697491,16.0
160,235,0,4483,1697726,14.6875
320,435,0,4484,1698161,13.59375
290,425,0,4485,1698586,14.655172413793103
390,657,0,4486,1699243,16.846153846153847
330,535,0,4487,1699778,16.21212121212121
210,299,0,4488,1700077,14.238095238095237
280,454,0,4489,1700531,16.214285714285715
230,308,0,4490,1700839,13.391304347826088
320,402,0,4491,1701241,12.5625
300,519,0,4492,1701760,17.3
340,569,0,4493,1702329,16.735294117647058
150,209,0,4494,1702538,13.933333333333334
330,574,0,4495,1703112,17.393939393939394
210,270,0,4496,1703382,12.857142857142858
310,463,0,4497,1703845,14.935483870967742
160,244,0,4498,1704089,15.25
210,324,0,4499,1704413,15.428571428571429
260,359,0,4500,1704772,13.807692307692308
170,249,0,4501,1705021,14.647058823529411
140,161,0,4502,1705182,11.5
270,339,0,4503,1705521,12.555555555555555
300,485,0,4504,1706006,16.166666666666668
180,244,0,4505,1706250,13.555555555555555
310,524,0,4506,1706774,16.903225806451612
300,393,0,4507,1707167,13.1
180,259,0,4508,1707426,14.38888888888889
210,245,0,4509,1707671,11.666666666666666
100,144,0,4510,1707815,14.4
360,487,0,4511,1708302,13.527777777777779
230,301,0,4512,1708603,13.08695652173913
150,239,0,4513,1708842,15.933333333333334
170,225,0,4514,1709067,13.235294117647058
110,160,0,4515,1709227,14.545454545454545
150,198,0,4516,1709425,13.2
240,375,0,4517,1709800,15.625
160,186,0,4518,1709986,11.625
310,431,0,4519,1710417,13.903225806451612
250,442,0,4520,1710859,17.68
510,834,0,4521,1711693,16.352941176470587
100,154,0,4522,1711847,15.4
110,177,0,4523,1712024,16.09090909090909
330,533,0,4524,1712557,16.151515151515152
290,424,0,4525,1712981,14.620689655172415
190,302,0,4526,1713283,15.894736842105264
440,727,0,4527,1714010,16.522727272727273
280,427,0,4528,1714437,15.25
260,396,0,4529,1714833,15.23076923076923
260,415,0,4530,1715248,15.961538461538462
120,138,0,4531,1715386,11.5
150,209,0,4532,1715595,13.933333333333334
250,394,0,4533,1715989,15.76
160,200,0,4534,1716189,12.5
370,594,0,4535,1716783,16.054054054054053
200,304,0,4536,1717087,15.2
320,509,0,4537,1717596,15.90625
160,259,0,4538,1717855,16.1875
270,332,0,4539,1718187,12.296296296296296
400,635,0,4540,1718822,15.875
310,517,0,4541,1719339,16.677419354838708
320,505,0,4542,1719844,15.78125
310,518,0,4543,1720362,16.70967741935484
230,326,0,4544,1720688,14.173913043478262
210,353,0,4545,1721041,16.80952380952381
400,592,0,4546,1721633,14.8
250,349,0,4547,1721982,13.96
400,724,0,4548,1722706,18.1
200,291,0,4549,1722997,14.55
180,236,0,4550,1723233,13.11111111111111
180,207,0,4551,1723440,11.5
340,513,0,4552,1723953,15.088235294117647
270,393,0,4553,1724346,14.555555555555555
200,325,0,4554,1724671,16.25
210,357,0,4555,1725028,17.0
400,620,0,4556,1725648,15.5
190,249,0,4557,1725897,13.105263157894736
250,361,0,4558,1726258,14.44
450,588,0,4559,1726846,13.066666666666666
180,192,0,4560,1727038,10.666666666666666
340,425,0,4561,1727463,12.5
250,351,0,4562,1727814,14.04
360,651,0,4563,1728465,18.083333333333332
300,419,0,4564,1728884,13.966666666666667
170,228,0,4565,1729112,13.411764705882353
250,347,0,4566,1729459,13.88
290,418,0,4567,1729877,14.413793103448276
220,286,0,4568,1730163,13.0
130,208,0,4569,1730371,16.0
230,374,0,4570,1730745,16.26086956521739
260,449,0,4571,1731194,17.26923076923077
280,403,0,4572,1731597,14.392857142857142
80,96,0,4573,1731693,12.0
140,200,0,4574,1731893,14.285714285714286
200,257,0,4575,1732150,12.85
190,291,0,4576,1732441,15.31578947368421
250,400,0,4577,1732841,16.0
310,377,0,4578,1733218,12.161290322580646
160,262,0,4579,1733480,16.375
220,334,0,4580,1733814,15.181818181818182
210,287,0,4581,1734101,13.666666666666666
290,413,0,4582,1734514,14.241379310344827
240,335,0,4583,1734849,13.958333333333334
160,219,0,4584,1735068,13.6875
220,303,0,4585,1735371,13.772727272727273
300,486,0,4586,1735857,16.2
310,466,0,4587,1736323,15.03225806451613
420,685,0,4588,1737008,16.30952380952381
130,172,0,4589,1737180,13.23076923076923
80,134,0,4590,1737314,16.75
520,885,0,4591,1738199,17.01923076923077
250,324,0,4592,1738523,12.96
170,193,0,4593,1738716,11.352941176470589
270,343,0,4594,1739059,12.703703703703704
200,248,0,4595,1739307,12.4
280,420,0,4596,1739727,15.0
240,356,0,4597,1740083,14.833333333333334
90,121,0,4598,1740204,13.444444444444445
80,124,0,4599,1740328,15.5
360,649,0,4600,1740977,18.02777777777778
60,109,0,4601,1741086,18.166666666666668
200,278,0,4602,1741364,13.9
270,362,0,4603,1741726,13.407407407407407
240,365,0,4604,1742091,15.208333333333334
290,446,0,4605,1742537,15.379310344827585
220,334,0,4606,1742871,15.181818181818182
280,404,0,4607,1743275,14.428571428571429
160,175,0,4608,1743450,10.9375
360,542,0,4609,1743992,15.055555555555555
240,356,0,4610,1744348,14.833333333333334
280,409,0,4611,1744757,14.607142857142858
300,464,0,4612,1745221,15.466666666666667
290,380,0,4613,1745601,13.10344827586207
160,197,0,4614,1745798,12.3125
430,612,0,4615,1746410,14.232558139534884
300,418,0,4616,1746828,13.933333333333334
330,527,0,4617,1747355,15.969696969696969
220,324,0,4618,1747679,14.727272727272727
250,420,0,4619,1748099,16.8
270,404,0,4620,1748503,14.962962962962964
300,421,0,4621,1748924,14.033333333333333
210,271,0,4622,1749195,12.904761904761905
340,603,0,4623,1749798,17.735294117647058
110,166,0,4624,1749964,15.090909090909092
300,446,0,4625,1750410,14.866666666666667
310,392,0,4626,1750802,12.64516129032258
220,296,0,4627,1751098,13.454545454545455
480,730,0,4628,1751828,15.208333333333334
270,404,0,4629,1752232,14.962962962962964
200,303,0,4630,1752535,15.15
280,341,0,4631,1752876,12.178571428571429
150,242,0,4632,1753118,16.133333333333333
250,331,0,4633,1753449,13.24
230,287,0,4634,1753736,12.478260869565217
100,137,0,4635,1753873,13.7
250,361,0,4636,1754234,14.44
120,171,0,4637,1754405,14.25
320,467,0,4638,1754872,14.59375
110,146,0,4639,1755018,13.272727272727273
220,319,0,4640,1755337,14.5
250,390,0,4641,1755727,15.6
280,323,0,4642,1756050,11.535714285714286
260,412,0,4643,1756462,15.846153846153847
310,441,0,4644,1756903,14.225806451612904
350,445,0,4645,1757348,12.714285714285714
100,154,0,4646,1757502,15.4
320,443,0,4647,1757945,13.84375
370,568,0,4648,1758513,15.35135135135135
270,422,0,4649,1758935,15.62962962962963
180,268,0,4650,1759203,14.88888888888889
380,509,0,4651,1759712,13.394736842105264
180,208,0,4652,1759920,11.555555555555555
260,420,0,4653,1760340,16.153846153846153
300,455,0,4654,1760795,15.166666666666666
220,283,0,4655,1761078,12.863636363636363
340,549,0,4656,1761627,16.147058823529413
270,361,0,4657,1761988,13.37037037037037
160,250,0,4658,1762238,15.625
350,542,0,4659,1762780,15.485714285714286
290,402,0,4660,1763182,13.862068965517242
190,331,0,4661,1763513,17.42105263157895
400,648,0,4662,1764161,16.2
250,391,0,4663,1764552,15.64
240,317,0,4664,1764869,13.208333333333334
120,137,0,4665,1765006,11.416666666666666
140,200,0,4666,1765206,14.285714285714286
180,243,0,4667,1765449,13.5
230,344,0,4668,1765793,14.956521739130435
250,298,0,4669,1766091,11.92
340,545,0,4670,1766636,16.029411764705884
240,319,0,4671,1766955,13.291666666666666
270,379,0,4672,1767334,14.037037037037036
140,196,0,4673,1767530,14.0
380,530,0,4674,1768060,13.947368421052632
280,437,0,4675,1768497,15.607142857142858
230,374,0,4676,1768871,16.26086956521739
280,423,0,4677,1769294,15.107142857142858
260,393,0,4678,1769687,15.115384615384615
290,477,0,4679,1770164,16.448275862068964
200,291,0,4680,1770455,14.55
190,258,0,4681,1770713,13.578947368421053
190,238,0,4682,1770951,12.526315789473685
130,151,0,4683,1771102,11.615384615384615
140,170,0,4684,1771272,12.142857142857142
200,261,0,4685,1771533,13.05
160,238,0,4686,1771771,14.875
370,649,0,4687,1772420,17.54054054054054
240,361,0,4688,1772781,15.041666666666666
270,367,0,4689,1773148,13.592592592592593
410,636,0,4690,1773784,15.512195121951219
150,193,0,4691,1773977,12.866666666666667
490,777,0,4692,1774754,15.857142857142858
390,602,0,4693,1775356,15.435897435897436
120,161,0,4694,1775517,13.416666666666666
310,486,0,4695,1776003,15.67741935483871
340,493,0,4696,1776496,14.5
60,53,0,4697,1776549,8.833333333333334
160,250,0,4698,1776799,15.625
150,264,0,4699,1777063,17.6
360,549,0,4700,1777612,15.25
300,392,0,4701,1778004,13.066666666666666
280,391,0,4702,1778395,13.964285714285714
340,581,0,4703,1778976,17.08823529411765
280,451,0,4704,1779427,16.107142857142858
320,362,0,4705,1779789,11.3125
230,322,0,4706,1780111,14.0
160,194,0,4707,1780305,12.125
240,349,0,4708,1780654,14.541666666666666
230,315,0,4709,1780969,13.695652173913043
300,464,0,4710,1781433,15.466666666666667
120,185,0,4711,1781618,15.416666666666666
190,318,0,4712,1781936,16.736842105263158
240,406,0,4713,1782342,16.916666666666668
240,388,0,4714,1782730,16.166666666666668
330,471,0,4715,1783201,14.272727272727273
410,637,0,4716,1783838,15.536585365853659
250,460,0,4717,1784298,18.4
130,183,0,4718,1784481,14.076923076923077
340,600,0,4719,1785081,17.647058823529413
180,265,0,4720,1785346,14.722222222222221
250,413,0,4721,1785759,16.52
280,406,0,4722,1786165,14.5
140,220,0,4723,1786385,15.714285714285714
180,250,0,4724,1786635,13.88888888888889
470,759,0,4725,1787394,16.148936170212767
150,186,0,4726,1787580,12.4
380,539,0,4727,1788119,14.18421052631579
380,548,0,4728,1788667,14.421052631578947
360,579,0,4729,1789246,16.083333333333332
140,194,0,4730,1789440,13.857142857142858
210,304,0,4731,1789744,14.476190476190476
330,499,0,4732,1790243,15.121212121212121
370,506,0,4733,1790749,13.675675675675675
340,566,0,4734,1791315,16.647058823529413
170,202,0,4735,1791517,11.882352941176471
220,356,0,4736,1791873,16.181818181818183
310,444,0,4737,1792317,14.32258064516129
120,119,0,4738,1792436,9.916666666666666
240,331,0,4739,1792767,13.791666666666666
230,308,0,4740,1793075,13.391304347826088
170,218,0,4741,1793293,12.823529411764707
180,283,0,4742,1793576,15.722222222222221
280,393,0,4743,1793969,14.035714285714286
160,231,0,4744,1794200,14.4375
220,311,0,4745,1794511,14.136363636363637
330,501,0,4746,1795012,15.181818181818182
180,196,0,4747,1795208,10.88888888888889
160,203,0,4748,1795411,12.6875
200,282,0,4749,1795693,14.1
230,308,0,4750,1796001,13.391304347826088
290,441,0,4751,1796442,15.206896551724139
350,600,0,4752,1797042,17.142857142857142
430,597,0,4753,1797639,13.883720930232558
260,353,0,4754,1797992,13.576923076923077
340,512,0,4755,1798504,15.058823529411764
440,770,0,4756,1799274,17.5
90,134,0,4757,1799408,14.88888888888889
330,499,0,4758,1799907,15.121212121212121
400,667,0,4759,1800574,16.675
280,382,0,4760,1800956,13.642857142857142
290,422,0,4761,1801378,14.551724137931034
380,528,0,4762,1801906,13.894736842105264
350,513,0,4763,1802419,14.657142857142857
170,239,0,4764,1802658,14.058823529411764
330,566,0,4765,1803224,17.151515151515152
260,339,0,4766,1803563,13.038461538461538
120,172,0,4767,1803735,14.333333333333334
100,152,0,4768,1803887,15.2
250,358,0,4769,1804245,14.32
200,253,0,4770,1804498,12.65
260,451,0,4771,1804949,17.346153846153847
210,359,0,4772,1805308,17.095238095238095
430,612,0,4773,1805920,14.232558139534884
250,346,0,4774,1806266,13.84
180,237,0,4775,1806503,13.166666666666666
110,133,0,4776,1806636,12.090909090909092
190,306,0,4777,1806942,16.105263157894736
100,137,0,4778,1807079,13.7
310,409,0,4779,1807488,13.193548387096774
280,402,0,4780,1807890,14.357142857142858
160,195,0,4781,1808085,12.1875
260,419,0,4782,1808504,16.115384615384617
110,121,0,4783,1808625,11.0
110,118,0,4784,1808743,10.727272727272727
170,246,0,4785,1808989,14.470588235294118
360,478,0,4786,1809467,13.277777777777779
360,551,0,4787,1810018,15.305555555555555
120,203,0,4788,1810221,16.916666666666668
290,426,0,4789,1810647,14.689655172413794
190,294,0,4790,1810941,15.473684210526315
180,295,0,4791,1811236,16.38888888888889
120,173,0,4792,1811409,14.416666666666666
200,240,0,4793,1811649,12.0
350,520,0,4794,1812169,14.857142857142858
200,265,0,4795,1812434,13.25
340,514,0,4796,1812948,15.117647058823529
240,328,0,4797,1813276,13.666666666666666
340,514,0,4798,1813790,15.117647058823529
210,260,0,4799,1814050,12.380952380952381
100,108,0,4800,1814158,10.8
100,116,0,4801,1814274,11.6
340,534,0,4802,1814808,15.705882352941176
300,398,0,4803,1815206,13.266666666666667
240,337,0,4804,1815543,14.041666666666666
300,479,0,4805,1816022,15.966666666666667
180,267,0,4806,1816289,14.833333333333334
220,354,0,4807,1816643,16.09090909090909
210,274,0,4808,1816917,13.047619047619047
330,461,0,4809,1817378,13.969696969696969
340,540,0,4810,1817918,15.882352941176471
230,313,0,4811,1818231,13.608695652173912
250,463,0,4812,1818694,18.52
350,462,0,4813,1819156,13.2
210,266,0,4814,1819422,12.666666666666666
210,293,0,4815,1819715,13.952380952380953
90,76,0,4816,1819791,8.444444444444445
390,632,0,4817,1820423,16.205128205128204
240,327,0,4818,1820750,13.625
160,202,0,4819,1820952,12.625
370,583,0,4820,1821535,15.756756756756756
290,424,0,4821,1821959,14.620689655172415
120,150,0,4822,1822109,12.5
70,98,0,4823,1822207,14.0
120,159,0,4824,1822366,13.25
170,203,0,4825,1822569,11.941176470588236
160,216,0,4826,1822785,13.5
270,410,0,4827,1823195,15.185185185185185
190,251,0,4828,1823446,13.210526315789474
150,194,0,4829,1823640,12.933333333333334
330,447,0,4830,1824087,13.545454545454545
360,622,0,4831,1824709,17.27777777777778
220,323,0,4832,1825032,14.681818181818182
420,642,0,4833,1825674,15.285714285714286
250,349,0,4834,1826023,13.96
220,298,0,4835,1826321,13.545454545454545
240,409,0,4836,1826730,17.041666666666668
150,193,0,4837,1826923,12.866666666666667
200,286,0,4838,1827209,14.3
430,722,0,4839,1827931,16.790697674418606
280,440,0,4840,1828371,15.714285714285714
190,266,0,4841,1828637,14.0
190,303,0,4842,1828940,15.947368421052632
170,243,0,4843,1829183,14.294117647058824
170,286,0,4844,1829469,16.823529411764707
230,373,0,4845,1829842,16.217391304347824
340,543,0,4846,1830385,15.970588235294118
240,320,0,4847,1830705,13.333333333333334
200,260,0,4848,1830965,13.0
250,399,0,4849,1831364,15.96
240,353,0,4850,1831717,14.708333333333334
40,37,0,4851,1831754,9.25
380,547,0,4852,1832301,14.394736842105264
280,373,0,4853,1832674,13.321428571428571
250,380,0,4854,1833054,15.2
120,146,0,4855,1833200,12.166666666666666
230,288,0,4856,1833488,12.521739130434783
420,723,0,4857,1834211,17.214285714285715
330,462,0,4858,1834673,14.0
300,384,0,4859,1835057,12.8
200,347,0,4860,1835404,17.35
170,254,0,4861,1835658,14.941176470588236
310,506,0,4862,1836164,16.322580645161292
390,589,0,4863,1836753,15.102564102564102
290,431,0,4864,1837184,14.862068965517242
360,531,0,4865,1837715,14.75
350,544,0,4866,1838259,15.542857142857143
250,335,0,4867,1838594,13.4
200,330,0,4868,1838924,16.5
310,476,0,4869,1839400,15.35483870967742
190,255,0,4870,1839655,13.421052631578947
410,593,0,4871,1840248,14.463414634146341
150,219,0,4872,1840467,14.6
70,45,0,4873,1840512,6.428571428571429
160,243,0,4874,1840755,15.1875
120,190,0,4875,1840945,15.833333333333334
180,221,0,4876,1841166,12.277777777777779
250,371,0,4877,1841537,14.84
200,264,0,4878,1841801,13.2
170,263,0,4879,1842064,15.470588235294118
190,244,0,4880,1842308,12.842105263157896
240,360,0,4881,1842668,15.0
350,535,0,4882,1843203,15.285714285714286
230,352,0,4883,1843555,15.304347826086957
360,470,0,4884,1844025,13.055555555555555
240,375,0,4885,1844400,15.625
140,208,0,4886,1844608,14.857142857142858
460,761,0,4887,1845369,16.543478260869566
300,382,0,4888,1845751,12.733333333333333
150,179,0,4889,1845930,11.933333333333334
240,303,0,4890,1846233,12.625
340,543,0,4891,1846776,15.970588235294118
120,196,0,4892,1846972,16.333333333333332
180,277,0,4893,1847249,15.38888888888889
350,553,0,4894,1847802,15.8
180,250,0,4895,1848052,13.88888888888889
170,250,0,4896,1848302,14.705882352941176
150,235,0,4897,1848537,15.666666666666666
270,323,0,4898,1848860,11.962962962962964
160,231,0,4899,1849091,14.4375
190,247,0,4900,1849338,13.0
340,683,0,4901,1850021,20.08823529411765
350,549,0,4902,1850570,15.685714285714285
540,1041,0,4903,1851611,19.27777777777778
200,274,0,4904,1851885,13.7
430,723,0,4905,1852608,16.813953488372093
480,846,0,4906,1853454,17.625
150,168,0,4907,1853622,11.2
190,242,0,4908,1853864,12.736842105263158
420,678,0,4909,1854542,16.142857142857142
260,486,0,4910,1855028,18.692307692307693
130,212,0,4911,1855240,16.307692307692307
220,320,0,4912,1855560,14.545454545454545
160,239,0,4913,1855799,14.9375
340,519,0,4914,1856318,15.264705882352942
220,348,0,4915,1856666,15.818181818181818
540,841,0,4916,1857507,15.574074074074074
210,297,0,4917,1857804,14.142857142857142
220,350,0,4918,1858154,15.909090909090908
230,381,0,4919,1858535,16.565217391304348
220,310,0,4920,1858845,14.090909090909092
200,321,0,4921,1859166,16.05
220,291,0,4922,1859457,13.227272727272727
140,225,0,4923,1859682,16.071428571428573
310,486,0,4924,1860168,15.67741935483871
150,243,0,4925,1860411,16.2
260,468,0,4926,1860879,18.0
180,180,0,4927,1861059,10.0
230,359,0,4928,1861418,15.608695652173912
280,414,0,4929,1861832,14.785714285714286
200,239,0,4930,1862071,11.95
230,336,0,4931,1862407,14.608695652173912
280,412,0,4932,1862819,14.714285714285714
150,252,0,4933,1863071,16.8
290,448,0,4934,1863519,15.448275862068966
450,679,0,4935,1864198,15.088888888888889
220,342,0,4936,1864540,15.545454545454545
470,742,0,4937,1865282,15.787234042553191
120,226,0,4938,1865508,18.833333333333332
150,205,0,4939,1865713,13.666666666666666
150,219,0,4940,1865932,14.6
320,486,0,4941,1866418,15.1875
200,293,0,4942,1866711,14.65
310,467,0,4943,1867178,15.064516129032258
160,182,0,4944,1867360,11.375
470,826,0,4945,1868186,17.574468085106382
190,278,0,4946,1868464,14.631578947368421
340,503,0,4947,1868967,14.794117647058824
310,471,0,4948,1869438,15.193548387096774
280,411,0,4949,1869849,14.678571428571429
200,264,0,4950,1870113,13.2
290,373,0,4951,1870486,12.862068965517242
130,154,0,4952,1870640,11.846153846153847
70,100,0,4953,1870740,14.285714285714286
260,403,0,4954,1871143,15.5
230,328,0,4955,1871471,14.26086956521739
330,419,0,4956,1871890,12.696969696969697
210,263,0,4957,1872153,12.523809523809524
220,275,0,4958,1872428,12.5
440,870,0,4959,1873298,19.772727272727273
280,339,0,4960,1873637,12.107142857142858
300,538,0,4961,1874175,17.933333333333334
320,477,0,4962,1874652,14.90625
350,561,0,4963,1875213,16.02857142857143
390,624,0,4964,1875837,16.0
140,134,0,4965,1875971,9.571428571428571
230,322,0,4966,1876293,14.0
240,350,0,4967,1876643,14.583333333333334
450,657,0,4968,1877300,14.6
200,204,0,4969,1877504,10.2
200,316,0,4970,1877820,15.8
160,179,0,4971,1877999,11.1875
230,357,0,4972,1878356,15.521739130434783
230,327,0,4973,1878683,14.217391304347826
100,102,0,4974,1878785,10.2
340,511,0,4975,1879296,15.029411764705882
320,507,0,4976,1879803,15.84375
240,336,0,4977,1880139,14.0
80,88,0,4978,1880227,11.0
280,449,0,4979,1880676,16.035714285714285
240,367,0,4980,1881043,15.291666666666666
140,200,0,4981,1881243,14.285714285714286
230,269,0,4982,1881512,11.695652173913043
110,127,0,4983,1881639,11.545454545454545
180,246,0,4984,1881885,13.666666666666666
180,228,0,4985,1882113,12.666666666666666
150,228,0,4986,1882341,15.2
170,230,0,4987,1882571,13.529411764705882
240,302,0,4988,1882873,12.583333333333334
190,273,0,4989,1883146,14.368421052631579
280,424,0,4990,1883570,15.142857142857142
230,355,0,4991,1883925,15.434782608695652
270,423,0,4992,1884348,15.666666666666666
300,353,0,4993,1884701,11.766666666666667
240,385,0,4994,1885086,16.041666666666668
250,472,0,4995,1885558,18.88
150,212,0,4996,1885770,14.133333333333333
310,506,0,4997,1886276,16.322580645161292
300,388,0,4998,1886664,12.933333333333334
110,132,0,4999,1886796,12.0
160,228,0,5000,1887024,14.25
220,382,0,5001,1887406,17.363636363636363
270,419,0,5002,1887825,15.518518518518519
250,360,0,5003,1888185,14.4
360,601,0,5004,1888786,16.694444444444443
140,207,0,5005,1888993,14.785714285714286
330,441,0,5006,1889434,13.363636363636363
150,174,0,5007,1889608,11.6
260,405,0,5008,1890013,15.576923076923077
190,243,0,5009,1890256,12.789473684210526
260,425,0,5010,1890681,16.346153846153847
180,275,0,5011,1890956,15.277777777777779
210,284,0,5012,1891240,13.523809523809524
200,326,0,5013,1891566,16.3
260,412,0,5014,1891978,15.846153846153847
130,155,0,5015,1892133,11.923076923076923
190,231,0,5016,1892364,12.157894736842104
230,347,0,5017,1892711,15.08695652173913
230,353,0,5018,1893064,15.347826086956522
190,210,0,5019,1893274,11.052631578947368
310,413,0,5020,1893687,13.32258064516129
100,136,0,5021,1893823,13.6
250,432,0,5022,1894255,17.28
110,135,0,5023,1894390,12.272727272727273
310,457,0,5024,1894847,14.741935483870968
310,411,0,5025,1895258,13.258064516129032
220,347,0,5026,1895605,15.772727272727273
160,225,0,5027,1895830,14.0625
210,309,0,5028,1896139,14.714285714285714
340,467,0,5029,1896606,13.735294117647058
260,412,0,5030,1897018,15.846153846153847
120,152,0,5031,1897170,12.666666666666666
250,439,0,5032,1897609,17.56
150,156,0,5033,1897765,10.4
150,269,0,5034,1898034,17.933333333333334
420,643,0,5035,1898677,15.30952380952381
200,315,0,5036,1898992,15.75
280,398,0,5037,1899390,14.214285714285714
120,154,0,5038,1899544,12.833333333333334
330,467,0,5039,1900011,14.151515151515152
180,245,0,5040,1900256,13.61111111111111
390,607,0,5041,1900863,15.564102564102564
320,511,0,5042,1901374,15.96875
470,952,0,5043,1902326,20.25531914893617
550,848,0,5044,1903174,15.418181818181818
330,537,0,5045,1903711,16.272727272727273
240,293,0,5046,1904004,12.208333333333334
250,324,0,5047,1904328,12.96
280,446,0,5048,1904774,15.928571428571429
280,495,0,5049,1905269,17.678571428571427
210,306,0,5050,1905575,14.571428571428571
140,168,0,5051,1905743,12.0
220,358,0,5052,1906101,16.272727272727273
330,530,0,5053,1906631,16.060606060606062
220,324,0,5054,1906955,14.727272727272727
350,564,0,5055,1907519,16.114285714285714
220,319,0,5056,1907838,14.5
300,423,0,5057,1908261,14.1
160,221,0,5058,1908482,13.8125
210,294,0,5059,1908776,14.0
160,217,0,5060,1908993,13.5625
230,333,0,5061,1909326,14.478260869565217
180,287,0,5062,1909613,15.944444444444445
220,314,0,5063,1909927,14.272727272727273
230,393,0,5064,1910320,17.08695652173913
290,466,0,5065,1910786,16.06896551724138
360,584,0,5066,1911370,16.22222222222222
310,410,0,5067,1911780,13.225806451612904
320,460,0,5068,1912240,14.375
270,432,0,5069,1912672,16.0
190,256,0,5070,1912928,13.473684210526315
130,132,0,5071,1913060,10.153846153846153
240,326,0,5072,1913386,13.583333333333334
210,286,0,5073,1913672,13.619047619047619
380,542,0,5074,1914214,14.263157894736842
150,269,0,5075,1914483,17.933333333333334
200,330,0,5076,1914813,16.5
150,201,0,5077,1915014,13.4
430,673,0,5078,1915687,15.651162790697674
360,535,0,5079,1916222,14.86111111111111
320,421,0,5080,1916643,13.15625
310,446,0,5081,1917089,14.387096774193548
140,199,0,5082,1917288,14.214285714285714
210,276,0,5083,1917564,13.142857142857142
240,390,0,5084,1917954,16.25
270,371,0,5085,1918325,13.74074074074074
140,146,0,5086,1918471,10.428571428571429
190,261,0,5087,1918732,13.736842105263158
230,338,0,5088,1919070,14.695652173913043
200,342,0,5089,1919412,17.1
230,276,0,5090,1919688,12.0
300,463,0,5091,1920151,15.433333333333334
200,284,0,5092,1920435,14.2
380,536,0,5093,1920971,14.105263157894736
310,502,0,5094,1921473,16.193548387096776
240,347,0,5095,1921820,14.458333333333334
370,492,0,5096,1922312,13.297297297297296
310,391,0,5097,1922703,12.612903225806452
250,383,0,5098,1923086,15.32
180,239,0,5099,1923325,13.277777777777779
430,608,0,5100,1923933,14.13953488372093
190,185,0,5101,1924118,9.736842105263158
360,609,0,5102,1924727,16.916666666666668
110,136,0,5103,1924863,12.363636363636363
320,534,0,5104,1925397,16.6875
200,272,0,5105,1925669,13.6
180,273,0,5106,1925942,15.166666666666666
230,372,0,5107,1926314,16.17391304347826
150,167,0,5108,1926481,11.133333333333333
270,376,0,5109,1926857,13.925925925925926
320,461,0,5110,1927318,14.40625
310,523,0,5111,1927841,16.870967741935484
230,263,0,5112,1928104,11.434782608695652
250,369,0,5113,1928473,14.76
210,311,0,5114,1928784,14.80952380952381
290,515,0,5115,1929299,17.75862068965517
270,375,0,5116,1929674,13.88888888888889
330,414,0,5117,1930088,12.545454545454545
300,413,0,5118,1930501,13.766666666666667
190,239,0,5119,1930740,12.578947368421053
240,296,0,5120,1931036,12.333333333333334
180,220,0,5121,1931256,12.222222222222221
130,141,0,5122,1931397,10.846153846153847
190,307,0,5123,1931704,16.157894736842106
430,831,0,5124,1932535,19.325581395348838
430,663,0,5125,1933198,15.418604651162791
330,520,0,5126,1933718,15.757575757575758
410,676,0,5127,1934394,16.48780487804878
180,270,0,5128,1934664,15.0
320,466,0,5129,1935130,14.5625
410,632,0,5130,1935762,15.414634146341463
330,425,0,5131,1936187,12.878787878787879
230,410,0,5132,1936597,17.82608695652174
240,323,0,5133,1936920,13.458333333333334
620,1142,0,5134,1938062,18.419354838709676
250,356,0,5135,1938418,14.24
210,303,0,5136,1938721,14.428571428571429
300,398,0,5137,1939119,13.266666666666667
200,271,0,5138,1939390,13.55
290,441,0,5139,1939831,15.206896551724139
130,167,0,5140,1939998,12.846153846153847
360,512,0,5141,1940510,14.222222222222221
180,227,0,5142,1940737,12.61111111111111
260,401,0,5143,1941138,15.423076923076923
350,511,0,5144,1941649,14.6
270,398,0,5145,1942047,14.74074074074074
290,381,0,5146,1942428,13.137931034482758
180,212,0,5147,1942640,11.777777777777779
170,237,0,5148,1942877,13.941176470588236
270,389,0,5149,1943266,14.407407407407407
300,491,0,5150,1943757,16.366666666666667
60,67,0,5151,1943824,11.166666666666666
340,510,0,5152,1944334,15.0
250,365,0,5153,1944699,14.6
500,792,0,5154,1945491,15.84
230,324,0,5155,1945815,14.08695652173913
280,392,0,5156,1946207,14.0
260,391,0,5157,1946598,15.038461538461538
230,291,0,5158,1946889,12.652173913043478
250,317,0,5159,1947206,12.68
180,242,0,5160,1947448,13.444444444444445
120,210,0,5161,1947658,17.5
230,346,0,5162,1948004,15.043478260869565
400,720,0,5163,1948724,18.0
260,351,0,5164,1949075,13.5
290,425,0,5165,1949500,14.655172413793103
260,344,0,5166,1949844,13.23076923076923
190,288,0,5167,1950132,15.157894736842104
280,464,0,5168,1950596,16.571428571428573
390,641,0,5169,1951237,16.435897435897434
400,643,0,5170,1951880,16.075
440,711,0,5171,1952591,16.15909090909091
310,473,0,5172,1953064,15.258064516129032
270,350,0,5173,1953414,12.962962962962964
160,217,0,5174,1953631,13.5625
200,221,0,5175,1953852,11.05
160,208,0,5176,1954060,13.0
220,351,0,5177,1954411,15.954545454545455
180,237,0,5178,1954648,13.166666666666666
220,307,0,5179,1954955,13.954545454545455
300,358,0,5180,1955313,11.933333333333334
260,441,0,5181,1955754,16.96153846153846
220,357,0,5182,1956111,16.227272727272727
260,339,0,5183,1956450,13.038461538461538
250,426,0,5184,1956876,17.04
400,612,0,5185,1957488,15.3
330,502,0,5186,1957990,15.212121212121213
290,346,0,5187,1958336,11.931034482758621
120,160,0,5188,1958496,13.333333333333334
80,107,0,5189,1958603,13.375
240,401,0,5190,1959004,16.708333333333332
160,197,0,5191,1959201,12.3125
270,360,0,5192,1959561,13.333333333333334
370,544,0,5193,1960105,14.702702702702704
110,136,0,5194,1960241,12.363636363636363
230,357,0,5195,1960598,15.521739130434783
170,277,0,5196,1960875,16.294117647058822
360,550,0,5197,1961425,15.277777777777779
190,248,0,5198,1961673,13.052631578947368
470,755,0,5199,1962428,16.06382978723404
140,198,0,5200,1962626,14.142857142857142
210,290,0,5201,1962916,13.80952380952381
270,389,0,5202,1963305,14.407407407407407
270,380,0,5203,1963685,14.074074074074074
260,378,0,5204,1964063,14.538461538461538
160,213,0,5205,1964276,13.3125
300,470,0,5206,1964746,15.666666666666666
350,532,0,5207,1965278,15.2
310,435,0,5208,1965713,14.03225806451613
180,240,0,5209,1965953,13.333333333333334
220,307,0,5210,1966260,13.954545454545455
150,232,0,5211,1966492,15.466666666666667
60,67,0,5212,1966559,11.166666666666666
140,162,0,5213,1966721,11.571428571428571
140,195,0,5214,1966916,13.928571428571429
330,517,0,5215,1967433,15.666666666666666
270,481,0,5216,1967914,17.814814814814813
190,305,0,5217,1968219,16.05263157894737
150,200,0,5218,1968419,13.333333333333334
120,152,0,5219,1968571,12.666666666666666
160,216,0,5220,1968787,13.5
240,349,0,5221,1969136,14.541666666666666
280,420,0,5222,1969556,15.0
320,508,0,5223,1970064,15.875
180,281,0,5224,1970345,15.61111111111111
220,325,0,5225,1970670,14.772727272727273
260,407,0,5226,1971077,15.653846153846153
250,358,0,5227,1971435,14.32
270,441,0,5228,1971876,16.333333333333332
210,251,0,5229,1972127,11.952380952380953
340,557,0,5230,1972684,16.38235294117647
330,517,0,5231,1973201,15.666666666666666
120,186,0,5232,1973387,15.5
360,559,0,5233,1973946,15.527777777777779
300,407,0,5234,1974353,13.566666666666666
150,222,0,5235,1974575,14.8
360,539,0,5236,1975114,14.972222222222221
460,719,0,5237,1975833,15.630434782608695
270,409,0,5238,1976242,15.148148148148149
170,220,0,5239,1976462,12.941176470588236
250,392,0,5240,1976854,15.68
90,128,0,5241,1976982,14.222222222222221
230,311,0,5242,1977293,13.521739130434783
240,372,0,5243,1977665,15.5
100,162,0,5244,1977827,16.2
240,344,0,5245,1978171,14.333333333333334
230,292,0,5246,1978463,12.695652173913043
160,188,0,5247,1978651,11.75
290,409,0,5248,1979060,14.10344827586207
170,258,0,5249,1979318,15.176470588235293
310,541,0,5250,1979859,17.451612903225808
330,425,0,5251,1980284,12.878787878787879
390,574,0,5252,1980858,14.717948717948717
220,315,0,5253,1981173,14.318181818181818
310,528,0,5254,1981701,17.032258064516128
180,262,0,5255,1981963,14.555555555555555
420,652,0,5256,1982615,15.523809523809524
270,375,0,5257,1982990,13.88888888888889
180,286,0,5258,1983276,15.88888888888889
310,422,0,5259,1983698,13.612903225806452
450,768,0,5260,1984466,17.066666666666666
140,172,0,5261,1984638,12.285714285714286
300,479,0,5262,1985117,15.966666666666667
310,371,0,5263,1985488,11.96774193548387
70,84,0,5264,1985572,12.0
260,414,0,5265,1985986,15.923076923076923
400,715,0,5266,1986701,17.875
230,309,0,5267,1987010,13.434782608695652
290,430,0,5268,1987440,14.827586206896552
230,284,0,5269,1987724,12.347826086956522
130,213,0,5270,1987937,16.384615384615383
460,817,0,5271,1988754,17.76086956521739
290,400,0,5272,1989154,13.793103448275861
310,439,0,5273,1989593,14.161290322580646
410,712,0,5274,1990305,17.365853658536587
160,250,0,5275,1990555,15.625
250,413,0,5276,1990968,16.52
330,463,0,5277,1991431,14.030303030303031
390,638,0,5278,1992069,16.358974358974358
290,392,0,5279,1992461,13.517241379310345
400,583,0,5280,1993044,14.575
480,669,0,5281,1993713,13.9375
310,495,0,5282,1994208,15.96774193548387
330,415,0,5283,1994623,12.575757575757576
230,313,0,5284,1994936,13.608695652173912
260,397,0,5285,1995333,15.26923076923077
100,100,0,5286,1995433,10.0
260,430,0,5287,1995863,16.53846153846154
490,794,0,5288,1996657,16.20408163265306
310,497,0,5289,1997154,16.032258064516128
300,471,0,5290,1997625,15.7
280,373,0,5291,1997998,13.321428571428571
300,373,0,5292,1998371,12.433333333333334
340,551,0,5293,1998922,16.205882352941178
200,293,0,5294,1999215,14.65
200,220,0,5295,1999435,11.0
110,150,0,5296,1999585,13.636363636363637
180,275,0,5297,1999860,15.277777777777779
210,334,0,5298,2000194,15.904761904761905
310,511,0,5299,2000705,16.483870967741936
320,547,0,5300,2001252,17.09375
230,310,0,5301,2001562,13.478260869565217
260,330,0,5302,2001892,12.692307692307692
190,274,0,5303,2002166,14.421052631578947
210,317,0,5304,2002483,15.095238095238095
260,400,0,5305,2002883,15.384615384615385
100,172,0,5306,2003055,17.2
310,481,0,5307,2003536,15.516129032258064
160,241,0,5308,2003777,15.0625
260,380,0,5309,2004157,14.615384615384615
160,260,0,5310,2004417,16.25
260,347,0,5311,2004764,13.346153846153847
350,633,0,5312,2005397,18.085714285714285
460,757,0,5313,2006154,16.456521739130434
360,570,0,5314,2006724,15.833333333333334
260,417,0,5315,2007141,16.03846153846154
300,402,0,5316,2007543,13.4
130,180,0,5317,2007723,13.846153846153847
210,241,0,5318,2007964,11.476190476190476
390,628,0,5319,2008592,16.102564102564102
240,393,0,5320,2008985,16.375
260,425,0,5321,2009410,16.346153846153847
180,263,0,5322,2009673,14.61111111111111
190,255,0,5323,2009928,13.421052631578947
300,503,0,5324,2010431,16.766666666666666
400,637,0,5325,2011068,15.925
420,608,0,5326,2011676,14.476190476190476
550,994,0,5327,2012670,18.072727272727274
230,358,0,5328,2013028,15.565217391304348
210,337,0,5329,2013365,16.047619047619047
180,237,0,5330,2013602,13.166666666666666
140,227,0,5331,2013829,16.214285714285715
210,260,0,5332,2014089,12.380952380952381
270,406,0,5333,2014495,15.037037037037036
170,225,0,5334,2014720,13.235294117647058
380,607,0,5335,2015327,15.973684210526315
170,275,0,5336,2015602,16.176470588235293
180,261,0,5337,2015863,14.5
160,238,0,5338,2016101,14.875
310,466,0,5339,2016567,15.03225806451613
260,399,0,5340,2016966,15.346153846153847
330,470,0,5341,2017436,14.242424242424242
230,286,0,5342,2017722,12.434782608695652
390,579,0,5343,2018301,14.846153846153847
240,379,0,5344,2018680,15.791666666666666
340,567,0,5345,2019247,16.676470588235293
380,485,0,5346,2019732,12.763157894736842
170,210,0,5347,2019942,12.352941176470589
290,411,0,5348,2020353,14.172413793103448
230,363,0,5349,2020716,15.782608695652174
340,598,0,5350,2021314,17.58823529411765
500,907,0,5351,2022221,18.14
240,338,0,5352,2022559,14.083333333333334
310,474,0,5353,2023033,15.290322580645162
220,369,0,5354,2023402,16.772727272727273
280,385,0,5355,2023787,13.75
200,301,0,5356,2024088,15.05
300,443,0,5357,2024531,14.766666666666667
290,392,0,5358,2024923,13.517241379310345
410,741,0,5359,2025664,18.073170731707318
470,723,0,5360,2026387,15.382978723404255
140,176,0,5361,2026563,12.571428571428571
370,516,0,5362,2027079,13.945945945945946
190,233,0,5363,2027312,12.263157894736842
200,257,0,5364,2027569,12.85
190,263,0,5365,2027832,13.842105263157896
180,286,0,5366,2028118,15.88888888888889
450,706,0,5367,2028824,15.688888888888888
290,388,0,5368,2029212,13.379310344827585
410,691,0,5369,2029903,16.853658536585368
410,520,0,5370,2030423,12.682926829268293
440,675,0,5371,2031098,15.340909090909092
180,288,0,5372,2031386,16.0
210,319,0,5373,2031705,15.19047619047619
190,275,0,5374,2031980,14.473684210526315
330,512,0,5375,2032492,15.515151515151516
210,316,0,5376,2032808,15.047619047619047
210,360,0,5377,2033168,17.142857142857142
250,392,0,5378,2033560,15.68
380,655,0,5379,2034215,17.236842105263158
140,174,0,5380,2034389,12.428571428571429
360,626,0,5381,2035015,17.38888888888889
330,541,0,5382,2035556,16.393939393939394
320,450,0,5383,2036006,14.0625
250,334,0,5384,2036340,13.36
140,168,0,5385,2036508,12.0
180,273,0,5386,2036781,15.166666666666666
270,438,0,5387,2037219,16.22222222222222
460,763,0,5388,2037982,16.58695652173913
170,236,0,5389,2038218,13.882352941176471
110,153,0,5390,2038371,13.909090909090908
260,387,0,5391,2038758,14.884615384615385
190,336,0,5392,2039094,17.68421052631579
260,396,0,5393,2039490,15.23076923076923
330,477,0,5394,2039967,14.454545454545455
240,300,0,5395,2040267,12.5
180,279,0,5396,2040546,15.5
390,536,0,5397,2041082,13.743589743589743
280,400,0,5398,2041482,14.285714285714286
230,351,0,5399,2041833,15.26086956521739
330,422,0,5400,2042255,12.787878787878787
320,478,0,5401,2042733,14.9375
310,445,0,5402,2043178,14.35483870967742
310,457,0,5403,2043635,14.741935483870968
270,338,0,5404,2043973,12.518518518518519
280,481,0,5405,2044454,17.178571428571427
310,463,0,5406,2044917,14.935483870967742
160,226,0,5407,2045143,14.125
460,773,0,5408,2045916,16.804347826086957
300,429,0,5409,2046345,14.3
230,271,0,5410,2046616,11.782608695652174
170,254,0,5411,2046870,14.941176470588236
110,133,0,5412,2047003,12.090909090909092
240,366,0,5413,2047369,15.25
210,242,0,5414,2047611,11.523809523809524
150,182,0,5415,2047793,12.133333333333333
260,354,0,5416,2048147,13.615384615384615
310,462,0,5417,2048609,14.903225806451612
280,353,0,5418,2048962,12.607142857142858
150,248,0,5419,2049210,16.533333333333335
190,332,0,5420,2049542,17.473684210526315
310,450,0,5421,2049992,14.516129032258064
280,431,0,5422,2050423,15.392857142857142
240,357,0,5423,2050780,14.875
380,569,0,5424,2051349,14.973684210526315
350,510,0,5425,2051859,14.571428571428571
130,142,0,5426,2052001,10.923076923076923
280,373,0,5427,2052374,13.321428571428571
270,367,0,5428,2052741,13.592592592592593
350,520,0,5429,2053261,14.857142857142858
320,522,0,5430,2053783,16.3125
240,380,0,5431,2054163,15.833333333333334
290,455,0,5432,2054618,15.689655172413794
210,301,0,5433,2054919,14.333333333333334
330,454,0,5434,2055373,13.757575757575758
340,631,0,5435,2056004,18.558823529411764
300,403,0,5436,2056407,13.433333333333334
80,108,0,5437,2056515,13.5
310,474,0,5438,2056989,15.290322580645162
240,364,0,5439,2057353,15.166666666666666
190,248,0,5440,2057601,13.052631578947368
270,384,0,5441,2057985,14.222222222222221
330,559,0,5442,2058544,16.939393939393938
260,369,0,5443,2058913,14.192307692307692
110,185,0,5444,2059098,16.818181818181817
400,683,0,5445,2059781,17.075
380,611,0,5446,2060392,16.07894736842105
140,204,0,5447,2060596,14.571428571428571
150,212,0,5448,2060808,14.133333333333333
300,467,0,5449,2061275,15.566666666666666
280,370,0,5450,2061645,13.214285714285714
250,323,0,5451,2061968,12.92
410,703,0,5452,2062671,17.146341463414632
220,317,0,5453,2062988,14.409090909090908
360,480,0,5454,2063468,13.333333333333334
300,381,0,5455,2063849,12.7
160,250,0,5456,2064099,15.625
310,418,0,5457,2064517,13.483870967741936
230,331,0,5458,2064848,14.391304347826088
420,658,0,5459,2065506,15.666666666666666
350,480,0,5460,2065986,13.714285714285714
430,650,0,5461,2066636,15.116279069767442
220,349,0,5462,2066985,15.863636363636363
360,583,0,5463,2067568,16.194444444444443
170,254,0,5464,2067822,14.941176470588236
180,259,0,5465,2068081,14.38888888888889
440,651,0,5466,2068732,14.795454545454545
310,440,0,5467,2069172,14.193548387096774
160,250,0,5468,2069422,15.625
320,465,0,5469,2069887,14.53125
410,596,0,5470,2070483,14.536585365853659
220,335,0,5471,2070818,15.227272727272727
350,652,0,5472,2071470,18.62857142857143
230,295,0,5473,2071765,12.826086956521738
570,844,0,5474,2072609,14.807017543859649
130,181,0,5475,2072790,13.923076923076923
250,338,0,5476,2073128,13.52
160,253,0,5477,2073381,15.8125
280,431,0,5478,2073812,15.392857142857142
230,326,0,5479,2074138,14.173913043478262
260,418,0,5480,2074556,16.076923076923077
160,190,0,5481,2074746,11.875
190,340,0,5482,2075086,17.894736842105264
230,306,0,5483,2075392,13.304347826086957
330,588,0,5484,2075980,17.818181818181817
240,313,0,5485,2076293,13.041666666666666
250,360,0,5486,2076653,14.4
140,187,0,5487,2076840,13.357142857142858
380,533,0,5488,2077373,14.026315789473685
190,240,0,5489,2077613,12.631578947368421
210,308,0,5490,2077921,14.666666666666666
220,312,0,5491,2078233,14.181818181818182
260,364,0,5492,2078597,14.0
130,194,0,5493,2078791,14.923076923076923
280,440,0,5494,2079231,15.714285714285714
110,163,0,5495,2079394,14.818181818181818
210,300,0,5496,2079694,14.285714285714286
440,750,0,5497,2080444,17.045454545454547
260,316,0,5498,2080760,12.153846153846153
180,271,0,5499,2081031,15.055555555555555
320,504,0,5500,2081535,15.75
240,385,0,5501,2081920,16.041666666666668
400,673,0,5502,2082593,16.825
100,168,0,5503,2082761,16.8
240,309,0,5504,2083070,12.875
280,375,0,5505,2083445,13.392857142857142
150,205,0,5506,2083650,13.666666666666666
330,489,0,5507,2084139,14.818181818181818
550,876,0,5508,2085015,15.927272727272728
160,204,0,5509,2085219,12.75
310,556,0,5510,2085775,17.93548387096774
220,319,0,5511,2086094,14.5
370,551,0,5512,2086645,14.891891891891891
440,742,0,5513,2087387,16.863636363636363
350,558,0,5514,2087945,15.942857142857143
100,158,0,5515,2088103,15.8
90,126,0,5516,2088229,14.0
150,152,0,5517,2088381,10.133333333333333
360,422,0,5518,2088803,11.722222222222221
410,625,0,5519,2089428,15.24390243902439
200,288,0,5520,2089716,14.4
210,258,0,5521,2089974,12.285714285714286
290,483,0,5522,2090457,16.655172413793103
290,442,0,5523,2090899,15.241379310344827
180,252,0,5524,2091151,14.0
120,156,0,5525,2091307,13.0
300,502,0,5526,2091809,16.733333333333334
130,244,0,5527,2092053,18.76923076923077
180,239,0,5528,2092292,13.277777777777779
320,451,0,5529,2092743,14.09375
350,585,0,5530,2093328,16.714285714285715
330,635,0,5531,2093963,19.242424242424242
190,244,0,5532,2094207,12.842105263157896
140,196,0,5533,2094403,14.0
280,352,0,5534,2094755,12.571428571428571
220,310,0,5535,2095065,14.090909090909092
220,390,0,5536,2095455,17.727272727272727
230,324,0,5537,2095779,14.08695652173913
210,264,0,5538,2096043,12.571428571428571
310,460,0,5539,2096503,14.838709677419354
250,403,0,5540,2096906,16.12
200,329,0,5541,2097235,16.45
170,230,0,5542,2097465,13.529411764705882
400,537,0,5543,2098002,13.425
370,579,0,5544,2098581,15.64864864864865
410,666,0,5545,2099247,16.24390243902439
190,246,0,5546,2099493,12.947368421052632
260,386,0,5547,2099879,14.846153846153847
190,321,0,5548,2100200,16.894736842105264
220,330,0,5549,2100530,15.0
150,222,0,5550,2100752,14.8
260,354,0,5551,2101106,13.615384615384615
240,322,0,5552,2101428,13.416666666666666
330,468,0,5553,2101896,14.181818181818182
200,290,0,5554,2102186,14.5
260,445,0,5555,2102631,17.115384615384617
210,291,0,5556,2102922,13.857142857142858
150,198,0,5557,2103120,13.2
170,261,0,5558,2103381,15.352941176470589
210,310,0,5559,2103691,14.761904761904763
210,313,0,5560,2104004,14.904761904761905
150,244,0,5561,2104248,16.266666666666666
130,172,0,5562,2104420,13.23076923076923
280,418,0,5563,2104838,14.928571428571429
330,507,0,5564,2105345,15.363636363636363
240,407,0,5565,2105752,16.958333333333332
290,439,0,5566,2106191,15.137931034482758
330,477,0,5567,2106668,14.454545454545455
210,304,0,5568,2106972,14.476190476190476
380,603,0,5569,2107575,15.868421052631579
90,135,0,5570,2107710,15.0
250,341,0,5571,2108051,13.64
240,392,0,5572,2108443,16.333333333333332
380,671,0,5573,2109114,17.657894736842106
580,1057,0,5574,2110171,18.224137931034484
240,301,0,5575,2110472,12.541666666666666
150,252,0,5576,2110724,16.8
170,295,0,5577,2111019,17.352941176470587
40,46,0,5578,2111065,11.5
390,630,0,5579,2111695,16.153846153846153
340,567,0,5580,2112262,16.676470588235293
420,721,0,5581,2112983,17.166666666666668
210,311,0,5582,2113294,14.80952380952381
530,918,0,5583,2114212,17.32075471698113
200,262,0,5584,2114474,13.1
190,272,0,5585,2114746,14.31578947368421
230,321,0,5586,2115067,13.956521739130435
230,369,0,5587,2115436,16.043478260869566
420,775,0,5588,2116211,18.452380952380953
120,130,0,5589,2116341,10.833333333333334
180,290,0,5590,2116631,16.11111111111111
320,539,0,5591,2117170,16.84375
240,353,0,5592,2117523,14.708333333333334
510,923,0,5593,2118446,18.098039215686274
160,215,0,5594,2118661,13.4375
360,590,0,5595,2119251,16.38888888888889
80,102,0,5596,2119353,12.75
360,555,0,5597,2119908,15.416666666666666
300,433,0,5598,2120341,14.433333333333334
200,284,0,5599,2120625,14.2
230,351,0,5600,2120976,15.26086956521739
230,331,0,5601,2121307,14.391304347826088
300,453,0,5602,2121760,15.1
190,280,0,5603,2122040,14.736842105263158
190,254,0,5604,2122294,13.368421052631579
290,436,0,5605,2122730,15.03448275862069
350,592,0,5606,2123322,16.914285714285715
330,488,0,5607,2123810,14.787878787878787
300,413,0,5608,2124223,13.766666666666667
400,627,0,5609,2124850,15.675
110,161,0,5610,2125011,14.636363636363637
350,562,0,5611,2125573,16.057142857142857
380,608,0,5612,2126181,16.0
200,271,0,5613,2126452,13.55
190,355,0,5614,2126807,18.68421052631579
190,320,0,5615,2127127,16.842105263157894
350,544,0,5616,2127671,15.542857142857143
290,405,0,5617,2128076,13.96551724137931
310,450,0,5618,2128526,14.516129032258064
220,327,0,5619,2128853,14.863636363636363
360,541,0,5620,2129394,15.027777777777779
460,719,0,5621,2130113,15.630434782608695
280,439,0,5622,2130552,15.678571428571429
140,210,0,5623,2130762,15.0
180,262,0,5624,2131024,14.555555555555555
140,197,0,5625,2131221,14.071428571428571
190,246,0,5626,2131467,12.947368421052632
210,330,0,5627,2131797,15.714285714285714
210,346,0,5628,2132143,16.476190476190474
320,431,0,5629,2132574,13.46875
250,334,0,5630,2132908,13.36
370,525,0,5631,2133433,14.18918918918919
340,501,0,5632,2133934,14.735294117647058
210,293,0,5633,2134227,13.952380952380953
190,272,0,5634,2134499,14.31578947368421
420,631,0,5635,2135130,15.023809523809524
300,427,0,5636,2135557,14.233333333333333
190,313,0,5637,2135870,16.473684210526315
290,438,0,5638,2136308,15.10344827586207
230,286,0,5639,2136594,12.434782608695652
290,443,0,5640,2137037,15.275862068965518
300,428,0,5641,2137465,14.266666666666667
250,365,0,5642,2137830,14.6
230,403,0,5643,2138233,17.52173913043478
130,208,0,5644,2138441,16.0
150,254,0,5645,2138695,16.933333333333334
280,389,0,5646,2139084,13.892857142857142
160,206,0,5647,2139290,12.875
510,815,0,5648,2140105,15.980392156862745
370,536,0,5649,2140641,14.486486486486486
290,443,0,5650,2141084,15.275862068965518
270,355,0,5651,2141439,13.148148148148149
320,419,0,5652,2141858,13.09375
150,206,0,5653,2142064,13.733333333333333
200,254,0,5654,2142318,12.7
330,452,0,5655,2142770,13.696969696969697
150,179,0,5656,2142949,11.933333333333334
250,354,0,5657,2143303,14.16
230,338,0,5658,2143641,14.695652173913043
120,221,0,5659,2143862,18.416666666666668
100,150,0,5660,2144012,15.0
330,478,0,5661,2144490,14.484848484848484
150,186,0,5662,2144676,12.4
200,293,0,5663,2144969,14.65
180,218,0,5664,2145187,12.11111111111111
260,412,0,5665,2145599,15.846153846153847
480,856,0,5666,2146455,17.833333333333332
140,182,0,5667,2146637,13.0
250,378,0,5668,2147015,15.12
200,285,0,5669,2147300,14.25
180,230,0,5670,2147530,12.777777777777779
190,292,0,5671,2147822,15.368421052631579
180,272,0,5672,2148094,15.11111111111111
290,385,0,5673,2148479,13.275862068965518
230,358,0,5674,2148837,15.565217391304348
210,326,0,5675,2149163,15.523809523809524
300,468,0,5676,2149631,15.6
140,192,0,5677,2149823,13.714285714285714
130,181,0,5678,2150004,13.923076923076923
610,1148,0,5679,2151152,18.81967213114754
130,150,0,5680,2151302,11.538461538461538
400,644,0,5681,2151946,16.1
160,213,0,5682,2152159,13.3125
280,434,0,5683,2152593,15.5
150,214,0,5684,2152807,14.266666666666667
300,471,0,5685,2153278,15.7
250,385,0,5686,2153663,15.4
140,215,0,5687,2153878,15.357142857142858
410,646,0,5688,2154524,15.75609756097561
130,219,0,5689,2154743,16.846153846153847
410,616,0,5690,2155359,15.024390243902438
420,691,0,5691,2156050,16.452380952380953
180,266,0,5692,2156316,14.777777777777779
380,657,0,5693,2156973,17.289473684210527
150,228,0,5694,2157201,15.2
350,566,0,5695,2157767,16.17142857142857
250,346,0,5696,2158113,13.84
300,359,0,5697,2158472,11.966666666666667
420,648,0,5698,2159120,15.428571428571429
320,500,0,5699,2159620,15.625
110,152,0,5700,2159772,13.818181818181818
430,620,0,5701,2160392,14.418604651162791
210,286,0,5702,2160678,13.619047619047619
290,388,0,5703,2161066,13.379310344827585
180,268,0,5704,2161334,14.88888888888889
260,377,0,5705,2161711,14.5
300,462,0,5706,2162173,15.4
350,526,0,5707,2162699,15.028571428571428
270,379,0,5708,2163078,14.037037037037036
350,571,0,5709,2163649,16.314285714285713
230,384,0,5710,2164033,16.695652173913043
270,345,0,5711,2164378,12.777777777777779
280,429,0,5712,2164807,15.321428571428571
190,239,0,5713,2165046,12.578947368421053
130,200,0,5714,2165246,15.384615384615385
310,452,0,5715,2165698,14.580645161290322
380,588,0,5716,2166286,15.473684210526315
210,225,0,5717,2166511,10.714285714285714
210,274,0,5718,2166785,13.047619047619047
160,256,0,5719,2167041,16.0
190,209,0,5720,2167250,11.0
370,544,0,5721,2167794,14.702702702702704
230,280,0,5722,2168074,12.173913043478262
300,444,0,5723,2168518,14.8
290,380,0,5724,2168898,13.10344827586207
170,253,0,5725,2169151,14.882352941176471
470,766,0,5726,2169917,16.29787234042553
160,190,0,5727,2170107,11.875
270,424,0,5728,2170531,15.703703703703704
240,309,0,5729,2170840,12.875
250,431,0,5730,2171271,17.24
310,490,0,5731,2171761,15.806451612903226
250,311,0,5732,2172072,12.44
520,707,0,5733,2172779,13.596153846153847
140,193,0,5734,2172972,13.785714285714286
460,803,0,5735,2173775,17.456521739130434
170,271,0,5736,2174046,15.941176470588236
170,273,0,5737,2174319,16.058823529411764
230,331,0,5738,2174650,14.391304347826088
190,262,0,5739,2174912,13.789473684210526
60,80,0,5740,2174992,13.333333333333334
140,214,0,5741,2175206,15.285714285714286
140,213,0,5742,2175419,15.214285714285714
170,209,0,5743,2175628,12.294117647058824
220,333,0,5744,2175961,15.136363636363637
260,362,0,5745,2176323,13.923076923076923
250,295,0,5746,2176618,11.8
400,555,0,5747,2177173,13.875
140,194,0,5748,2177367,13.857142857142858
320,448,0,5749,2177815,14.0
280,412,0,5750,2178227,14.714285714285714
160,229,0,5751,2178456,14.3125
270,358,0,5752,2178814,13.25925925925926
130,152,0,5753,2178966,11.692307692307692
350,488,0,5754,2179454,13.942857142857143
270,429,0,5755,2179883,15.88888888888889
200,280,0,5756,2180163,14.0
290,361,0,5757,2180524,12.448275862068966
400,594,0,5758,2181118,14.85
290,412,0,5759,2181530,14.206896551724139
290,476,0,5760,2182006,16.413793103448278
270,329,0,5761,2182335,12.185185185185185
250,425,0,5762,2182760,17.0
220,336,0,5763,2183096,15.272727272727273
140,173,0,5764,2183269,12.357142857142858
260,362,0,5765,2183631,13.923076923076923
230,333,0,5766,2183964,14.478260869565217
390,614,0,5767,2184578,15.743589743589743
540,868,0,5768,2185446,16.074074074074073
250,360,0,5769,2185806,14.4
310,455,0,5770,2186261,14.67741935483871
220,379,0,5771,2186640,17.227272727272727
440,650,0,5772,2187290,14.772727272727273
250,390,0,5773,2187680,15.6
200,305,0,5774,2187985,15.25
310,515,0,5775,2188500,16.612903225806452
180,284,0,5776,2188784,15.777777777777779
390,563,0,5777,2189347,14.435897435897436
90,139,0,5778,2189486,15.444444444444445
190,307,0,5779,2189793,16.157894736842106
250,355,0,5780,2190148,14.2
80,114,0,5781,2190262,14.25
270,377,0,5782,2190639,13.962962962962964
530,920,0,5783,2191559,17.358490566037737
200,309,0,5784,2191868,15.45
300,406,0,5785,2192274,13.533333333333333
210,266,0,5786,2192540,12.666666666666666
230,362,0,5787,2192902,15.73913043478261
240,330,0,5788,2193232,13.75
210,364,0,5789,2193596,17.333333333333332
260,438,0,5790,2194034,16.846153846153847
370,580,0,5791,2194614,15.675675675675675
350,512,0,5792,2195126,14.628571428571428
350,438,0,5793,2195564,12.514285714285714
320,420,0,5794,2195984,13.125
160,219,0,5795,2196203,13.6875
80,101,0,5796,2196304,12.625
280,396,0,5797,2196700,14.142857142857142
270,348,0,5798,2197048,12.88888888888889
140,193,0,5799,2197241,13.785714285714286
90,128,0,5800,2197369,14.222222222222221
120,159,0,5801,2197528,13.25
330,581,0,5802,2198109,17.606060606060606
150,207,0,5803,2198316,13.8
120,187,0,5804,2198503,15.583333333333334
90,120,0,5805,2198623,13.333333333333334
110,156,0,5806,2198779,14.181818181818182
320,506,0,5807,2199285,15.8125
310,511,0,5808,2199796,16.483870967741936
410,561,0,5809,2200357,13.682926829268293
210,339,0,5810,2200696,16.142857142857142
410,663,0,5811,2201359,16.170731707317074
130,147,0,5812,2201506,11.307692307692308
340,469,0,5813,2201975,13.794117647058824
280,456,0,5814,2202431,16.285714285714285
140,285,0,5815,2202716,20.357142857142858
320,495,0,5816,2203211,15.46875
250,344,0,5817,2203555,13.76
230,346,0,5818,2203901,15.043478260869565
200,328,0,5819,2204229,16.4
270,392,0,5820,2204621,14.518518518518519
260,351,0,5821,2204972,13.5
180,279,0,5822,2205251,15.5
390,596,0,5823,2205847,15.282051282051283
260,353,0,5824,2206200,13.576923076923077
200,300,0,5825,2206500,15.0
340,558,0,5826,2207058,16.41176470588235
380,574,0,5827,2207632,15.105263157894736
140,160,0,5828,2207792,11.428571428571429
380,590,0,5829,2208382,15.526315789473685
230,331,0,5830,2208713,14.391304347826088
430,695,0,5831,2209408,16.162790697674417
220,301,0,5832,2209709,13.681818181818182
120,149,0,5833,2209858,12.416666666666666
210,366,0,5834,2210224,17.428571428571427
200,299,0,5835,2210523,14.95
210,291,0,5836,2210814,13.857142857142858
200,292,0,5837,2211106,14.6
300,488,0,5838,2211594,16.266666666666666
400,633,0,5839,2212227,15.825
230,377,0,5840,2212604,16.391304347826086
170,201,0,5841,2212805,11.823529411764707
310,454,0,5842,2213259,14.64516129032258
350,502,0,5843,2213761,14.342857142857143
150,205,0,5844,2213966,13.666666666666666
280,416,0,5845,2214382,14.857142857142858
210,312,0,5846,2214694,14.857142857142858
340,569,0,5847,2215263,16.735294117647058
380,594,0,5848,2215857,15.631578947368421
410,687,0,5849,2216544,16.75609756097561
150,195,0,5850,2216739,13.0
100,97,0,5851,2216836,9.7
360,517,0,5852,2217353,14.36111111111111
390,606,0,5853,2217959,15.538461538461538
170,273,0,5854,2218232,16.058823529411764
210,326,0,5855,2218558,15.523809523809524
310,501,0,5856,2219059,16.161290322580644
230,361,0,5857,2219420,15.695652173913043
220,345,0,5858,2219765,15.681818181818182
220,341,0,5859,2220106,15.5
200,340,0,5860,2220446,17.0
260,394,0,5861,2220840,15.153846153846153
310,494,0,5862,2221334,15.935483870967742
230,331,0,5863,2221665,14.391304347826088
310,507,0,5864,2222172,16.35483870967742
130,167,0,5865,2222339,12.846153846153847
150,215,0,5866,2222554,14.333333333333334
200,326,0,5867,2222880,16.3
90,91,0,5868,2222971,10.11111111111111
90,117,0,5869,2223088,13.0
70,114,0,5870,2223202,16.285714285714285
150,214,0,5871,2223416,14.266666666666667
260,336,0,5872,2223752,12.923076923076923
480,704,0,5873,2224456,14.666666666666666
190,248,0,5874,2224704,13.052631578947368
290,411,0,5875,2225115,14.172413793103448
340,520,0,5876,2225635,15.294117647058824
270,502,0,5877,2226137,18.59259259259259
170,206,0,5878,2226343,12.117647058823529
180,260,0,5879,2226603,14.444444444444445
150,231,0,5880,2226834,15.4
370,571,0,5881,2227405,15.432432432432432
270,359,0,5882,2227764,13.296296296296296
190,245,0,5883,2228009,12.894736842105264
180,260,0,5884,2228269,14.444444444444445
280,404,0,5885,2228673,14.428571428571429
300,457,0,5886,2229130,15.233333333333333
360,576,0,5887,2229706,16.0
220,345,0,5888,2230051,15.681818181818182
190,252,0,5889,2230303,13.263157894736842
200,332,0,5890,2230635,16.6
170,238,0,5891,2230873,14.0
300,413,0,5892,2231286,13.766666666666667
320,440,0,5893,2231726,13.75
320,529,0,5894,2232255,16.53125
120,146,0,5895,2232401,12.166666666666666
300,435,0,5896,2232836,14.5
340,464,0,5897,2233300,13.647058823529411
360,498,0,5898,2233798,13.833333333333334
360,588,0,5899,2234386,16.333333333333332
260,390,0,5900,2234776,15.0
220,351,0,5901,2235127,15.954545454545455
190,304,0,5902,2235431,16.0
100,153,0,5903,2235584,15.3
90,101,0,5904,2235685,11.222222222222221
200,284,0,5905,2235969,14.2
310,441,0,5906,2236410,14.225806451612904
280,404,0,5907,2236814,14.428571428571429
310,395,0,5908,2237209,12.741935483870968
340,585,0,5909,2237794,17.205882352941178
180,271,0,5910,2238065,15.055555555555555
240,287,0,5911,2238352,11.958333333333334
260,341,0,5912,2238693,13.115384615384615
200,255,0,5913,2238948,12.75
350,529,0,5914,2239477,15.114285714285714
300,486,0,5915,2239963,16.2
130,164,0,5916,2240127,12.615384615384615
110,120,0,5917,2240247,10.909090909090908
340,510,0,5918,2240757,15.0
250,387,0,5919,2241144,15.48
90,121,0,5920,2241265,13.444444444444445
250,407,0,5921,2241672,16.28
420,740,0,5922,2242412,17.61904761904762
360,572,0,5923,2242984,15.88888888888889
440,718,0,5924,2243702,16.318181818181817
120,116,0,5925,2243818,9.666666666666666
300,459,0,5926,2244277,15.3
100,126,0,5927,2244403,12.6
130,211,0,5928,2244614,16.23076923076923
300,467,0,5929,2245081,15.566666666666666
290,427,0,5930,2245508,14.724137931034482
190,230,0,5931,2245738,12.105263157894736
380,626,0,5932,2246364,16.473684210526315
240,330,0,5933,2246694,13.75
430,805,0,5934,2247499,18.72093023255814
260,346,0,5935,2247845,13.307692307692308
120,174,0,5936,2248019,14.5
120,169,0,5937,2248188,14.083333333333334
220,295,0,5938,2248483,13.409090909090908
280,414,0,5939,2248897,14.785714285714286
150,228,0,5940,2249125,15.2
290,386,0,5941,2249511,13.310344827586206
520,934,0,5942,2250445,17.96153846153846
110,111,0,5943,2250556,10.090909090909092
280,430,0,5944,2250986,15.357142857142858
400,582,0,5945,2251568,14.55
220,324,0,5946,2251892,14.727272727272727
290,416,0,5947,2252308,14.344827586206897
190,300,0,5948,2252608,15.789473684210526
220,304,0,5949,2252912,13.818181818181818
370,577,0,5950,2253489,15.594594594594595
220,335,0,5951,2253824,15.227272727272727
260,382,0,5952,2254206,14.692307692307692
90,121,0,5953,2254327,13.444444444444445
230,295,0,5954,2254622,12.826086956521738
240,354,0,5955,2254976,14.75
290,443,0,5956,2255419,15.275862068965518
170,201,0,5957,2255620,11.823529411764707
230,386,0,5958,2256006,16.782608695652176
140,189,0,5959,2256195,13.5
190,240,0,5960,2256435,12.631578947368421
250,403,0,5961,2256838,16.12
520,894,0,5962,2257732,17.192307692307693
50,73,0,5963,2257805,14.6
290,425,0,5964,2258230,14.655172413793103
180,251,0,5965,2258481,13.944444444444445
190,302,0,5966,2258783,15.894736842105264
130,230,0,5967,2259013,17.692307692307693
280,423,0,5968,2259436,15.107142857142858
210,296,0,5969,2259732,14.095238095238095
140,218,0,5970,2259950,15.571428571428571
240,345,0,5971,2260295,14.375
300,412,0,5972,2260707,13.733333333333333
120,142,0,5973,2260849,11.833333333333334
110,180,0,5974,2261029,16.363636363636363
210,255,0,5975,2261284,12.142857142857142
130,186,0,5976,2261470,14.307692307692308
250,337,0,5977,2261807,13.48
130,155,0,5978,2261962,11.923076923076923
70,102,0,5979,2262064,14.571428571428571
170,245,0,5980,2262309,14.411764705882353
150,213,0,5981,2262522,14.2
240,339,0,5982,2262861,14.125
290,411,0,5983,2263272,14.172413793103448
180,253,0,5984,2263525,14.055555555555555
280,359,0,5985,2263884,12.821428571428571
240,391,0,5986,2264275,16.291666666666668
260,402,0,5987,2264677,15.461538461538462
250,326,0,5988,2265003,13.04
90,102,0,5989,2265105,11.333333333333334
310,433,0,5990,2265538,13.96774193548387
150,159,0,5991,2265697,10.6
200,285,0,5992,2265982,14.25
320,437,0,5993,2266419,13.65625
280,419,0,5994,2266838,14.964285714285714
250,381,0,5995,2267219,15.24
150,226,0,5996,2267445,15.066666666666666
300,513,0,5997,2267958,17.1
330,523,0,5998,2268481,15.848484848484848
150,174,0,5999,2268655,11.6
250,380,0,6000,2269035,15.2
280,398,0,6001,2269433,14.214285714285714
260,345,0,6002,2269778,13.26923076923077
180,330,0,6003,2270108,18.333333333333332
170,203,0,6004,2270311,11.941176470588236
290,419,0,6005,2270730,14.448275862068966
350,584,0,6006,2271314,16.685714285714287
350,533,0,6007,2271847,15.228571428571428
320,486,0,6008,2272333,15.1875
200,225,0,6009,2272558,11.25
350,542,0,6010,2273100,15.485714285714286
140,191,0,6011,2273291,13.642857142857142
330,476,0,6012,2273767,14.424242424242424
270,496,0,6013,2274263,18.37037037037037
230,274,0,6014,2274537,11.91304347826087
170,242,0,6015,2274779,14.235294117647058
120,154,0,6016,2274933,12.833333333333334
310,452,0,6017,2275385,14.580645161290322
290,470,0,6018,2275855,16.20689655172414
170,236,0,6019,2276091,13.882352941176471
260,409,0,6020,2276500,15.73076923076923
100,106,0,6021,2276606,10.6
160,255,0,6022,2276861,15.9375
260,378,0,6023,2277239,14.538461538461538
180,262,0,6024,2277501,14.555555555555555
260,349,0,6025,2277850,13.423076923076923
170,253,0,6026,2278103,14.882352941176471
350,542,0,6027,2278645,15.485714285714286
320,519,0,6028,2279164,16.21875
250,383,0,6029,2279547,15.32
400,571,0,6030,2280118,14.275
220,254,0,6031,2280372,11.545454545454545
230,346,0,6032,2280718,15.043478260869565
450,780,0,6033,2281498,17.333333333333332
240,326,0,6034,2281824,13.583333333333334
220,272,0,6035,2282096,12.363636363636363
220,351,0,6036,2282447,15.954545454545455
380,533,0,6037,2282980,14.026315789473685
70,87,0,6038,2283067,12.428571428571429
440,687,0,6039,2283754,15.613636363636363
160,174,0,6040,2283928,10.875
120,138,0,6041,2284066,11.5
380,526,0,6042,2284592,13.842105263157896
200,275,0,6043,2284867,13.75
230,337,0,6044,2285204,14.652173913043478
190,247,0,6045,2285451,13.0
160,274,0,6046,2285725,17.125
260,434,0,6047,2286159,16.692307692307693
140,176,0,6048,2286335,12.571428571428571
130,210,0,6049,2286545,16.153846153846153
160,223,0,6050,2286768,13.9375
220,250,0,6051,2287018,11.363636363636363
290,485,0,6052,2287503,16.724137931034484
240,379,0,6053,2287882,15.791666666666666
470,818,0,6054,2288700,17.404255319148938
180,205,0,6055,2288905,11.38888888888889
340,552,0,6056,2289457,16.235294117647058
180,251,0,6057,2289708,13.944444444444445
220,298,0,6058,2290006,13.545454545454545
240,402,0,6059,2290408,16.75
300,386,0,6060,2290794,12.866666666666667
420,583,0,6061,2291377,13.880952380952381
280,395,0,6062,2291772,14.107142857142858
360,621,0,6063,2292393,17.25
450,791,0,6064,2293184,17.57777777777778
520,839,0,6065,2294023,16.134615384615383
350,547,0,6066,2294570,15.628571428571428
300,559,0,6067,2295129,18.633333333333333
110,152,0,6068,2295281,13.818181818181818
190,273,0,6069,2295554,14.368421052631579
130,159,0,6070,2295713,12.23076923076923
250,310,0,6071,2296023,12.4
390,609,0,6072,2296632,15.615384615384615
240,390,0,6073,2297022,16.25
270,408,0,6074,2297430,15.11111111111111
690,1047,0,6075,2298477,15.173913043478262
330,483,0,6076,2298960,14.636363636363637
260,355,0,6077,2299315,13.653846153846153
320,446,0,6078,2299761,13.9375
300,467,0,6079,2300228,15.566666666666666
270,394,0,6080,2300622,14.592592592592593
130,171,0,6081,2300793,13.153846153846153
90,183,0,6082,2300976,20.333333333333332
250,356,0,6083,2301332,14.24
110,126,0,6084,2301458,11.454545454545455
290,470,0,6085,2301928,16.20689655172414
290,452,0,6086,2302380,15.586206896551724
220,299,0,6087,2302679,13.590909090909092
250,342,0,6088,2303021,13.68
300,497,0,6089,2303518,16.566666666666666
290,416,0,6090,2303934,14.344827586206897
320,508,0,6091,2304442,15.875
320,522,0,6092,2304964,16.3125
200,359,0,6093,2305323,17.95
440,680,0,6094,2306003,15.454545454545455
400,694,0,6095,2306697,17.35
330,474,0,6096,2307171,14.363636363636363
280,387,0,6097,2307558,13.821428571428571
60,98,0,6098,2307656,16.333333333333332
200,264,0,6099,2307920,13.2
390,572,0,6100,2308492,14.666666666666666
220,338,0,6101,2308830,15.363636363636363
310,483,0,6102,2309313,15.580645161290322
300,458,0,6103,2309771,15.266666666666667
370,611,0,6104,2310382,16.513513513513512
230,282,0,6105,2310664,12.26086956521739
220,296,0,6106,2310960,13.454545454545455
200,269,0,6107,2311229,13.45
180,261,0,6108,2311490,14.5
180,232,0,6109,2311722,12.88888888888889
160,209,0,6110,2311931,13.0625
230,326,0,6111,2312257,14.173913043478262
420,623,0,6112,2312880,14.833333333333334
230,354,0,6113,2313234,15.391304347826088
260,376,0,6114,2313610,14.461538461538462
190,277,0,6115,2313887,14.578947368421053
300,425,0,6116,2314312,14.166666666666666
280,461,0,6117,2314773,16.464285714285715
210,293,0,6118,2315066,13.952380952380953
160,243,0,6119,2315309,15.1875
370,585,0,6120,2315894,15.81081081081081
310,474,0,6121,2316368,15.290322580645162
260,359,0,6122,2316727,13.807692307692308
250,393,0,6123,2317120,15.72
250,379,0,6124,2317499,15.16
80,107,0,6125,2317606,13.375
280,445,0,6126,2318051,15.892857142857142
70,111,0,6127,2318162,15.857142857142858
400,658,0,6128,2318820,16.45
240,366,0,6129,2319186,15.25
300,430,0,6130,2319616,14.333333333333334
250,368,0,6131,2319984,14.72
250,351,0,6132,2320335,14.04
460,798,0,6133,2321133,17.347826086956523
160,215,0,6134,2321348,13.4375
220,280,0,6135,2321628,12.727272727272727
120,162,0,6136,2321790,13.5
230,319,0,6137,2322109,13.869565217391305
120,134,0,6138,2322243,11.166666666666666
450,670,0,6139,2322913,14.88888888888889
210,253,0,6140,2323166,12.047619047619047
300,501,0,6141,2323667,16.7
310,435,0,6142,2324102,14.03225806451613
290,487,0,6143,2324589,16.79310344827586
150,233,0,6144,2324822,15.533333333333333
200,358,0,6145,2325180,17.9
370,576,0,6146,2325756,15.567567567567568
110,150,0,6147,2325906,13.636363636363637
200,280,0,6148,2326186,14.0
360,652,0,6149,2326838,18.11111111111111
160,225,0,6150,2327063,14.0625
130,191,0,6151,2327254,14.692307692307692
440,713,0,6152,2327967,16.204545454545453
220,309,0,6153,2328276,14.045454545454545
270,449,0,6154,2328725,16.62962962962963
260,398,0,6155,2329123,15.307692307692308
390,559,0,6156,2329682,14.333333333333334
280,420,0,6157,2330102,15.0
140,214,0,6158,2330316,15.285714285714286
40,39,0,6159,2330355,9.75
430,604,0,6160,2330959,14.046511627906977
100,103,0,6161,2331062,10.3
210,381,0,6162,2331443,18.142857142857142
300,517,0,6163,2331960,17.233333333333334
380,633,0,6164,2332593,16.657894736842106
280,417,0,6165,2333010,14.892857142857142
110,193,0,6166,2333203,17.545454545454547
190,276,0,6167,2333479,14.526315789473685
130,170,0,6168,2333649,13.076923076923077
160,204,0,6169,2333853,12.75
220,300,0,6170,2334153,13.636363636363637
290,425,0,6171,2334578,14.655172413793103
150,226,0,6172,2334804,15.066666666666666
240,365,0,6173,2335169,15.208333333333334
220,360,0,6174,2335529,16.363636363636363
340,505,0,6175,2336034,14.852941176470589
150,176,0,6176,2336210,11.733333333333333
340,527,0,6177,2336737,15.5
200,307,0,6178,2337044,15.35
220,322,0,6179,2337366,14.636363636363637
290,472,0,6180,2337838,16.275862068965516
200,306,0,6181,2338144,15.3
290,494,0,6182,2338638,17.03448275862069
490,773,0,6183,2339411,15.775510204081632
210,258,0,6184,2339669,12.285714285714286
220,329,0,6185,2339998,14.954545454545455
210,289,0,6186,2340287,13.761904761904763
200,312,0,6187,2340599,15.6
150,187,0,6188,2340786,12.466666666666667
260,395,0,6189,2341181,15.192307692307692
140,281,0,6190,2341462,20.071428571428573
350,633,0,6191,2342095,18.085714285714285
380,531,0,6192,2342626,13.973684210526315
410,583,0,6193,2343209,14.21951219512195
260,362,0,6194,2343571,13.923076923076923
390,628,0,6195,2344199,16.102564102564102
280,392,0,6196,2344591,14.0
360,537,0,6197,2345128,14.916666666666666
320,481,0,6198,2345609,15.03125
340,530,0,6199,2346139,15.588235294117647
250,351,0,6200,2346490,14.04
370,559,0,6201,2347049,15.108108108108109
340,518,0,6202,2347567,15.235294117647058
150,228,0,6203,2347795,15.2
120,136,0,6204,2347931,11.333333333333334
270,395,0,6205,2348326,14.62962962962963
180,223,0,6206,2348549,12.38888888888889
280,433,0,6207,2348982,15.464285714285714
140,188,0,6208,2349170,13.428571428571429
400,557,0,6209,2349727,13.925
210,293,0,6210,2350020,13.952380952380953
120,153,0,6211,2350173,12.75
300,400,0,6212,2350573,13.333333333333334
240,390,0,6213,2350963,16.25
330,513,0,6214,2351476,15.545454545454545
210,299,0,6215,2351775,14.238095238095237
360,587,0,6216,2352362,16.305555555555557
220,320,0,6217,2352682,14.545454545454545
420,703,0,6218,2353385,16.738095238095237
500,831,0,6219,2354216,16.62
280,412,0,6220,2354628,14.714285714285714
250,351,0,6221,2354979,14.04
240,370,0,6222,2355349,15.416666666666666
290,383,0,6223,2355732,13.206896551724139
170,209,0,6224,2355941,12.294117647058824
190,234,0,6225,2356175,12.31578947368421
220,302,0,6226,2356477,13.727272727272727
290,384,0,6227,2356861,13.241379310344827
200,257,0,6228,2357118,12.85
430,710,0,6229,2357828,16.511627906976745
300,443,0,6230,2358271,14.766666666666667
190,312,0,6231,2358583,16.42105263157895
470,765,0,6232,2359348,16.27659574468085
160,234,0,6233,2359582,14.625
210,344,0,6234,2359926,16.38095238095238
360,550,0,6235,2360476,15.277777777777779
330,446,0,6236,2360922,13.515151515151516
260,323,0,6237,2361245,12.423076923076923
230,345,0,6238,2361590,15.0
330,462,0,6239,2362052,14.0
270,358,0,6240,2362410,13.25925925925926
130,192,0,6241,2362602,14.76923076923077
340,450,0,6242,2363052,13.235294117647058
80,124,0,6243,2363176,15.5
260,421,0,6244,2363597,16.192307692307693
460,703,0,6245,2364300,15.282608695652174
90,168,0,6246,2364468,18.666666666666668
200,352,0,6247,2364820,17.6
210,299,0,6248,2365119,14.238095238095237
100,114,0,6249,2365233,11.4
190,257,0,6250,2365490,13.526315789473685
220,308,0,6251,2365798,14.0
420,845,0,6252,2366643,20.11904761904762
210,370,0,6253,2367013,17.61904761904762
140,198,0,6254,2367211,14.142857142857142
480,717,0,6255,2367928,14.9375
210,293,0,6256,2368221,13.952380952380953
310,438,0,6257,2368659,14.129032258064516
220,313,0,6258,2368972,14.227272727272727
160,178,0,6259,2369150,11.125
80,103,0,6260,2369253,12.875
290,447,0,6261,2369700,15.413793103448276
400,651,0,6262,2370351,16.275
260,381,0,6263,2370732,14.653846153846153
360,559,0,6264,2371291,15.527777777777779
430,597,0,6265,2371888,13.883720930232558
370,617,0,6266,2372505,16.675675675675677
240,305,0,6267,2372810,12.708333333333334
200,256,0,6268,2373066,12.8
190,323,0,6269,2373389,17.0
200,271,0,6270,2373660,13.55
100,129,0,6271,2373789,12.9
130,198,0,6272,2373987,15.23076923076923
330,432,0,6273,2374419,13.090909090909092
370,610,0,6274,2375029,16.486486486486488
110,167,0,6275,2375196,15.181818181818182
290,449,0,6276,2375645,15.482758620689655
180,301,0,6277,2375946,16.72222222222222
330,490,0,6278,2376436,14.848484848484848
230,327,0,6279,2376763,14.217391304347826
280,337,0,6280,2377100,12.035714285714286
160,208,0,6281,2377308,13.0
130,223,0,6282,2377531,17.153846153846153
160,272,0,6283,2377803,17.0
270,483,0,6284,2378286,17.88888888888889
260,326,0,6285,2378612,12.538461538461538
270,385,0,6286,2378997,14.25925925925926
220,355,0,6287,2379352,16.136363636363637
130,185,0,6288,2379537,14.23076923076923
350,509,0,6289,2380046,14.542857142857143
220,351,0,6290,2380397,15.954545454545455
350,573,0,6291,2380970,16.37142857142857
200,335,0,6292,2381305,16.75
200,180,0,6293,2381485,9.0
320,456,0,6294,2381941,14.25
270,412,0,6295,2382353,15.25925925925926
380,606,0,6296,2382959,15.947368421052632
280,406,0,6297,2383365,14.5
330,526,0,6298,2383891,15.93939393939394
190,248,0,6299,2384139,13.052631578947368
180,282,0,6300,2384421,15.666666666666666
410,611,0,6301,2385032,14.902439024390244
260,349,0,6302,2385381,13.423076923076923
380,682,0,6303,2386063,17.94736842105263
110,117,0,6304,2386180,10.636363636363637
180,235,0,6305,2386415,13.055555555555555
80,86,0,6306,2386501,10.75
270,446,0,6307,2386947,16.51851851851852
200,280,0,6308,2387227,14.0
300,415,0,6309,2387642,13.833333333333334
80,108,0,6310,2387750,13.5
300,421,0,6311,2388171,14.033333333333333
260,315,0,6312,2388486,12.115384615384615
190,302,0,6313,2388788,15.894736842105264
260,436,0,6314,2389224,16.76923076923077
210,280,0,6315,2389504,13.333333333333334
180,195,0,6316,2389699,10.833333333333334
120,158,0,6317,2389857,13.166666666666666
110,171,0,6318,2390028,15.545454545454545
240,334,0,6319,2390362,13.916666666666666
330,445,0,6320,2390807,13.484848484848484
360,581,0,6321,2391388,16.13888888888889
170,275,0,6322,2391663,16.176470588235293
390,592,0,6323,2392255,15.179487179487179
290,448,0,6324,2392703,15.448275862068966
430,612,0,6325,2393315,14.232558139534884
230,316,0,6326,2393631,13.73913043478261
300,521,0,6327,2394152,17.366666666666667
220,316,0,6328,2394468,14.363636363636363
430,778,0,6329,2395246,18.093023255813954
220,288,0,6330,2395534,13.090909090909092
220,381,0,6331,2395915,17.318181818181817
320,492,0,6332,2396407,15.375
290,468,0,6333,2396875,16.137931034482758
230,306,0,6334,2397181,13.304347826086957
310,529,0,6335,2397710,17.06451612903226
200,281,0,6336,2397991,14.05
340,480,0,6337,2398471,14.117647058823529
140,155,0,6338,2398626,11.071428571428571
330,560,0,6339,2399186,16.96969696969697
370,517,0,6340,2399703,13.972972972972974
170,223,0,6341,2399926,13.117647058823529
440,663,0,6342,2400589,15.068181818181818
290,410,0,6343,2400999,14.137931034482758
190,323,0,6344,2401322,17.0
330,447,0,6345,2401769,13.545454545454545
250,314,0,6346,2402083,12.56
260,508,0,6347,2402591,19.53846153846154
110,154,0,6348,2402745,14.0
130,198,0,6349,2402943,15.23076923076923
220,357,0,6350,2403300,16.227272727272727
280,436,0,6351,2403736,15.571428571428571
270,437,0,6352,2404173,16.185185185185187
110,145,0,6353,2404318,13.181818181818182
190,300,0,6354,2404618,15.789473684210526
160,204,0,6355,2404822,12.75
120,158,0,6356,2404980,13.166666666666666
240,382,0,6357,2405362,15.916666666666666
290,453,0,6358,2405815,15.620689655172415
300,473,0,6359,2406288,15.766666666666667
360,639,0,6360,2406927,17.75
80,106,0,6361,2407033,13.25
220,351,0,6362,2407384,15.954545454545455
230,338,0,6363,2407722,14.695652173913043
360,581,0,6364,2408303,16.13888888888889
350,564,0,6365,2408867,16.114285714285714
220,285,0,6366,2409152,12.954545454545455
310,530,0,6367,2409682,17.096774193548388
230,358,0,6368,2410040,15.565217391304348
160,213,0,6369,2410253,13.3125
210,291,0,6370,2410544,13.857142857142858
240,375,0,6371,2410919,15.625
170,266,0,6372,2411185,15.647058823529411
380,530,0,6373,2411715,13.947368421052632
270,470,0,6374,2412185,17.40740740740741
390,625,0,6375,2412810,16.025641025641026
280,463,0,6376,2413273,16.535714285714285
290,506,0,6377,2413779,17.448275862068964
220,258,0,6378,2414037,11.727272727272727
320,496,0,6379,2414533,15.5
180,228,0,6380,2414761,12.666666666666666
170,268,0,6381,2415029,15.764705882352942
70,82,0,6382,2415111,11.714285714285714
210,286,0,6383,2415397,13.619047619047619
120,137,0,6384,2415534,11.416666666666666
150,252,0,6385,2415786,16.8
140,221,0,6386,2416007,15.785714285714286
170,245,0,6387,2416252,14.411764705882353
150,241,0,6388,2416493,16.066666666666666
220,305,0,6389,2416798,13.863636363636363
240,386,0,6390,2417184,16.083333333333332
330,456,0,6391,2417640,13.818181818181818
310,404,0,6392,2418044,13.03225806451613
410,545,0,6393,2418589,13.292682926829269
120,168,0,6394,2418757,14.0
220,295,0,6395,2419052,13.409090909090908
110,167,0,6396,2419219,15.181818181818182
260,359,0,6397,2419578,13.807692307692308
170,265,0,6398,2419843,15.588235294117647
370,561,0,6399,2420404,15.162162162162161
250,337,0,6400,2420741,13.48
240,410,0,6401,2421151,17.083333333333332
250,304,0,6402,2421455,12.16
170,212,0,6403,2421667,12.470588235294118
160,208,0,6404,2421875,13.0
360,520,0,6405,2422395,14.444444444444445
140,148,0,6406,2422543,10.571428571428571
110,132,0,6407,2422675,12.0
280,423,0,6408,2423098,15.107142857142858
230,344,0,6409,2423442,14.956521739130435
230,321,0,6410,2423763,13.956521739130435
210,276,0,6411,2424039,13.142857142857142
210,342,0,6412,2424381,16.285714285714285
270,404,0,6413,2424785,14.962962962962964
80,86,0,6414,2424871,10.75
250,418,0,6415,2425289,16.72
250,437,0,6416,2425726,17.48
230,307,0,6417,2426033,13.347826086956522
180,193,0,6418,2426226,10.722222222222221
120,178,0,6419,2426404,14.833333333333334
420,645,0,6420,2427049,15.357142857142858
300,430,0,6421,2427479,14.333333333333334
50,60,0,6422,2427539,12.0
280,430,0,6423,2427969,15.357142857142858
120,174,0,6424,2428143,14.5
170,261,0,6425,2428404,15.352941176470589
240,329,0,6426,2428733,13.708333333333334
290,430,0,6427,2429163,14.827586206896552
230,363,0,6428,2429526,15.782608695652174
240,278,0,6429,2429804,11.583333333333334
280,400,0,6430,2430204,14.285714285714286
170,225,0,6431,2430429,13.235294117647058
110,146,0,6432,2430575,13.272727272727273
340,556,0,6433,2431131,16.352941176470587
270,423,0,6434,2431554,15.666666666666666
290,421,0,6435,2431975,14.517241379310345
310,448,0,6436,2432423,14.451612903225806
380,577,0,6437,2433000,15.18421052631579
260,365,0,6438,2433365,14.038461538461538
170,234,0,6439,2433599,13.764705882352942
320,518,0,6440,2434117,16.1875
80,72,0,6441,2434189,9.0
300,463,0,6442,2434652,15.433333333333334
360,525,0,6443,2435177,14.583333333333334
310,387,0,6444,2435564,12.483870967741936
300,452,0,6445,2436016,15.066666666666666
170,240,0,6446,2436256,14.117647058823529
160,226,0,6447,2436482,14.125
260,370,0,6448,2436852,14.23076923076923
290,428,0,6449,2437280,14.758620689655173
140,210,0,6450,2437490,15.0
190,255,0,6451,2437745,13.421052631578947
200,235,0,6452,2437980,11.75
90,117,0,6453,2438097,13.0
290,444,0,6454,2438541,15.310344827586206
130,181,0,6455,2438722,13.923076923076923
440,763,0,6456,2439485,17.34090909090909
260,351,0,6457,2439836,13.5
330,512,0,6458,2440348,15.515151515151516
200,279,0,6459,2440627,13.95
70,106,0,6460,2440733,15.142857142857142
310,529,0,6461,2441262,17.06451612903226
330,549,0,6462,2441811,16.636363636363637
290,448,0,6463,2442259,15.448275862068966
610,992,0,6464,2443251,16.262295081967213
320,448,0,6465,2443699,14.0
90,114,0,6466,2443813,12.666666666666666
90,123,0,6467,2443936,13.666666666666666
160,232,0,6468,2444168,14.5
410,648,0,6469,2444816,15.804878048780488
300,412,0,6470,2445228,13.733333333333333
340,515,0,6471,2445743,15.147058823529411
130,206,0,6472,2445949,15.846153846153847
130,196,0,6473,2446145,15.076923076923077
170,259,0,6474,2446404,15.235294117647058
190,260,0,6475,2446664,13.68421052631579
370,565,0,6476,2447229,15.27027027027027
430,697,0,6477,2447926,16.209302325581394
250,380,0,6478,2448306,15.2
390,684,0,6479,2448990,17.53846153846154
90,137,0,6480,2449127,15.222222222222221
320,506,0,6481,2449633,15.8125
370,572,0,6482,2450205,15.45945945945946
200,276,0,6483,2450481,13.8
430,604,0,6484,2451085,14.046511627906977
220,323,0,6485,2451408,14.681818181818182
320,463,0,6486,2451871,14.46875
110,154,0,6487,2452025,14.0
320,541,0,6488,2452566,16.90625
150,170,0,6489,2452736,11.333333333333334
230,305,0,6490,2453041,13.26086956521739
310,456,0,6491,2453497,14.709677419354838
240,390,0,6492,2453887,16.25
520,777,0,6493,2454664,14.942307692307692
190,279,0,6494,2454943,14.68421052631579
220,384,0,6495,2455327,17.454545454545453
240,277,0,6496,2455604,11.541666666666666
220,322,0,6497,2455926,14.636363636363637
270,448,0,6498,2456374,16.59259259259259
470,739,0,6499,2457113,15.72340425531915
480,842,0,6500,2457955,17.541666666666668
150,189,0,6501,2458144,12.6
110,105,0,6502,2458249,9.545454545454545
160,171,0,6503,2458420,10.6875
110,146,0,6504,2458566,13.272727272727273
380,634,0,6505,2459200,16.68421052631579
300,419,0,6506,2459619,13.966666666666667
430,723,0,6507,2460342,16.813953488372093
300,426,0,6508,2460768,14.2
200,227,0,6509,2460995,11.35
140,154,0,6510,2461149,11.0
360,527,0,6511,2461676,14.63888888888889
350,603,0,6512,2462279,17.228571428571428
150,196,0,6513,2462475,13.066666666666666
220,344,0,6514,2462819,15.636363636363637
360,514,0,6515,2463333,14.277777777777779
80,95,0,6516,2463428,11.875
260,327,0,6517,2463755,12.576923076923077
190,234,0,6518,2463989,12.31578947368421
210,282,0,6519,2464271,13.428571428571429
270,394,0,6520,2464665,14.592592592592593
260,360,0,6521,2465025,13.846153846153847
240,418,0,6522,2465443,17.416666666666668
210,304,0,6523,2465747,14.476190476190476
300,441,0,6524,2466188,14.7
220,285,0,6525,2466473,12.954545454545455
300,462,0,6526,2466935,15.4
330,585,0,6527,2467520,17.727272727272727
270,387,0,6528,2467907,14.333333333333334
240,350,0,6529,2468257,14.583333333333334
310,435,0,6530,2468692,14.03225806451613
330,489,0,6531,2469181,14.818181818181818
200,239,0,6532,2469420,11.95
170,231,0,6533,2469651,13.588235294117647
170,258,0,6534,2469909,15.176470588235293
320,495,0,6535,2470404,15.46875
140,226,0,6536,2470630,16.142857142857142
220,321,0,6537,2470951,14.590909090909092
180,236,0,6538,2471187,13.11111111111111
320,555,0,6539,2471742,17.34375
300,435,0,6540,2472177,14.5
350,536,0,6541,2472713,15.314285714285715
220,298,0,6542,2473011,13.545454545454545
280,364,0,6543,2473375,13.0
280,436,0,6544,2473811,15.571428571428571
190,247,0,6545,2474058,13.0
220,272,0,6546,2474330,12.363636363636363
250,358,0,6547,2474688,14.32
170,290,0,6548,2474978,17.058823529411764
220,352,0,6549,2475330,16.0
320,444,0,6550,2475774,13.875
220,278,0,6551,2476052,12.636363636363637
160,234,0,6552,2476286,14.625
180,298,0,6553,2476584,16.555555555555557
160,266,0,6554,2476850,16.625
450,814,0,6555,2477664,18.08888888888889
250,303,0,6556,2477967,12.12
230,337,0,6557,2478304,14.652173913043478
420,637,0,6558,2478941,15.166666666666666
80,90,0,6559,2479031,11.25
120,171,0,6560,2479202,14.25
130,175,0,6561,2479377,13.461538461538462
110,175,0,6562,2479552,15.909090909090908
150,186,0,6563,2479738,12.4
160,248,0,6564,2479986,15.5
280,396,0,6565,2480382,14.142857142857142
80,104,0,6566,2480486,13.0
250,388,0,6567,2480874,15.52
360,588,0,6568,2481462,16.333333333333332
220,286,0,6569,2481748,13.0
140,164,0,6570,2481912,11.714285714285714
130,160,0,6571,2482072,12.307692307692308
290,459,0,6572,2482531,15.827586206896552
440,673,0,6573,2483204,15.295454545454545
200,248,0,6574,2483452,12.4
230,403,0,6575,2483855,17.52173913043478
310,437,0,6576,2484292,14.096774193548388
160,203,0,6577,2484495,12.6875
230,322,0,6578,2484817,14.0
150,221,0,6579,2485038,14.733333333333333
220,381,0,6580,2485419,17.318181818181817
320,459,0,6581,2485878,14.34375
190,284,0,6582,2486162,14.947368421052632
500,711,0,6583,2486873,14.22
180,293,0,6584,2487166,16.27777777777778
160,207,0,6585,2487373,12.9375
330,638,0,6586,2488011,19.333333333333332
250,345,0,6587,2488356,13.8
490,914,0,6588,2489270,18.653061224489797
280,419,0,6589,2489689,14.964285714285714
370,527,0,6590,2490216,14.243243243243244
230,424,0,6591,2490640,18.434782608695652
380,603,0,6592,2491243,15.868421052631579
410,566,0,6593,2491809,13.804878048780488
200,309,0,6594,2492118,15.45
140,219,0,6595,2492337,15.642857142857142
360,476,0,6596,2492813,13.222222222222221
290,444,0,6597,2493257,15.310344827586206
350,537,0,6598,2493794,15.342857142857143
290,479,0,6599,2494273,16.517241379310345
130,177,0,6600,2494450,13.615384615384615
150,186,0,6601,2494636,12.4
270,412,0,6602,2495048,15.25925925925926
180,318,0,6603,2495366,17.666666666666668
190,283,0,6604,2495649,14.894736842105264
120,146,0,6605,2495795,12.166666666666666
210,307,0,6606,2496102,14.619047619047619
130,182,0,6607,2496284,14.0
250,349,0,6608,2496633,13.96
290,454,0,6609,2497087,15.655172413793103
140,199,0,6610,2497286,14.214285714285714
160,164,0,6611,2497450,10.25
140,181,0,6612,2497631,12.928571428571429
220,344,0,6613,2497975,15.636363636363637
440,897,0,6614,2498872,20.386363636363637
70,69,0,6615,2498941,9.857142857142858
390,587,0,6616,2499528,15.051282051282051
200,298,0,6617,2499826,14.9
220,350,0,6618,2500176,15.909090909090908
250,324,0,6619,2500500,12.96
280,385,0,6620,2500885,13.75
220,282,0,6621,2501167,12.818181818181818
90,122,0,6622,2501289,13.555555555555555
250,438,0,6623,2501727,17.52
360,593,0,6624,2502320,16.47222222222222
530,985,0,6625,2503305,18.58490566037736
180,214,0,6626,2503519,11.88888888888889
330,471,0,6627,2503990,14.272727272727273
350,530,0,6628,2504520,15.142857142857142
150,281,0,6629,2504801,18.733333333333334
180,252,0,6630,2505053,14.0
300,406,0,6631,2505459,13.533333333333333
290,397,0,6632,2505856,13.689655172413794
180,273,0,6633,2506129,15.166666666666666
260,363,0,6634,2506492,13.961538461538462
320,522,0,6635,2507014,16.3125
240,343,0,6636,2507357,14.291666666666666
100,153,0,6637,2507510,15.3
120,192,0,6638,2507702,16.0
270,407,0,6639,2508109,15.074074074074074
240,408,0,6640,2508517,17.0
300,422,0,6641,2508939,14.066666666666666
290,386,0,6642,2509325,13.310344827586206
170,210,0,6643,2509535,12.352941176470589
150,194,0,6644,2509729,12.933333333333334
160,184,0,6645,2509913,11.5
320,429,0,6646,2510342,13.40625
290,421,0,6647,2510763,14.517241379310345
300,433,0,6648,2511196,14.433333333333334
210,310,0,6649,2511506,14.761904761904763
250,386,0,6650,2511892,15.44
330,532,0,6651,2512424,16.12121212121212
160,225,0,6652,2512649,14.0625
260,385,0,6653,2513034,14.807692307692308
290,443,0,6654,2513477,15.275862068965518
340,604,0,6655,2514081,17.764705882352942
220,200,0,6656,2514281,9.090909090909092
120,182,0,6657,2514463,15.166666666666666
340,505,0,6658,2514968,14.852941176470589
200,339,0,6659,2515307,16.95
240,328,0,6660,2515635,13.666666666666666
150,252,0,6661,2515887,16.8
310,482,0,6662,2516369,15.548387096774194
190,241,0,6663,2516610,12.68421052631579
280,423,0,6664,2517033,15.107142857142858
300,459,0,6665,2517492,15.3
180,271,0,6666,2517763,15.055555555555555
220,326,0,6667,2518089,14.818181818181818
320,546,0,6668,2518635,17.0625
110,90,0,6669,2518725,8.181818181818182
290,463,0,6670,2519188,15.96551724137931
200,289,0,6671,2519477,14.45
400,644,0,6672,2520121,16.1
80,80,0,6673,2520201,10.0
170,287,0,6674,2520488,16.88235294117647
250,420,0,6675,2520908,16.8
200,372,0,6676,2521280,18.6
350,620,0,6677,2521900,17.714285714285715
280,506,0,6678,2522406,18.071428571428573
160,204,0,6679,2522610,12.75
240,349,0,6680,2522959,14.541666666666666
350,550,0,6681,2523509,15.714285714285714
180,282,0,6682,2523791,15.666666666666666
400,641,0,6683,2524432,16.025
190,281,0,6684,2524713,14.789473684210526
250,381,0,6685,2525094,15.24
240,393,0,6686,2525487,16.375
120,157,0,6687,2525644,13.083333333333334
320,486,0,6688,2526130,15.1875
230,357,0,6689,2526487,15.521739130434783
150,189,0,6690,2526676,12.6
280,440,0,6691,2527116,15.714285714285714
330,506,0,6692,2527622,15.333333333333334
180,275,0,6693,2527897,15.277777777777779
330,509,0,6694,2528406,15.424242424242424
310,423,0,6695,2528829,13.64516129032258
330,539,0,6696,2529368,16.333333333333332
110,163,0,6697,2529531,14.818181818181818
400,616,0,6698,2530147,15.4
380,560,0,6699,2530707,14.736842105263158
160,186,0,6700,2530893,11.625
240,314,0,6701,2531207,13.083333333333334
330,496,0,6702,2531703,15.030303030303031
290,350,0,6703,2532053,12.068965517241379
220,372,0,6704,2532425,16.90909090909091
290,416,0,6705,2532841,14.344827586206897
260,331,0,6706,2533172,12.73076923076923
100,134,0,6707,2533306,13.4
180,244,0,6708,2533550,13.555555555555555
250,391,0,6709,2533941,15.64
230,306,0,6710,2534247,13.304347826086957
320,496,0,6711,2534743,15.5
160,239,0,6712,2534982,14.9375
150,170,0,6713,2535152,11.333333333333334
360,563,0,6714,2535715,15.63888888888889
250,327,0,6715,2536042,13.08
290,468,0,6716,2536510,16.137931034482758
500,767,0,6717,2537277,15.34
380,660,0,6718,2537937,17.36842105263158
170,283,0,6719,2538220,16.647058823529413
230,391,0,6720,2538611,17.0
140,197,0,6721,2538808,14.071428571428571
180,242,0,6722,2539050,13.444444444444445
270,350,0,6723,2539400,12.962962962962964
280,446,0,6724,2539846,15.928571428571429
270,453,0,6725,2540299,16.77777777777778
290,401,0,6726,2540700,13.827586206896552
210,268,0,6727,2540968,12.761904761904763
330,502,0,6728,2541470,15.212121212121213
210,296,0,6729,2541766,14.095238095238095
190,268,0,6730,2542034,14.105263157894736
340,482,0,6731,2542516,14.176470588235293
310,429,0,6732,2542945,13.838709677419354
240,379,0,6733,2543324,15.791666666666666
120,182,0,6734,2543506,15.166666666666666
350,484,0,6735,2543990,13.82857142857143
180,281,0,6736,2544271,15.61111111111111
120,180,0,6737,2544451,15.0
180,296,0,6738,2544747,16.444444444444443
100,120,0,6739,2544867,12.0
300,462,0,6740,2545329,15.4
300,480,0,6741,2545809,16.0
250,336,0,6742,2546145,13.44
80,124,0,6743,2546269,15.5
140,197,0,6744,2546466,14.071428571428571
250,333,0,6745,2546799,13.32
300,532,0,6746,2547331,17.733333333333334
260,340,0,6747,2547671,13.076923076923077
400,584,0,6748,2548255,14.6
100,118,0,6749,2548373,11.8
360,658,0,6750,2549031,18.27777777777778
330,458,0,6751,2549489,13.878787878787879
320,476,0,6752,2549965,14.875
230,358,0,6753,2550323,15.565217391304348
200,296,0,6754,2550619,14.8
380,652,0,6755,2551271,17.157894736842106
380,552,0,6756,2551823,14.526315789473685
330,507,0,6757,2552330,15.363636363636363
160,202,0,6758,2552532,12.625
260,369,0,6759,2552901,14.192307692307692
220,318,0,6760,2553219,14.454545454545455
180,221,0,6761,2553440,12.277777777777779
300,432,0,6762,2553872,14.4
120,147,0,6763,2554019,12.25
200,237,0,6764,2554256,11.85
140,183,0,6765,2554439,13.071428571428571
420,705,0,6766,2555144,16.785714285714285
190,274,0,6767,2555418,14.421052631578947
180,231,0,6768,2555649,12.833333333333334
150,216,0,6769,2555865,14.4
400,651,0,6770,2556516,16.275
170,225,0,6771,2556741,13.235294117647058
160,213,0,6772,2556954,13.3125
320,472,0,6773,2557426,14.75
130,189,0,6774,2557615,14.538461538461538
170,233,0,6775,2557848,13.705882352941176
160,263,0,6776,2558111,16.4375
270,403,0,6777,2558514,14.925925925925926
410,798,0,6778,2559312,19.463414634146343
160,174,0,6779,2559486,10.875
290,435,0,6780,2559921,15.0
130,166,0,6781,2560087,12.76923076923077
110,132,0,6782,2560219,12.0
120,149,0,6783,2560368,12.416666666666666
330,555,0,6784,2560923,16.818181818181817
200,224,0,6785,2561147,11.2
150,190,0,6786,2561337,12.666666666666666
160,196,0,6787,2561533,12.25
270,499,0,6788,2562032,18.48148148148148
190,250,0,6789,2562282,13.157894736842104
290,421,0,6790,2562703,14.517241379310345
370,500,0,6791,2563203,13.513513513513514
60,74,0,6792,2563277,12.333333333333334
280,480,0,6793,2563757,17.142857142857142
340,554,0,6794,2564311,16.294117647058822
220,293,0,6795,2564604,13.318181818181818
180,223,0,6796,2564827,12.38888888888889
350,571,0,6797,2565398,16.314285714285713
320,474,0,6798,2565872,14.8125
360,621,0,6799,2566493,17.25
150,224,0,6800,2566717,14.933333333333334
270,342,0,6801,2567059,12.666666666666666
260,340,0,6802,2567399,13.076923076923077
230,305,0,6803,2567704,13.26086956521739
220,375,0,6804,2568079,17.045454545454547
230,337,0,6805,2568416,14.652173913043478
260,385,0,6806,2568801,14.807692307692308
260,429,0,6807,2569230,16.5
220,328,0,6808,2569558,14.909090909090908
240,327,0,6809,2569885,13.625
320,541,0,6810,2570426,16.90625
370,579,0,6811,2571005,15.64864864864865
180,295,0,6812,2571300,16.38888888888889
250,333,0,6813,2571633,13.32
150,248,0,6814,2571881,16.533333333333335
190,255,0,6815,2572136,13.421052631578947
250,397,0,6816,2572533,15.88
230,339,0,6817,2572872,14.73913043478261
250,357,0,6818,2573229,14.28
510,929,0,6819,2574158,18.215686274509803
160,228,0,6820,2574386,14.25
220,296,0,6821,2574682,13.454545454545455
210,330,0,6822,2575012,15.714285714285714
150,237,0,6823,2575249,15.8
190,227,0,6824,2575476,11.947368421052632
160,206,0,6825,2575682,12.875
280,426,0,6826,2576108,15.214285714285714
150,226,0,6827,2576334,15.066666666666666
290,505,0,6828,2576839,17.413793103448278
220,313,0,6829,2577152,14.227272727272727
430,637,0,6830,2577789,14.813953488372093
130,199,0,6831,2577988,15.307692307692308
330,561,0,6832,2578549,17.0
350,516,0,6833,2579065,14.742857142857142
110,154,0,6834,2579219,14.0
300,434,0,6835,2579653,14.466666666666667
300,415,0,6836,2580068,13.833333333333334
350,498,0,6837,2580566,14.228571428571428
240,314,0,6838,2580880,13.083333333333334
280,427,0,6839,2581307,15.25
280,409,0,6840,2581716,14.607142857142858
220,399,0,6841,2582115,18.136363636363637
220,358,0,6842,2582473,16.272727272727273
190,291,0,6843,2582764,15.31578947368421
230,361,0,6844,2583125,15.695652173913043
150,205,0,6845,2583330,13.666666666666666
300,487,0,6846,2583817,16.233333333333334
260,351,0,6847,2584168,13.5
230,317,0,6848,2584485,13.782608695652174
390,555,0,6849,2585040,14.23076923076923
290,516,0,6850,2585556,17.79310344827586
110,114,0,6851,2585670,10.363636363636363
260,371,0,6852,2586041,14.26923076923077
180,276,0,6853,2586317,15.333333333333334
180,241,0,6854,2586558,13.38888888888889
100,125,0,6855,2586683,12.5
340,440,0,6856,2587123,12.941176470588236
200,307,0,6857,2587430,15.35
230,358,0,6858,2587788,15.565217391304348
290,392,0,6859,2588180,13.517241379310345
170,281,0,6860,2588461,16.529411764705884
100,154,0,6861,2588615,15.4
140,232,0,6862,2588847,16.571428571428573
370,501,0,6863,2589348,13.54054054054054
210,275,0,6864,2589623,13.095238095238095
190,269,0,6865,2589892,14.157894736842104
380,562,0,6866,2590454,14.789473684210526
440,741,0,6867,2591195,16.84090909090909
170,280,0,6868,2591475,16.470588235294116
290,411,0,6869,2591886,14.172413793103448
330,491,0,6870,2592377,14.878787878787879
190,285,0,6871,2592662,15.0
130,177,0,6872,2592839,13.615384615384615
280,301,0,6873,2593140,10.75
330,576,0,6874,2593716,17.454545454545453
140,232,0,6875,2593948,16.571428571428573
300,493,0,6876,2594441,16.433333333333334
270,405,0,6877,2594846,15.0
290,396,0,6878,2595242,13.655172413793103
320,437,0,6879,2595679,13.65625
210,300,0,6880,2595979,14.285714285714286
180,244,0,6881,2596223,13.555555555555555
360,457,0,6882,2596680,12.694444444444445
220,394,0,6883,2597074,17.90909090909091
80,73,0,6884,2597147,9.125
330,499,0,6885,2597646,15.121212121212121
150,204,0,6886,2597850,13.6
290,429,0,6887,2598279,14.793103448275861
220,289,0,6888,2598568,13.136363636363637
250,362,0,6889,2598930,14.48
190,248,0,6890,2599178,13.052631578947368
310,558,0,6891,2599736,18.0
320,495,0,6892,2600231,15.46875
130,200,0,6893,2600431,15.384615384615385
340,496,0,6894,2600927,14.588235294117647
250,373,0,6895,2601300,14.92
510,889,0,6896,2602189,17.431372549019606
660,1194,0,6897,2603383,18.09090909090909
230,363,0,6898,2603746,15.782608695652174
390,641,0,6899,2604387,16.435897435897434
110,192,0,6900,2604579,17.454545454545453
190,285,0,6901,2604864,15.0
390,645,0,6902,2605509,16.53846153846154
250,433,0,6903,2605942,17.32
360,520,0,6904,2606462,14.444444444444445
120,154,0,6905,2606616,12.833333333333334
300,404,0,6906,2607020,13.466666666666667
230,391,0,6907,2607411,17.0
270,384,0,6908,2607795,14.222222222222221
420,587,0,6909,2608382,13.976190476190476
90,101,0,6910,2608483,11.222222222222221
300,402,0,6911,2608885,13.4
220,328,0,6912,2609213,14.909090909090908
140,219,0,6913,2609432,15.642857142857142
360,580,0,6914,2610012,16.11111111111111
360,572,0,6915,2610584,15.88888888888889
80,82,0,6916,2610666,10.25
300,463,0,6917,2611129,15.433333333333334
160,243,0,6918,2611372,15.1875
50,76,0,6919,2611448,15.2
350,514,0,6920,2611962,14.685714285714285
250,383,0,6921,2612345,15.32
290,401,0,6922,2612746,13.827586206896552
190,285,0,6923,2613031,15.0
180,300,0,6924,2613331,16.666666666666668
210,319,0,6925,2613650,15.19047619047619
190,303,0,6926,2613953,15.947368421052632
180,264,0,6927,2614217,14.666666666666666
270,407,0,6928,2614624,15.074074074074074
290,420,0,6929,2615044,14.482758620689655
340,572,0,6930,2615616,16.823529411764707
190,260,0,6931,2615876,13.68421052631579
50,50,0,6932,2615926,10.0
370,617,0,6933,2616543,16.675675675675677
400,710,0,6934,2617253,17.75
210,392,0,6935,2617645,18.666666666666668
450,794,0,6936,2618439,17.644444444444446
320,446,0,6937,2618885,13.9375
220,283,0,6938,2619168,12.863636363636363
220,328,0,6939,2619496,14.909090909090908
130,147,0,6940,2619643,11.307692307692308
550,1035,0,6941,2620678,18.818181818181817
300,453,0,6942,2621131,15.1
290,415,0,6943,2621546,14.310344827586206
120,154,0,6944,2621700,12.833333333333334
300,466,0,6945,2622166,15.533333333333333
160,181,0,6946,2622347,11.3125
320,565,0,6947,2622912,17.65625
260,419,0,6948,2623331,16.115384615384617
350,529,0,6949,2623860,15.114285714285714
230,280,0,6950,2624140,12.173913043478262
200,274,0,6951,2624414,13.7
170,197,0,6952,2624611,11.588235294117647
210,304,0,6953,2624915,14.476190476190476
200,313,0,6954,2625228,15.65
320,504,0,6955,2625732,15.75
220,317,0,6956,2626049,14.409090909090908
340,532,0,6957,2626581,15.647058823529411
100,161,0,6958,2626742,16.1
140,196,0,6959,2626938,14.0
290,462,0,6960,2627400,15.931034482758621
190,271,0,6961,2627671,14.263157894736842
400,601,0,6962,2628272,15.025
210,339,0,6963,2628611,16.142857142857142
280,382,0,6964,2628993,13.642857142857142
370,548,0,6965,2629541,14.81081081081081
240,354,0,6966,2629895,14.75
330,508,0,6967,2630403,15.393939393939394
220,243,0,6968,2630646,11.045454545454545
280,391,0,6969,2631037,13.964285714285714
160,210,0,6970,2631247,13.125
300,414,0,6971,2631661,13.8
80,61,0,6972,2631722,7.625
200,267,0,6973,2631989,13.35
220,327,0,6974,2632316,14.863636363636363
100,140,0,6975,2632456,14.0
180,254,0,6976,2632710,14.11111111111111
250,339,0,6977,2633049,13.56
140,154,0,6978,2633203,11.0
260,442,0,6979,2633645,17.0
120,201,0,6980,2633846,16.75
370,678,0,6981,2634524,18.324324324324323
230,326,0,6982,2634850,14.173913043478262
240,364,0,6983,2635214,15.166666666666666
270,456,0,6984,2635670,16.88888888888889
280,447,0,6985,2636117,15.964285714285714
180,206,0,6986,2636323,11.444444444444445
190,234,0,6987,2636557,12.31578947368421
80,117,0,6988,2636674,14.625
280,408,0,6989,2637082,14.571428571428571
270,381,0,6990,2637463,14.11111111111111
190,274,0,6991,2637737,14.421052631578947
260,463,0,6992,2638200,17.807692307692307
260,476,0,6993,2638676,18.307692307692307
170,216,0,6994,2638892,12.705882352941176
370,535,0,6995,2639427,14.45945945945946
240,360,0,6996,2639787,15.0
220,297,0,6997,2640084,13.5
380,508,0,6998,2640592,13.368421052631579
200,308,0,6999,2640900,15.4
290,476,0,7000,2641376,16.413793103448278
300,477,0,7001,2641853,15.9
200,264,0,7002,2642117,13.2
210,314,0,7003,2642431,14.952380952380953
380,630,0,7004,2643061,16.57894736842105
450,740,0,7005,2643801,16.444444444444443
240,311,0,7006,2644112,12.958333333333334
340,472,0,7007,2644584,13.882352941176471
310,503,0,7008,2645087,16.225806451612904
440,801,0,7009,2645888,18.204545454545453
270,451,0,7010,2646339,16.703703703703702
200,200,0,7011,2646539,10.0
460,706,0,7012,2647245,15.347826086956522
280,521,0,7013,2647766,18.607142857142858
320,544,0,7014,2648310,17.0
80,89,0,7015,2648399,11.125
200,365,0,7016,2648764,18.25
240,355,0,7017,2649119,14.791666666666666
130,177,0,7018,2649296,13.615384615384615
350,500,0,7019,2649796,14.285714285714286
220,301,0,7020,2650097,13.681818181818182
250,432,0,7021,2650529,17.28
310,402,0,7022,2650931,12.96774193548387
600,1073,0,7023,2652004,17.883333333333333
250,431,0,7024,2652435,17.24
130,170,0,7025,2652605,13.076923076923077
170,240,0,7026,2652845,14.117647058823529
210,270,0,7027,2653115,12.857142857142858
110,128,0,7028,2653243,11.636363636363637
240,356,0,7029,2653599,14.833333333333334
180,253,0,7030,2653852,14.055555555555555
440,728,0,7031,2654580,16.545454545454547
360,541,0,7032,2655121,15.027777777777779
260,373,0,7033,2655494,14.346153846153847
370,549,0,7034,2656043,14.837837837837839
240,366,0,7035,2656409,15.25
340,606,0,7036,2657015,17.823529411764707
230,274,0,7037,2657289,11.91304347826087
290,461,0,7038,2657750,15.89655172413793
290,434,0,7039,2658184,14.96551724137931
350,548,0,7040,2658732,15.657142857142857
120,141,0,7041,2658873,11.75
330,567,0,7042,2659440,17.181818181818183
230,319,0,7043,2659759,13.869565217391305
230,313,0,7044,2660072,13.608695652173912
110,128,0,7045,2660200,11.636363636363637
150,211,0,7046,2660411,14.066666666666666
310,559,0,7047,2660970,18.032258064516128
210,236,0,7048,2661206,11.238095238095237
120,134,0,7049,2661340,11.166666666666666
260,381,0,7050,2661721,14.653846153846153
390,685,0,7051,2662406,17.564102564102566
310,443,0,7052,2662849,14.290322580645162
340,536,0,7053,2663385,15.764705882352942
160,188,0,7054,2663573,11.75
320,483,0,7055,2664056,15.09375
340,560,0,7056,2664616,16.470588235294116
170,251,0,7057,2664867,14.764705882352942
350,474,0,7058,2665341,13.542857142857143
280,440,0,7059,2665781,15.714285714285714
300,463,0,7060,2666244,15.433333333333334
130,157,0,7061,2666401,12.076923076923077
230,354,0,7062,2666755,15.391304347826088
280,417,0,7063,2667172,14.892857142857142
260,355,0,7064,2667527,13.653846153846153
320,441,0,7065,2667968,13.78125
180,264,0,7066,2668232,14.666666666666666
150,171,0,7067,2668403,11.4
390,602,0,7068,2669005,15.435897435897436
300,485,0,7069,2669490,16.166666666666668
180,244,0,7070,2669734,13.555555555555555
210,272,0,7071,2670006,12.952380952380953
160,232,0,7072,2670238,14.5
290,405,0,7073,2670643,13.96551724137931
290,472,0,7074,2671115,16.275862068965516
60,66,0,7075,2671181,11.0
350,524,0,7076,2671705,14.971428571428572
320,495,0,7077,2672200,15.46875
230,347,0,7078,2672547,15.08695652173913
340,443,0,7079,2672990,13.029411764705882
100,143,0,7080,2673133,14.3
160,228,0,7081,2673361,14.25
170,260,0,7082,2673621,15.294117647058824
340,530,0,7083,2674151,15.588235294117647
300,446,0,7084,2674597,14.866666666666667
280,417,0,7085,2675014,14.892857142857142
260,378,0,7086,2675392,14.538461538461538
260,413,0,7087,2675805,15.884615384615385
220,292,0,7088,2676097,13.272727272727273
370,647,0,7089,2676744,17.486486486486488
360,579,0,7090,2677323,16.083333333333332
190,220,0,7091,2677543,11.578947368421053
220,282,0,7092,2677825,12.818181818181818
360,561,0,7093,2678386,15.583333333333334
210,265,0,7094,2678651,12.619047619047619
480,703,0,7095,2679354,14.645833333333334
400,596,0,7096,2679950,14.9
210,353,0,7097,2680303,16.80952380952381
270,380,0,7098,2680683,14.074074074074074
200,293,0,7099,2680976,14.65
300,488,0,7100,2681464,16.266666666666666
130,159,0,7101,2681623,12.23076923076923
220,294,0,7102,2681917,13.363636363636363
280,421,0,7103,2682338,15.035714285714286
250,375,0,7104,2682713,15.0
200,295,0,7105,2683008,14.75
160,245,0,7106,2683253,15.3125
250,362,0,7107,2683615,14.48
220,313,0,7108,2683928,14.227272727272727
170,238,0,7109,2684166,14.0
80,142,0,7110,2684308,17.75
210,263,0,7111,2684571,12.523809523809524
260,368,0,7112,2684939,14.153846153846153
220,315,0,7113,2685254,14.318181818181818
310,407,0,7114,2685661,13.129032258064516
540,716,0,7115,2686377,13.25925925925926
300,426,0,7116,2686803,14.2
200,299,0,7117,2687102,14.95
280,417,0,7118,2687519,14.892857142857142
440,621,0,7119,2688140,14.113636363636363
470,758,0,7120,2688898,16.127659574468087
190,213,0,7121,2689111,11.210526315789474
240,355,0,7122,2689466,14.791666666666666
260,341,0,7123,2689807,13.115384615384615
270,481,0,7124,2690288,17.814814814814813
310,396,0,7125,2690684,12.774193548387096
410,659,0,7126,2691343,16.073170731707318
270,409,0,7127,2691752,15.148148148148149
300,434,0,7128,2692186,14.466666666666667
270,373,0,7129,2692559,13.814814814814815
270,408,0,7130,2692967,15.11111111111111
300,480,0,7131,2693447,16.0
490,844,0,7132,2694291,17.224489795918366
140,188,0,7133,2694479,13.428571428571429
220,304,0,7134,2694783,13.818181818181818
160,231,0,7135,2695014,14.4375
200,295,0,7136,2695309,14.75
270,352,0,7137,2695661,13.037037037037036
220,306,0,7138,2695967,13.909090909090908
130,168,0,7139,2696135,12.923076923076923
210,324,0,7140,2696459,15.428571428571429
270,395,0,7141,2696854,14.62962962962963
270,340,0,7142,2697194,12.592592592592593
240,405,0,7143,2697599,16.875
420,694,0,7144,2698293,16.523809523809526
410,706,0,7145,2698999,17.21951219512195
150,237,0,7146,2699236,15.8
160,242,0,7147,2699478,15.125
230,360,0,7148,2699838,15.652173913043478
360,650,0,7149,2700488,18.055555555555557
460,687,0,7150,2701175,14.934782608695652
260,384,0,7151,2701559,14.76923076923077
330,463,0,7152,2702022,14.030303030303031
390,612,0,7153,2702634,15.692307692307692
390,724,0,7154,2703358,18.564102564102566
180,187,0,7155,2703545,10.38888888888889
300,420,0,7156,2703965,14.0
290,416,0,7157,2704381,14.344827586206897
490,760,0,7158,2705141,15.510204081632653
390,715,0,7159,2705856,18.333333333333332
300,476,0,7160,2706332,15.866666666666667
370,552,0,7161,2706884,14.91891891891892
210,312,0,7162,2707196,14.857142857142858
220,375,0,7163,2707571,17.045454545454547
170,305,0,7164,2707876,17.941176470588236
200,326,0,7165,2708202,16.3
250,381,0,7166,2708583,15.24
400,657,0,7167,2709240,16.425
160,187,0,7168,2709427,11.6875
200,263,0,7169,2709690,13.15
340,560,0,7170,2710250,16.470588235294116
160,276,0,7171,2710526,17.25
260,317,0,7172,2710843,12.192307692307692
220,300,0,7173,2711143,13.636363636363637
240,354,0,7174,2711497,14.75
90,131,0,7175,2711628,14.555555555555555
180,224,0,7176,2711852,12.444444444444445
320,511,0,7177,2712363,15.96875
320,514,0,7178,2712877,16.0625
240,370,0,7179,2713247,15.416666666666666
340,440,0,7180,2713687,12.941176470588236
200,264,0,7181,2713951,13.2
290,472,0,7182,2714423,16.275862068965516
80,99,0,7183,2714522,12.375
240,353,0,7184,2714875,14.708333333333334
270,331,0,7185,2715206,12.25925925925926
250,375,0,7186,2715581,15.0
110,134,0,7187,2715715,12.181818181818182
250,355,0,7188,2716070,14.2
120,188,0,7189,2716258,15.666666666666666
280,407,0,7190,2716665,14.535714285714286
320,521,0,7191,2717186,16.28125
320,460,0,7192,2717646,14.375
260,356,0,7193,2718002,13.692307692307692
330,455,0,7194,2718457,13.787878787878787
150,234,0,7195,2718691,15.6
290,394,0,7196,2719085,13.586206896551724
110,155,0,7197,2719240,14.090909090909092
270,423,0,7198,2719663,15.666666666666666
430,673,0,7199,2720336,15.651162790697674
280,429,0,7200,2720765,15.321428571428571
320,436,0,7201,2721201,13.625
280,352,0,7202,2721553,12.571428571428571
170,206,0,7203,2721759,12.117647058823529
320,511,0,7204,2722270,15.96875
350,621,0,7205,2722891,17.742857142857144
440,695,0,7206,2723586,15.795454545454545
170,175,0,7207,2723761,10.294117647058824
260,326,0,7208,2724087,12.538461538461538
170,211,0,7209,2724298,12.411764705882353
330,478,0,7210,2724776,14.484848484848484
230,285,0,7211,2725061,12.391304347826088
320,534,0,7212,2725595,16.6875
290,428,0,7213,2726023,14.758620689655173
230,298,0,7214,2726321,12.956521739130435
330,461,0,7215,2726782,13.969696969696969
410,697,0,7216,2727479,17.0
240,436,0,7217,2727915,18.166666666666668
270,434,0,7218,2728349,16.074074074074073
240,322,0,7219,2728671,13.416666666666666
390,519,0,7220,2729190,13.307692307692308
410,764,0,7221,2729954,18.634146341463413
70,97,0,7222,2730051,13.857142857142858
240,342,0,7223,2730393,14.25
190,283,0,7224,2730676,14.894736842105264
210,315,0,7225,2730991,15.0
290,476,0,7226,2731467,16.413793103448278
180,228,0,7227,2731695,12.666666666666666
120,186,0,7228,2731881,15.5
220,358,0,7229,2732239,16.272727272727273
140,191,0,7230,2732430,13.642857142857142
240,369,0,7231,2732799,15.375
220,261,0,7232,2733060,11.863636363636363
290,355,0,7233,2733415,12.241379310344827
330,511,0,7234,2733926,15.484848484848484
320,519,0,7235,2734445,16.21875
320,574,0,7236,2735019,17.9375
310,477,0,7237,2735496,15.387096774193548
260,315,0,7238,2735811,12.115384615384615
260,439,0,7239,2736250,16.884615384615383
140,195,0,7240,2736445,13.928571428571429
280,429,0,7241,2736874,15.321428571428571
160,246,0,7242,2737120,15.375
330,546,0,7243,2737666,16.545454545454547
310,412,0,7244,2738078,13.290322580645162
330,495,0,7245,2738573,15.0
320,552,0,7246,2739125,17.25
190,212,0,7247,2739337,11.157894736842104
130,168,0,7248,2739505,12.923076923076923
420,508,0,7249,2740013,12.095238095238095
160,273,0,7250,2740286,17.0625
270,414,0,7251,2740700,15.333333333333334
210,274,0,7252,2740974,13.047619047619047
370,604,0,7253,2741578,16.324324324324323
240,374,0,7254,2741952,15.583333333333334
220,276,0,7255,2742228,12.545454545454545
230,296,0,7256,2742524,12.869565217391305
190,254,0,7257,2742778,13.368421052631579
200,279,0,7258,2743057,13.95
350,528,0,7259,2743585,15.085714285714285
240,339,0,7260,2743924,14.125
340,462,0,7261,2744386,13.588235294117647
50,64,0,7262,2744450,12.8
180,270,0,7263,2744720,15.0
130,167,0,7264,2744887,12.846153846153847
110,151,0,7265,2745038,13.727272727272727
390,576,0,7266,2745614,14.76923076923077
290,400,0,7267,2746014,13.793103448275861
330,497,0,7268,2746511,15.06060606060606
180,210,0,7269,2746721,11.666666666666666
120,195,0,7270,2746916,16.25
270,424,0,7271,2747340,15.703703703703704
270,426,0,7272,2747766,15.777777777777779
170,255,0,7273,2748021,15.0
260,393,0,7274,2748414,15.115384615384615
160,219,0,7275,2748633,13.6875
100,145,0,7276,2748778,14.5
150,184,0,7277,2748962,12.266666666666667
300,477,0,7278,2749439,15.9
160,222,0,7279,2749661,13.875
200,310,0,7280,2749971,15.5
280,399,0,7281,2750370,14.25
310,477,0,7282,2750847,15.387096774193548
400,564,0,7283,2751411,14.1
130,234,0,7284,2751645,18.0
100,113,0,7285,2751758,11.3
230,418,0,7286,2752176,18.17391304347826
170,212,0,7287,2752388,12.470588235294118
290,596,0,7288,2752984,20.551724137931036
220,308,0,7289,2753292,14.0
210,314,0,7290,2753606,14.952380952380953
350,547,0,7291,2754153,15.628571428571428
200,252,0,7292,2754405,12.6
270,414,0,7293,2754819,15.333333333333334
310,458,0,7294,2755277,14.774193548387096
230,318,0,7295,2755595,13.826086956521738
260,357,0,7296,2755952,13.73076923076923
220,291,0,7297,2756243,13.227272727272727
190,329,0,7298,2756572,17.31578947368421
100,145,0,7299,2756717,14.5
250,383,0,7300,2757100,15.32
250,367,0,7301,2757467,14.68
210,349,0,7302,2757816,16.61904761904762
380,502,0,7303,2758318,13.210526315789474
370,572,0,7304,2758890,15.45945945945946
160,288,0,7305,2759178,18.0
220,327,0,7306,2759505,14.863636363636363
310,525,0,7307,2760030,16.93548387096774
160,233,0,7308,2760263,14.5625
180,253,0,7309,2760516,14.055555555555555
110,123,0,7310,2760639,11.181818181818182
190,238,0,7311,2760877,12.526315789473685
290,437,0,7312,2761314,15.068965517241379
280,380,0,7313,2761694,13.571428571428571
70,74,0,7314,2761768,10.571428571428571
160,231,0,7315,2761999,14.4375
310,587,0,7316,2762586,18.93548387096774
160,148,0,7317,2762734,9.25
260,340,0,7318,2763074,13.076923076923077
270,415,0,7319,2763489,15.37037037037037
230,330,0,7320,2763819,14.347826086956522
230,320,0,7321,2764139,13.91304347826087
270,425,0,7322,2764564,15.74074074074074
240,333,0,7323,2764897,13.875
330,500,0,7324,2765397,15.151515151515152
220,307,0,7325,2765704,13.954545454545455
130,199,0,7326,2765903,15.307692307692308
170,268,0,7327,2766171,15.764705882352942
380,595,0,7328,2766766,15.657894736842104
150,195,0,7329,2766961,13.0
350,595,0,7330,2767556,17.0
330,431,0,7331,2767987,13.06060606060606
240,321,0,7332,2768308,13.375
90,111,0,7333,2768419,12.333333333333334
70,113,0,7334,2768532,16.142857142857142
320,500,0,7335,2769032,15.625
120,166,0,7336,2769198,13.833333333333334
160,178,0,7337,2769376,11.125
430,669,0,7338,2770045,15.55813953488372
330,569,0,7339,2770614,17.242424242424242
240,361,0,7340,2770975,15.041666666666666
390,666,0,7341,2771641,17.076923076923077
100,105,0,7342,2771746,10.5
210,311,0,7343,2772057,14.80952380952381
350,585,0,7344,2772642,16.714285714285715
250,356,0,7345,2772998,14.24
350,522,0,7346,2773520,14.914285714285715
170,226,0,7347,2773746,13.294117647058824
200,300,0,7348,2774046,15.0
240,374,0,7349,2774420,15.583333333333334
160,238,0,7350,2774658,14.875
310,408,0,7351,2775066,13.161290322580646
370,537,0,7352,2775603,14.513513513513514
340,423,0,7353,2776026,12.441176470588236
280,360,0,7354,2776386,12.857142857142858
200,298,0,7355,2776684,14.9
180,235,0,7356,2776919,13.055555555555555
300,447,0,7357,2777366,14.9
110,150,0,7358,2777516,13.636363636363637
400,674,0,7359,2778190,16.85
240,375,0,7360,2778565,15.625
270,413,0,7361,2778978,15.296296296296296
190,261,0,7362,2779239,13.736842105263158
330,477,0,7363,2779716,14.454545454545455
130,140,0,7364,2779856,10.76923076923077
160,224,0,7365,2780080,14.0
310,509,0,7366,2780589,16.419354838709676
220,332,0,7367,2780921,15.090909090909092
420,697,0,7368,2781618,16.595238095238095
330,590,0,7369,2782208,17.87878787878788
270,405,0,7370,2782613,15.0
290,449,0,7371,2783062,15.482758620689655
80,136,0,7372,2783198,17.0
280,463,0,7373,2783661,16.535714285714285
240,290,0,7374,2783951,12.083333333333334
270,454,0,7375,2784405,16.814814814814813
220,332,0,7376,2784737,15.090909090909092
270,412,0,7377,2785149,15.25925925925926
220,321,0,7378,2785470,14.590909090909092
170,241,0,7379,2785711,14.176470588235293
420,638,0,7380,2786349,15.19047619047619
220,340,0,7381,2786689,15.454545454545455
320,413,0,7382,2787102,12.90625
90,118,0,7383,2787220,13.11111111111111
340,519,0,7384,2787739,15.264705882352942
200,293,0,7385,2788032,14.65
210,296,0,7386,2788328,14.095238095238095
220,379,0,7387,2788707,17.227272727272727
80,118,0,7388,2788825,14.75
220,335,0,7389,2789160,15.227272727272727
150,199,0,7390,2789359,13.266666666666667
210,315,0,7391,2789674,15.0
410,660,0,7392,2790334,16.097560975609756
270,325,0,7393,2790659,12.037037037037036
350,527,0,7394,2791186,15.057142857142857
260,371,0,7395,2791557,14.26923076923077
250,385,0,7396,2791942,15.4
300,421,0,7397,2792363,14.033333333333333
240,312,0,7398,2792675,13.0
290,470,0,7399,2793145,16.20689655172414
140,184,0,7400,2793329,13.142857142857142
300,471,0,7401,2793800,15.7
200,279,0,7402,2794079,13.95
320,415,0,7403,2794494,12.96875
280,438,0,7404,2794932,15.642857142857142
100,131,0,7405,2795063,13.1
320,478,0,7406,2795541,14.9375
390,578,0,7407,2796119,14.820512820512821
310,418,0,7408,2796537,13.483870967741936
460,755,0,7409,2797292,16.41304347826087
570,815,0,7410,2798107,14.298245614035087
270,345,0,7411,2798452,12.777777777777779
450,764,0,7412,2799216,16.977777777777778
270,368,0,7413,2799584,13.62962962962963
130,219,0,7414,2799803,16.846153846153847
140,206,0,7415,2800009,14.714285714285714
200,298,0,7416,2800307,14.9
230,342,0,7417,2800649,14.869565217391305
320,458,0,7418,2801107,14.3125
340,523,0,7419,2801630,15.382352941176471
210,344,0,7420,2801974,16.38095238095238
420,671,0,7421,2802645,15.976190476190476
280,389,0,7422,2803034,13.892857142857142
270,281,0,7423,2803315,10.407407407407407
350,559,0,7424,2803874,15.971428571428572
270,377,0,7425,2804251,13.962962962962964
220,327,0,7426,2804578,14.863636363636363
470,771,0,7427,2805349,16.404255319148938
170,269,0,7428,2805618,15.823529411764707
340,527,0,7429,2806145,15.5
290,449,0,7430,2806594,15.482758620689655
200,241,0,7431,2806835,12.05
220,284,0,7432,2807119,12.909090909090908
90,108,0,7433,2807227,12.0
230,304,0,7434,2807531,13.217391304347826
180,262,0,7435,2807793,14.555555555555555
270,393,0,7436,2808186,14.555555555555555
350,564,0,7437,2808750,16.114285714285714
120,157,0,7438,2808907,13.083333333333334
340,508,0,7439,2809415,14.941176470588236
270,445,0,7440,2809860,16.48148148148148
290,430,0,7441,2810290,14.827586206896552
340,537,0,7442,2810827,15.794117647058824
150,230,0,7443,2811057,15.333333333333334
290,382,0,7444,2811439,13.172413793103448
240,322,0,7445,2811761,13.416666666666666
70,100,0,7446,2811861,14.285714285714286
100,227,0,7447,2812088,22.7
470,774,0,7448,2812862,16.46808510638298
240,378,0,7449,2813240,15.75
200,248,0,7450,2813488,12.4
260,404,0,7451,2813892,15.538461538461538
420,589,0,7452,2814481,14.023809523809524
300,435,0,7453,2814916,14.5
180,237,0,7454,2815153,13.166666666666666
310,484,0,7455,2815637,15.612903225806452
260,427,0,7456,2816064,16.423076923076923
250,376,0,7457,2816440,15.04
180,256,0,7458,2816696,14.222222222222221
370,546,0,7459,2817242,14.756756756756756
210,249,0,7460,2817491,11.857142857142858
250,321,0,7461,2817812,12.84
370,555,0,7462,2818367,15.0
100,171,0,7463,2818538,17.1
200,304,0,7464,2818842,15.2
400,605,0,7465,2819447,15.125
150,197,0,7466,2819644,13.133333333333333
160,225,0,7467,2819869,14.0625
220,352,0,7468,2820221,16.0
310,515,0,7469,2820736,16.612903225806452
320,513,0,7470,2821249,16.03125
370,467,0,7471,2821716,12.621621621621621
370,671,0,7472,2822387,18.135135135135137
150,218,0,7473,2822605,14.533333333333333
210,306,0,7474,2822911,14.571428571428571
300,487,0,7475,2823398,16.233333333333334
200,297,0,7476,2823695,14.85
510,814,0,7477,2824509,15.96078431372549
290,373,0,7478,2824882,12.862068965517242
260,342,0,7479,2825224,13.153846153846153
230,268,0,7480,2825492,11.652173913043478
140,163,0,7481,2825655,11.642857142857142
280,447,0,7482,2826102,15.964285714285714
310,506,0,7483,2826608,16.322580645161292
330,617,0,7484,2827225,18.696969696969695
220,333,0,7485,2827558,15.136363636363637
450,579,0,7486,2828137,12.866666666666667
390,631,0,7487,2828768,16.17948717948718
100,181,0,7488,2828949,18.1
210,335,0,7489,2829284,15.952380952380953
250,340,0,7490,2829624,13.6
160,244,0,7491,2829868,15.25
220,267,0,7492,2830135,12.136363636363637
440,677,0,7493,2830812,15.386363636363637
370,624,0,7494,2831436,16.864864864864863
340,545,0,7495,2831981,16.029411764705884
330,572,0,7496,2832553,17.333333333333332
200,300,0,7497,2832853,15.0
150,217,0,7498,2833070,14.466666666666667
140,223,0,7499,2833293,15.928571428571429
330,494,0,7500,2833787,14.969696969696969
310,451,0,7501,2834238,14.548387096774194
200,313,0,7502,2834551,15.65
230,315,0,7503,2834866,13.695652173913043
240,402,0,7504,2835268,16.75
80,130,0,7505,2835398,16.25
170,239,0,7506,2835637,14.058823529411764
120,192,0,7507,2835829,16.0
170,299,0,7508,2836128,17.58823529411765
140,206,0,7509,2836334,14.714285714285714
180,257,0,7510,2836591,14.277777777777779
270,398,0,7511,2836989,14.74074074074074
240,380,0,7512,2837369,15.833333333333334
190,308,0,7513,2837677,16.210526315789473
280,382,0,7514,2838059,13.642857142857142
280,411,0,7515,2838470,14.678571428571429
380,592,0,7516,2839062,15.578947368421053
260,392,0,7517,2839454,15.076923076923077
130,136,0,7518,2839590,10.461538461538462
250,357,0,7519,2839947,14.28
240,334,0,7520,2840281,13.916666666666666
310,635,0,7521,2840916,20.483870967741936
200,299,0,7522,2841215,14.95
270,327,0,7523,2841542,12.11111111111111
160,238,0,7524,2841780,14.875
210,330,0,7525,2842110,15.714285714285714
140,230,0,7526,2842340,16.428571428571427
180,242,0,7527,2842582,13.444444444444445
390,577,0,7528,2843159,14.794871794871796
210,339,0,7529,2843498,16.142857142857142
150,170,0,7530,2843668,11.333333333333334
450,632,0,7531,2844300,14.044444444444444
330,447,0,7532,2844747,13.545454545454545
340,478,0,7533,2845225,14.058823529411764
560,1036,0,7534,2846261,18.5
210,337,0,7535,2846598,16.047619047619047
240,307,0,7536,2846905,12.791666666666666
140,194,0,7537,2847099,13.857142857142858
140,196,0,7538,2847295,14.0
130,195,0,7539,2847490,15.0
230,319,0,7540,2847809,13.869565217391305
260,407,0,7541,2848216,15.653846153846153
360,553,0,7542,2848769,15.36111111111111
340,543,0,7543,2849312,15.970588235294118
390,540,0,7544,2849852,13.846153846153847
280,420,0,7545,2850272,15.0
190,272,0,7546,2850544,14.31578947368421
210,258,0,7547,2850802,12.285714285714286
280,388,0,7548,2851190,13.857142857142858
230,314,0,7549,2851504,13.652173913043478
170,251,0,7550,2851755,14.764705882352942
230,319,0,7551,2852074,13.869565217391305
360,567,0,7552,2852641,15.75
260,385,0,7553,2853026,14.807692307692308
380,534,0,7554,2853560,14.052631578947368
320,566,0,7555,2854126,17.6875
260,329,0,7556,2854455,12.653846153846153
350,511,0,7557,2854966,14.6
60,55,0,7558,2855021,9.166666666666666
420,546,0,7559,2855567,13.0
290,446,0,7560,2856013,15.379310344827585
190,269,0,7561,2856282,14.157894736842104
370,633,0,7562,2856915,17.10810810810811
220,352,0,7563,2857267,16.0
280,458,0,7564,2857725,16.357142857142858
240,389,0,7565,2858114,16.208333333333332
200,270,0,7566,2858384,13.5
320,510,0,7567,2858894,15.9375
240,355,0,7568,2859249,14.791666666666666
350,587,0,7569,2859836,16.771428571428572
270,416,0,7570,2860252,15.407407407407407
180,324,0,7571,2860576,18.0
130,161,0,7572,2860737,12.384615384615385
390,654,0,7573,2861391,16.76923076923077
310,515,0,7574,2861906,16.612903225806452
400,576,0,7575,2862482,14.4
170,204,0,7576,2862686,12.0
220,277,0,7577,2862963,12.590909090909092
200,314,0,7578,2863277,15.7
70,73,0,7579,2863350,10.428571428571429
240,331,0,7580,2863681,13.791666666666666
130,176,0,7581,2863857,13.538461538461538
140,211,0,7582,2864068,15.071428571428571
130,192,0,7583,2864260,14.76923076923077
300,390,0,7584,2864650,13.0
280,412,0,7585,2865062,14.714285714285714
360,542,0,7586,2865604,15.055555555555555
250,329,0,7587,2865933,13.16
150,202,0,7588,2866135,13.466666666666667
350,460,0,7589,2866595,13.142857142857142
160,218,0,7590,2866813,13.625
230,293,0,7591,2867106,12.73913043478261
320,469,0,7592,2867575,14.65625
170,207,0,7593,2867782,12.176470588235293
330,511,0,7594,2868293,15.484848484848484
120,118,0,7595,2868411,9.833333333333334
290,395,0,7596,2868806,13.620689655172415
240,329,0,7597,2869135,13.708333333333334
260,387,0,7598,2869522,14.884615384615385
260,447,0,7599,2869969,17.192307692307693
310,545,0,7600,2870514,17.580645161290324
200,295,0,7601,2870809,14.75
460,737,0,7602,2871546,16.02173913043478
180,245,0,7603,2871791,13.61111111111111
310,461,0,7604,2872252,14.870967741935484
190,309,0,7605,2872561,16.263157894736842
80,110,0,7606,2872671,13.75
160,207,0,7607,2872878,12.9375
240,343,0,7608,2873221,14.291666666666666
410,648,0,7609,2873869,15.804878048780488
110,150,0,7610,2874019,13.636363636363637
260,371,0,7611,2874390,14.26923076923077
250,351,0,7612,2874741,14.04
190,322,0,7613,2875063,16.94736842105263
440,676,0,7614,2875739,15.363636363636363
170,246,0,7615,2875985,14.470588235294118
220,297,0,7616,2876282,13.5
220,358,0,7617,2876640,16.272727272727273
200,283,0,7618,2876923,14.15
300,444,0,7619,2877367,14.8
180,202,0,7620,2877569,11.222222222222221
250,414,0,7621,2877983,16.56
200,314,0,7622,2878297,15.7
160,191,0,7623,2878488,11.9375
350,442,0,7624,2878930,12.628571428571428
240,425,0,7625,2879355,17.708333333333332
80,128,0,7626,2879483,16.0
310,461,0,7627,2879944,14.870967741935484
430,649,0,7628,2880593,15.093023255813954
400,704,0,7629,2881297,17.6
310,478,0,7630,2881775,15.419354838709678
370,552,0,7631,2882327,14.91891891891892
400,642,0,7632,2882969,16.05
160,180,0,7633,2883149,11.25
350,579,0,7634,2883728,16.542857142857144
140,191,0,7635,2883919,13.642857142857142
360,521,0,7636,2884440,14.472222222222221
210,297,0,7637,2884737,14.142857142857142
330,559,0,7638,2885296,16.939393939393938
310,427,0,7639,2885723,13.774193548387096
280,411,0,7640,2886134,14.678571428571429
170,212,0,7641,2886346,12.470588235294118
310,436,0,7642,2886782,14.064516129032258
300,466,0,7643,2887248,15.533333333333333
350,519,0,7644,2887767,14.82857142857143
220,278,0,7645,2888045,12.636363636363637
280,384,0,7646,2888429,13.714285714285714
330,513,0,7647,2888942,15.545454545454545
270,328,0,7648,2889270,12.148148148148149
110,132,0,7649,2889402,12.0
90,97,0,7650,2889499,10.777777777777779
400,657,0,7651,2890156,16.425
380,608,0,7652,2890764,16.0
430,723,0,7653,2891487,16.813953488372093
220,287,0,7654,2891774,13.045454545454545
320,460,0,7655,2892234,14.375
220,283,0,7656,2892517,12.863636363636363
130,174,0,7657,2892691,13.384615384615385
360,591,0,7658,2893282,16.416666666666668
230,286,0,7659,2893568,12.434782608695652
230,306,0,7660,2893874,13.304347826086957
410,661,0,7661,2894535,16.121951219512194
410,626,0,7662,2895161,15.268292682926829
270,425,0,7663,2895586,15.74074074074074
240,295,0,7664,2895881,12.291666666666666
150,191,0,7665,2896072,12.733333333333333
180,275,0,7666,2896347,15.277777777777779
230,309,0,7667,2896656,13.434782608695652
420,638,0,7668,2897294,15.19047619047619
330,533,0,7669,2897827,16.151515151515152
260,389,0,7670,2898216,14.961538461538462
200,279,0,7671,2898495,13.95
230,351,0,7672,2898846,15.26086956521739
200,289,0,7673,2899135,14.45
160,227,0,7674,2899362,14.1875
170,255,0,7675,2899617,15.0
370,584,0,7676,2900201,15.783783783783784
120,187,0,7677,2900388,15.583333333333334
190,308,0,7678,2900696,16.210526315789473
290,435,0,7679,2901131,15.0
260,328,0,7680,2901459,12.615384615384615
270,412,0,7681,2901871,15.25925925925926
300,439,0,7682,2902310,14.633333333333333
280,466,0,7683,2902776,16.642857142857142
130,175,0,7684,2902951,13.461538461538462
160,241,0,7685,2903192,15.0625
130,227,0,7686,2903419,17.46153846153846
260,360,0,7687,2903779,13.846153846153847
340,640,0,7688,2904419,18.823529411764707
160,239,0,7689,2904658,14.9375
130,197,0,7690,2904855,15.153846153846153
260,416,0,7691,2905271,16.0
230,273,0,7692,2905544,11.869565217391305
310,539,0,7693,2906083,17.387096774193548
270,376,0,7694,2906459,13.925925925925926
160,246,0,7695,2906705,15.375
240,366,0,7696,2907071,15.25
190,234,0,7697,2907305,12.31578947368421
140,214,0,7698,2907519,15.285714285714286
410,672,0,7699,2908191,16.390243902439025
380,534,0,7700,2908725,14.052631578947368
430,793,0,7701,2909518,18.441860465116278
320,455,0,7702,2909973,14.21875
380,581,0,7703,2910554,15.289473684210526
240,425,0,7704,2910979,17.708333333333332
350,526,0,7705,2911505,15.028571428571428
250,397,0,7706,2911902,15.88
300,391,0,7707,2912293,13.033333333333333
390,545,0,7708,2912838,13.974358974358974
370,617,0,7709,2913455,16.675675675675677
180,256,0,7710,2913711,14.222222222222221
120,162,0,7711,2913873,13.5
300,425,0,7712,2914298,14.166666666666666
330,442,0,7713,2914740,13.393939393939394
310,366,0,7714,2915106,11.806451612903226
400,635,0,7715,2915741,15.875
80,111,0,7716,2915852,13.875
250,344,0,7717,2916196,13.76
210,308,0,7718,2916504,14.666666666666666
280,420,0,7719,2916924,15.0
430,629,0,7720,2917553,14.627906976744185
260,421,0,7721,2917974,16.192307692307693
400,566,0,7722,2918540,14.15
270,420,0,7723,2918960,15.555555555555555
210,338,0,7724,2919298,16.095238095238095
170,211,0,7725,2919509,12.411764705882353
160,239,0,7726,2919748,14.9375
420,621,0,7727,2920369,14.785714285714286
380,589,0,7728,2920958,15.5
210,358,0,7729,2921316,17.047619047619047
280,365,0,7730,2921681,13.035714285714286
170,321,0,7731,2922002,18.88235294117647
260,392,0,7732,2922394,15.076923076923077
260,356,0,7733,2922750,13.692307692307692
270,393,0,7734,2923143,14.555555555555555
290,460,0,7735,2923603,15.862068965517242
240,298,0,7736,2923901,12.416666666666666
130,182,0,7737,2924083,14.0
210,281,0,7738,2924364,13.380952380952381
100,101,0,7739,2924465,10.1
460,752,0,7740,2925217,16.347826086956523
210,317,0,7741,2925534,15.095238095238095
210,333,0,7742,2925867,15.857142857142858
310,445,0,7743,2926312,14.35483870967742
300,458,0,7744,2926770,15.266666666666667
320,525,0,7745,2927295,16.40625
280,426,0,7746,2927721,15.214285714285714
320,493,0,7747,2928214,15.40625
220,289,0,7748,2928503,13.136363636363637
300,399,0,7749,2928902,13.3
200,279,0,7750,2929181,13.95
210,274,0,7751,2929455,13.047619047619047
410,651,0,7752,2930106,15.878048780487806
420,684,0,7753,2930790,16.285714285714285
310,493,0,7754,2931283,15.903225806451612
190,354,0,7755,2931637,18.63157894736842
190,280,0,7756,2931917,14.736842105263158
370,622,0,7757,2932539,16.81081081081081
440,631,0,7758,2933170,14.340909090909092
120,175,0,7759,2933345,14.583333333333334
380,633,0,7760,2933978,16.657894736842106
130,143,0,7761,2934121,11.0
270,372,0,7762,2934493,13.777777777777779
290,472,0,7763,2934965,16.275862068965516
150,218,0,7764,2935183,14.533333333333333
140,174,0,7765,2935357,12.428571428571429
270,347,0,7766,2935704,12.851851851851851
120,165,0,7767,2935869,13.75
210,266,0,7768,2936135,12.666666666666666
80,105,0,7769,2936240,13.125
290,332,0,7770,2936572,11.448275862068966
270,418,0,7771,2936990,15.481481481481481
120,153,0,7772,2937143,12.75
160,218,0,7773,2937361,13.625
340,521,0,7774,2937882,15.323529411764707
240,366,0,7775,2938248,15.25
270,418,0,7776,2938666,15.481481481481481
420,633,0,7777,2939299,15.071428571428571
310,444,0,7778,2939743,14.32258064516129
110,155,0,7779,2939898,14.090909090909092
220,337,0,7780,2940235,15.318181818181818
340,511,0,7781,2940746,15.029411764705882
380,605,0,7782,2941351,15.921052631578947
260,489,0,7783,2941840,18.807692307692307
350,534,0,7784,2942374,15.257142857142858
220,251,0,7785,2942625,11.409090909090908
260,374,0,7786,2942999,14.384615384615385
290,366,0,7787,2943365,12.620689655172415
270,411,0,7788,2943776,15.222222222222221
530,1130,0,7789,2944906,21.32075471698113
170,207,0,7790,2945113,12.176470588235293
300,403,0,7791,2945516,13.433333333333334
250,304,0,7792,2945820,12.16
170,262,0,7793,2946082,15.411764705882353
370,588,0,7794,2946670,15.891891891891891
270,390,0,7795,2947060,14.444444444444445
280,401,0,7796,2947461,14.321428571428571
200,303,0,7797,2947764,15.15
320,486,0,7798,2948250,15.1875
100,116,0,7799,2948366,11.6
200,291,0,7800,2948657,14.55
520,876,0,7801,2949533,16.846153846153847
180,340,0,7802,2949873,18.88888888888889
170,223,0,7803,2950096,13.117647058823529
130,229,0,7804,2950325,17.615384615384617
120,168,0,7805,2950493,14.0
160,264,0,7806,2950757,16.5
110,147,0,7807,2950904,13.363636363636363
230,336,0,7808,2951240,14.608695652173912
270,436,0,7809,2951676,16.14814814814815
280,445,0,7810,2952121,15.892857142857142
280,372,0,7811,2952493,13.285714285714286
120,181,0,7812,2952674,15.083333333333334
230,384,0,7813,2953058,16.695652173913043
160,205,0,7814,2953263,12.8125
190,275,0,7815,2953538,14.473684210526315
260,367,0,7816,2953905,14.115384615384615
220,323,0,7817,2954228,14.681818181818182
330,483,0,7818,2954711,14.636363636363637
150,252,0,7819,2954963,16.8
140,163,0,7820,2955126,11.642857142857142
150,200,0,7821,2955326,13.333333333333334
270,389,0,7822,2955715,14.407407407407407
140,166,0,7823,2955881,11.857142857142858
110,162,0,7824,2956043,14.727272727272727
250,325,0,7825,2956368,13.0
320,415,0,7826,2956783,12.96875
120,167,0,7827,2956950,13.916666666666666
300,497,0,7828,2957447,16.566666666666666
370,449,0,7829,2957896,12.135135135135135
200,226,0,7830,2958122,11.3
260,367,0,7831,2958489,14.115384615384615
140,205,0,7832,2958694,14.642857142857142
220,314,0,7833,2959008,14.272727272727273
200,273,0,7834,2959281,13.65
260,389,0,7835,2959670,14.961538461538462
260,365,0,7836,2960035,14.038461538461538
200,269,0,7837,2960304,13.45
80,139,0,7838,2960443,17.375
300,495,0,7839,2960938,16.5
200,308,0,7840,2961246,15.4
150,215,0,7841,2961461,14.333333333333334
170,258,0,7842,2961719,15.176470588235293
330,533,0,7843,2962252,16.151515151515152
480,827,0,7844,2963079,17.229166666666668
200,337,0,7845,2963416,16.85
210,302,0,7846,2963718,14.380952380952381
370,644,0,7847,2964362,17.405405405405407
260,384,0,7848,2964746,14.76923076923077
260,391,0,7849,2965137,15.038461538461538
290,418,0,7850,2965555,14.413793103448276
380,615,0,7851,2966170,16.18421052631579
180,269,0,7852,2966439,14.944444444444445
210,265,0,7853,2966704,12.619047619047619
160,235,0,7854,2966939,14.6875
360,559,0,7855,2967498,15.527777777777779
270,513,0,7856,2968011,19.0
150,222,0,7857,2968233,14.8
140,180,0,7858,2968413,12.857142857142858
260,420,0,7859,2968833,16.153846153846153
150,181,0,7860,2969014,12.066666666666666
270,409,0,7861,2969423,15.148148148148149
240,320,0,7862,2969743,13.333333333333334
100,147,0,7863,2969890,14.7
230,399,0,7864,2970289,17.347826086956523
190,262,0,7865,2970551,13.789473684210526
170,256,0,7866,2970807,15.058823529411764
230,312,0,7867,2971119,13.565217391304348
170,212,0,7868,2971331,12.470588235294118
290,431,0,7869,2971762,14.862068965517242
260,452,0,7870,2972214,17.384615384615383
190,236,0,7871,2972450,12.421052631578947
220,290,0,7872,2972740,13.181818181818182
170,244,0,7873,2972984,14.352941176470589
290,421,0,7874,2973405,14.517241379310345
350,478,0,7875,2973883,13.657142857142857
280,407,0,7876,2974290,14.535714285714286
310,436,0,7877,2974726,14.064516129032258
400,671,0,7878,2975397,16.775
240,337,0,7879,2975734,14.041666666666666
310,473,0,7880,2976207,15.258064516129032
210,297,0,7881,2976504,14.142857142857142
300,440,0,7882,2976944,14.666666666666666
150,219,0,7883,2977163,14.6
210,322,0,7884,2977485,15.333333333333334
250,405,0,7885,2977890,16.2
250,372,0,7886,2978262,14.88
60,75,0,7887,2978337,12.5
290,429,0,7888,2978766,14.793103448275861
260,296,0,7889,2979062,11.384615384615385
240,321,0,7890,2979383,13.375
310,455,0,7891,2979838,14.67741935483871
270,392,0,7892,2980230,14.518518518518519
210,328,0,7893,2980558,15.619047619047619
270,431,0,7894,2980989,15.962962962962964
310,540,0,7895,2981529,17.419354838709676
110,190,0,7896,2981719,17.272727272727273
150,225,0,7897,2981944,15.0
330,553,0,7898,2982497,16.757575757575758
320,497,0,7899,2982994,15.53125
90,129,0,7900,2983123,14.333333333333334
180,324,0,7901,2983447,18.0
220,331,0,7902,2983778,15.045454545454545
330,525,0,7903,2984303,15.909090909090908
160,202,0,7904,2984505,12.625
240,391,0,7905,2984896,16.291666666666668
120,180,0,7906,2985076,15.0
380,528,0,7907,2985604,13.894736842105264
120,154,0,7908,2985758,12.833333333333334
360,607,0,7909,2986365,16.86111111111111
350,535,0,7910,2986900,15.285714285714286
130,146,0,7911,2987046,11.23076923076923
300,448,0,7912,2987494,14.933333333333334
240,418,0,7913,2987912,17.416666666666668
320,552,0,7914,2988464,17.25
280,449,0,7915,2988913,16.035714285714285
240,322,0,7916,2989235,13.416666666666666
250,323,0,7917,2989558,12.92
90,92,0,7918,2989650,10.222222222222221
230,368,0,7919,2990018,16.0
360,509,0,7920,2990527,14.13888888888889
230,372,0,7921,2990899,16.17391304347826
150,231,0,7922,2991130,15.4
430,667,0,7923,2991797,15.511627906976743
170,206,0,7924,2992003,12.117647058823529
240,382,0,7925,2992385,15.916666666666666
190,242,0,7926,2992627,12.736842105263158
240,350,0,7927,2992977,14.583333333333334
80,128,0,7928,2993105,16.0
230,308,0,7929,2993413,13.391304347826088
110,129,0,7930,2993542,11.727272727272727
180,279,0,7931,2993821,15.5
330,458,0,7932,2994279,13.878787878787879
150,196,0,7933,2994475,13.066666666666666
230,364,0,7934,2994839,15.826086956521738
400,695,0,7935,2995534,17.375
460,815,0,7936,2996349,17.717391304347824
330,450,0,7937,2996799,13.636363636363637
480,647,0,7938,2997446,13.479166666666666
200,256,0,7939,2997702,12.8
180,235,0,7940,2997937,13.055555555555555
390,573,0,7941,2998510,14.692307692307692
230,401,0,7942,2998911,17.434782608695652
240,345,0,7943,2999256,14.375
330,565,0,7944,2999821,17.12121212121212
130,165,0,7945,2999986,12.692307692307692
240,332,0,7946,3000318,13.833333333333334
320,474,0,7947,3000792,14.8125
170,214,0,7948,3001006,12.588235294117647
230,340,0,7949,3001346,14.782608695652174
160,207,0,7950,3001553,12.9375
220,271,0,7951,3001824,12.318181818181818
210,273,0,7952,3002097,13.0
300,381,0,7953,3002478,12.7
330,488,0,7954,3002966,14.787878787878787
270,412,0,7955,3003378,15.25925925925926
500,751,0,7956,3004129,15.02
100,105,0,7957,3004234,10.5
320,467,0,7958,3004701,14.59375
300,462,0,7959,3005163,15.4
170,171,0,7960,3005334,10.058823529411764
240,350,0,7961,3005684,14.583333333333334
390,590,0,7962,3006274,15.128205128205128
320,468,0,7963,3006742,14.625
260,417,0,7964,3007159,16.03846153846154
450,756,0,7965,3007915,16.8
180,241,0,7966,3008156,13.38888888888889
200,351,0,7967,3008507,17.55
240,303,0,7968,3008810,12.625
220,288,0,7969,3009098,13.090909090909092
380,596,0,7970,3009694,15.68421052631579
100,160,0,7971,3009854,16.0
340,541,0,7972,3010395,15.911764705882353
240,346,0,7973,3010741,14.416666666666666
300,456,0,7974,3011197,15.2
70,117,0,7975,3011314,16.714285714285715
120,200,0,7976,3011514,16.666666666666668
190,281,0,7977,3011795,14.789473684210526
220,301,0,7978,3012096,13.681818181818182
100,169,0,7979,3012265,16.9
150,194,0,7980,3012459,12.933333333333334
140,194,0,7981,3012653,13.857142857142858
410,659,0,7982,3013312,16.073170731707318
110,121,0,7983,3013433,11.0
400,547,0,7984,3013980,13.675
220,370,0,7985,3014350,16.818181818181817
300,415,0,7986,3014765,13.833333333333334
210,299,0,7987,3015064,14.238095238095237
110,200,0,7988,3015264,18.181818181818183
240,378,0,7989,3015642,15.75
270,456,0,7990,3016098,16.88888888888889
210,274,0,7991,3016372,13.047619047619047
310,482,0,7992,3016854,15.548387096774194
270,408,0,7993,3017262,15.11111111111111
190,262,0,7994,3017524,13.789473684210526
290,391,0,7995,3017915,13.482758620689655
260,385,0,7996,3018300,14.807692307692308
220,359,0,7997,3018659,16.318181818181817
330,577,0,7998,3019236,17.484848484848484
280,475,0,7999,3019711,16.964285714285715
270,391,0,8000,3020102,14.481481481481481
270,470,0,8001,3020572,17.40740740740741
310,417,0,8002,3020989,13.451612903225806
240,359,0,8003,3021348,14.958333333333334
140,149,0,8004,3021497,10.642857142857142
210,288,0,8005,3021785,13.714285714285714
260,335,0,8006,3022120,12.884615384615385
150,201,0,8007,3022321,13.4
350,585,0,8008,3022906,16.714285714285715
350,503,0,8009,3023409,14.371428571428572
270,423,0,8010,3023832,15.666666666666666
400,594,0,8011,3024426,14.85
130,162,0,8012,3024588,12.461538461538462
320,520,0,8013,3025108,16.25
230,353,0,8014,3025461,15.347826086956522
330,546,0,8015,3026007,16.545454545454547
360,483,0,8016,3026490,13.416666666666666
390,551,0,8017,3027041,14.128205128205128
360,569,0,8018,3027610,15.805555555555555
250,349,0,8019,3027959,13.96
410,649,0,8020,3028608,15.829268292682928
260,455,0,8021,3029063,17.5
180,303,0,8022,3029366,16.833333333333332
300,445,0,8023,3029811,14.833333333333334
230,306,0,8024,3030117,13.304347826086957
170,208,0,8025,3030325,12.235294117647058
240,441,0,8026,3030766,18.375
370,567,0,8027,3031333,15.324324324324325
200,320,0,8028,3031653,16.0
350,517,0,8029,3032170,14.771428571428572
330,556,0,8030,3032726,16.848484848484848
490,778,0,8031,3033504,15.877551020408163
180,242,0,8032,3033746,13.444444444444445
130,168,0,8033,3033914,12.923076923076923
190,242,0,8034,3034156,12.736842105263158
180,220,0,8035,3034376,12.222222222222221
320,429,0,8036,3034805,13.40625
100,149,0,8037,3034954,14.9
400,642,0,8038,3035596,16.05
290,433,0,8039,3036029,14.931034482758621
220,345,0,8040,3036374,15.681818181818182
110,186,0,8041,3036560,16.90909090909091
350,644,0,8042,3037204,18.4
260,395,0,8043,3037599,15.192307692307692
220,294,0,8044,3037893,13.363636363636363
270,371,0,8045,3038264,13.74074074074074
240,405,0,8046,3038669,16.875
400,730,0,8047,3039399,18.25
290,503,0,8048,3039902,17.344827586206897
230,334,0,8049,3040236,14.521739130434783
260,424,0,8050,3040660,16.307692307692307
170,202,0,8051,3040862,11.882352941176471
420,680,0,8052,3041542,16.19047619047619
120,147,0,8053,3041689,12.25
290,459,0,8054,3042148,15.827586206896552
230,312,0,8055,3042460,13.565217391304348
360,592,0,8056,3043052,16.444444444444443
100,150,0,8057,3043202,15.0
270,382,0,8058,3043584,14.148148148148149
180,267,0,8059,3043851,14.833333333333334
330,489,0,8060,3044340,14.818181818181818
180,263,0,8061,3044603,14.61111111111111
60,58,0,8062,3044661,9.666666666666666
220,332,0,8063,3044993,15.090909090909092
200,269,0,8064,3045262,13.45
330,546,0,8065,3045808,16.545454545454547
120,215,0,8066,3046023,17.916666666666668
120,169,0,8067,3046192,14.083333333333334
320,534,0,8068,3046726,16.6875
190,239,0,8069,3046965,12.578947368421053
250,292,0,8070,3047257,11.68
180,233,0,8071,3047490,12.944444444444445
420,726,0,8072,3048216,17.285714285714285
190,289,0,8073,3048505,15.210526315789474
330,604,0,8074,3049109,18.303030303030305
350,569,0,8075,3049678,16.257142857142856
350,504,0,8076,3050182,14.4
300,379,0,8077,3050561,12.633333333333333
350,524,0,8078,3051085,14.971428571428572
270,400,0,8079,3051485,14.814814814814815
260,400,0,8080,3051885,15.384615384615385
350,502,0,8081,3052387,14.342857142857143
410,634,0,8082,3053021,15.463414634146341
140,180,0,8083,3053201,12.857142857142858
130,171,0,8084,3053372,13.153846153846153
230,326,0,8085,3053698,14.173913043478262
190,280,0,8086,3053978,14.736842105263158
240,329,0,8087,3054307,13.708333333333334
250,341,0,8088,3054648,13.64
420,624,0,8089,3055272,14.857142857142858
340,498,0,8090,3055770,14.647058823529411
370,623,0,8091,3056393,16.83783783783784
180,224,0,8092,3056617,12.444444444444445
310,473,0,8093,3057090,15.258064516129032
210,283,0,8094,3057373,13.476190476190476
90,126,0,8095,3057499,14.0
320,448,0,8096,3057947,14.0
330,468,0,8097,3058415,14.181818181818182
190,269,0,8098,3058684,14.157894736842104
160,212,0,8099,3058896,13.25
290,420,0,8100,3059316,14.482758620689655
210,309,0,8101,3059625,14.714285714285714
230,334,0,8102,3059959,14.521739130434783
350,445,0,8103,3060404,12.714285714285714
270,392,0,8104,3060796,14.518518518518519
220,319,0,8105,3061115,14.5
150,205,0,8106,3061320,13.666666666666666
340,568,0,8107,3061888,16.705882352941178
260,400,0,8108,3062288,15.384615384615385
220,295,0,8109,3062583,13.409090909090908
150,252,0,8110,3062835,16.8
390,614,0,8111,3063449,15.743589743589743
120,164,0,8112,3063613,13.666666666666666
220,293,0,8113,3063906,13.318181818181818
100,124,0,8114,3064030,12.4
360,584,0,8115,3064614,16.22222222222222
250,408,0,8116,3065022,16.32
270,467,0,8117,3065489,17.296296296296298
320,512,0,8118,3066001,16.0
310,459,0,8119,3066460,14.806451612903226
150,249,0,8120,3066709,16.6
180,283,0,8121,3066992,15.722222222222221
280,504,0,8122,3067496,18.0
240,336,0,8123,3067832,14.0
190,299,0,8124,3068131,15.736842105263158
200,249,0,8125,3068380,12.45
390,612,0,8126,3068992,15.692307692307692
160,237,0,8127,3069229,14.8125
240,334,0,8128,3069563,13.916666666666666
160,160,0,8129,3069723,10.0
410,575,0,8130,3070298,14.024390243902438
190,252,0,8131,3070550,13.263157894736842
240,374,0,8132,3070924,15.583333333333334
190,273,0,8133,3071197,14.368421052631579
230,355,0,8134,3071552,15.434782608695652
180,261,0,8135,3071813,14.5
330,524,0,8136,3072337,15.878787878787879
170,283,0,8137,3072620,16.647058823529413
340,472,0,8138,3073092,13.882352941176471
260,412,0,8139,3073504,15.846153846153847
330,419,0,8140,3073923,12.696969696969697
240,376,0,8141,3074299,15.666666666666666
260,368,0,8142,3074667,14.153846153846153
400,674,0,8143,3075341,16.85
280,370,0,8144,3075711,13.214285714285714
210,349,0,8145,3076060,16.61904761904762
360,561,0,8146,3076621,15.583333333333334
180,255,0,8147,3076876,14.166666666666666
350,529,0,8148,3077405,15.114285714285714
310,417,0,8149,3077822,13.451612903225806
160,236,0,8150,3078058,14.75
160,236,0,8151,3078294,14.75
280,467,0,8152,3078761,16.678571428571427
300,410,0,8153,3079171,13.666666666666666
320,473,0,8154,3079644,14.78125
390,584,0,8155,3080228,14.974358974358974
120,151,0,8156,3080379,12.583333333333334
260,359,0,8157,3080738,13.807692307692308
280,493,0,8158,3081231,17.607142857142858
390,651,0,8159,3081882,16.692307692307693
240,356,0,8160,3082238,14.833333333333334
120,163,0,8161,3082401,13.583333333333334
250,313,0,8162,3082714,12.52
250,376,0,8163,3083090,15.04
340,493,0,8164,3083583,14.5
140,185,0,8165,3083768,13.214285714285714
400,581,0,8166,3084349,14.525
130,144,0,8167,3084493,11.076923076923077
310,478,0,8168,3084971,15.419354838709678
320,474,0,8169,3085445,14.8125
210,310,0,8170,3085755,14.761904761904763
250,306,0,8171,3086061,12.24
100,117,0,8172,3086178,11.7
320,457,0,8173,3086635,14.28125
340,472,0,8174,3087107,13.882352941176471
240,383,0,8175,3087490,15.958333333333334
170,203,0,8176,3087693,11.941176470588236
240,290,0,8177,3087983,12.083333333333334
330,485,0,8178,3088468,14.696969696969697
190,242,0,8179,3088710,12.736842105263158
290,404,0,8180,3089114,13.931034482758621
180,258,0,8181,3089372,14.333333333333334
270,442,0,8182,3089814,16.37037037037037
260,365,0,8183,3090179,14.038461538461538
200,313,0,8184,3090492,15.65
230,332,0,8185,3090824,14.434782608695652
260,387,0,8186,3091211,14.884615384615385
130,128,0,8187,3091339,9.846153846153847
180,224,0,8188,3091563,12.444444444444445
380,598,0,8189,3092161,15.736842105263158
380,542,0,8190,3092703,14.263157894736842
160,224,0,8191,3092927,14.0
130,228,0,8192,3093155,17.53846153846154
220,369,0,8193,3093524,16.772727272727273
370,500,0,8194,3094024,13.513513513513514
220,371,0,8195,3094395,16.863636363636363
160,250,0,8196,3094645,15.625
390,528,0,8197,3095173,13.538461538461538
180,260,0,8198,3095433,14.444444444444445
340,566,0,8199,3095999,16.647058823529413
260,397,0,8200,3096396,15.26923076923077
140,203,0,8201,3096599,14.5
350,537,0,8202,3097136,15.342857142857143
270,554,0,8203,3097690,20.51851851851852
170,176,0,8204,3097866,10.352941176470589
390,620,0,8205,3098486,15.897435897435898
200,330,0,8206,3098816,16.5
300,550,0,8207,3099366,18.333333333333332
410,599,0,8208,3099965,14.609756097560975
410,641,0,8209,3100606,15.634146341463415
220,359,0,8210,3100965,16.318181818181817
180,217,0,8211,3101182,12.055555555555555
80,110,0,8212,3101292,13.75
220,282,0,8213,3101574,12.818181818181818
330,536,0,8214,3102110,16.242424242424242
290,459,0,8215,3102569,15.827586206896552
200,253,0,8216,3102822,12.65
270,404,0,8217,3103226,14.962962962962964
210,268,0,8218,3103494,12.761904761904763
360,494,0,8219,3103988,13.722222222222221
270,364,0,8220,3104352,13.481481481481481
170,230,0,8221,3104582,13.529411764705882
200,325,0,8222,3104907,16.25
260,374,0,8223,3105281,14.384615384615385
160,206,0,8224,3105487,12.875
210,280,0,8225,3105767,13.333333333333334
340,487,0,8226,3106254,14.323529411764707
220,318,0,8227,3106572,14.454545454545455
200,259,0,8228,3106831,12.95
350,552,0,8229,3107383,15.771428571428572
180,248,0,8230,3107631,13.777777777777779
590,937,0,8231,3108568,15.88135593220339
190,271,0,8232,3108839,14.263157894736842
470,801,0,8233,3109640,17.04255319148936
270,359,0,8234,3109999,13.296296296296296
220,244,0,8235,3110243,11.090909090909092
510,833,0,8236,3111076,16.333333333333332
180,244,0,8237,3111320,13.555555555555555
220,336,0,8238,3111656,15.272727272727273
160,230,0,8239,3111886,14.375
120,163,0,8240,3112049,13.583333333333334
210,259,0,8241,3112308,12.333333333333334
450,666,0,8242,3112974,14.8
160,227,0,8243,3113201,14.1875
140,164,0,8244,3113365,11.714285714285714
160,219,0,8245,3113584,13.6875
320,530,0,8246,3114114,16.5625
290,476,0,8247,3114590,16.413793103448278
210,314,0,8248,3114904,14.952380952380953
100,137,0,8249,3115041,13.7
280,406,0,8250,3115447,14.5
210,322,0,8251,3115769,15.333333333333334
180,280,0,8252,3116049,15.555555555555555
260,412,0,8253,3116461,15.846153846153847
410,597,0,8254,3117058,14.560975609756097
240,303,0,8255,3117361,12.625
180,287,0,8256,3117648,15.944444444444445
300,415,0,8257,3118063,13.833333333333334
370,595,0,8258,3118658,16.08108108108108
70,100,0,8259,3118758,14.285714285714286
240,314,0,8260,3119072,13.083333333333334
370,524,0,8261,3119596,14.162162162162161
220,339,0,8262,3119935,15.409090909090908
260,349,0,8263,3120284,13.423076923076923
240,342,0,8264,3120626,14.25
190,264,0,8265,3120890,13.894736842105264
320,510,0,8266,3121400,15.9375
380,674,0,8267,3122074,17.736842105263158
230,319,0,8268,3122393,13.869565217391305
250,313,0,8269,3122706,12.52
180,228,0,8270,3122934,12.666666666666666
230,340,0,8271,3123274,14.782608695652174
150,179,0,8272,3123453,11.933333333333334
330,385,0,8273,3123838,11.666666666666666
260,441,0,8274,3124279,16.96153846153846
110,145,0,8275,3124424,13.181818181818182
340,528,0,8276,3124952,15.529411764705882
190,300,0,8277,3125252,15.789473684210526
300,423,0,8278,3125675,14.1
270,466,0,8279,3126141,17.25925925925926
70,99,0,8280,3126240,14.142857142857142
80,116,0,8281,3126356,14.5
370,537,0,8282,3126893,14.513513513513514
300,449,0,8283,3127342,14.966666666666667
220,295,0,8284,3127637,13.409090909090908
230,317,0,8285,3127954,13.782608695652174
210,352,0,8286,3128306,16.761904761904763
320,463,0,8287,3128769,14.46875
200,278,0,8288,3129047,13.9
190,245,0,8289,3129292,12.894736842105264
380,662,0,8290,3129954,17.42105263157895
350,598,0,8291,3130552,17.085714285714285
350,638,0,8292,3131190,18.228571428571428
170,192,0,8293,3131382,11.294117647058824
210,324,0,8294,3131706,15.428571428571429
300,441,0,8295,3132147,14.7
310,448,0,8296,3132595,14.451612903225806
300,436,0,8297,3133031,14.533333333333333
350,630,0,8298,3133661,18.0
70,89,0,8299,3133750,12.714285714285714
240,341,0,8300,3134091,14.208333333333334
470,741,0,8301,3134832,15.76595744680851
220,284,0,8302,3135116,12.909090909090908
190,263,0,8303,3135379,13.842105263157896
210,308,0,8304,3135687,14.666666666666666
230,300,0,8305,3135987,13.043478260869565
310,461,0,8306,3136448,14.870967741935484
150,243,0,8307,3136691,16.2
330,513,0,8308,3137204,15.545454545454545
380,650,0,8309,3137854,17.105263157894736
180,251,0,8310,3138105,13.944444444444445
250,367,0,8311,3138472,14.68
150,198,0,8312,3138670,13.2
210,317,0,8313,3138987,15.095238095238095
250,398,0,8314,3139385,15.92
240,354,0,8315,3139739,14.75
350,581,0,8316,3140320,16.6
230,284,0,8317,3140604,12.347826086956522
80,104,0,8318,3140708,13.0
240,336,0,8319,3141044,14.0
260,443,0,8320,3141487,17.03846153846154
200,291,0,8321,3141778,14.55
90,137,0,8322,3141915,15.222222222222221
120,164,0,8323,3142079,13.666666666666666
120,166,0,8324,3142245,13.833333333333334
200,265,0,8325,3142510,13.25
100,211,0,8326,3142721,21.1
90,121,0,8327,3142842,13.444444444444445
350,554,0,8328,3143396,15.82857142857143
250,329,0,8329,3143725,13.16
170,261,0,8330,3143986,15.352941176470589
360,559,0,8331,3144545,15.527777777777779
210,332,0,8332,3144877,15.80952380952381
280,430,0,8333,3145307,15.357142857142858
370,665,0,8334,3145972,17.972972972972972
300,436,0,8335,3146408,14.533333333333333
150,223,0,8336,3146631,14.866666666666667
100,135,0,8337,3146766,13.5
260,369,0,8338,3147135,14.192307692307692
460,766,0,8339,3147901,16.652173913043477
50,83,0,8340,3147984,16.6
420,714,0,8341,3148698,17.0
80,117,0,8342,3148815,14.625
260,296,0,8343,3149111,11.384615384615385
190,303,0,8344,3149414,15.947368421052632
250,410,0,8345,3149824,16.4
300,394,0,8346,3150218,13.133333333333333
310,465,0,8347,3150683,15.0
330,603,0,8348,3151286,18.272727272727273
270,418,0,8349,3151704,15.481481481481481
290,386,0,8350,3152090,13.310344827586206
250,338,0,8351,3152428,13.52
290,449,0,8352,3152877,15.482758620689655
340,415,0,8353,3153292,12.205882352941176
310,448,0,8354,3153740,14.451612903225806
280,435,0,8355,3154175,15.535714285714286
130,181,0,8356,3154356,13.923076923076923
130,156,0,8357,3154512,12.0
540,1025,0,8358,3155537,18.98148148148148
150,156,0,8359,3155693,10.4
300,395,0,8360,3156088,13.166666666666666
460,759,0,8361,3156847,16.5
80,111,0,8362,3156958,13.875
80,131,0,8363,3157089,16.375
290,441,0,8364,3157530,15.206896551724139
430,720,0,8365,3158250,16.74418604651163
280,402,0,8366,3158652,14.357142857142858
260,378,0,8367,3159030,14.538461538461538
310,508,0,8368,3159538,16.387096774193548
340,531,0,8369,3160069,15.617647058823529
210,306,0,8370,3160375,14.571428571428571
390,632,0,8371,3161007,16.205128205128204
250,391,0,8372,3161398,15.64
300,487,0,8373,3161885,16.233333333333334
170,247,0,8374,3162132,14.529411764705882
310,462,0,8375,3162594,14.903225806451612
200,291,0,8376,3162885,14.55
300,424,0,8377,3163309,14.133333333333333
380,480,0,8378,3163789,12.631578947368421
180,259,0,8379,3164048,14.38888888888889
210,339,0,8380,3164387,16.142857142857142
160,249,0,8381,3164636,15.5625
150,165,0,8382,3164801,11.0
220,337,0,8383,3165138,15.318181818181818
90,116,0,8384,3165254,12.88888888888889
170,261,0,8385,3165515,15.352941176470589
340,526,0,8386,3166041,15.470588235294118
310,438,0,8387,3166479,14.129032258064516
200,322,0,8388,3166801,16.1
180,267,0,8389,3167068,14.833333333333334
220,346,0,8390,3167414,15.727272727272727
360,566,0,8391,3167980,15.722222222222221
80,97,0,8392,3168077,12.125
160,209,0,8393,3168286,13.0625
180,253,0,8394,3168539,14.055555555555555
350,570,0,8395,3169109,16.285714285714285
140,172,0,8396,3169281,12.285714285714286
260,359,0,8397,3169640,13.807692307692308
370,604,0,8398,3170244,16.324324324324323
300,418,0,8399,3170662,13.933333333333334
290,404,0,8400,3171066,13.931034482758621
300,429,0,8401,3171495,14.3
260,371,0,8402,3171866,14.26923076923077
260,414,0,8403,3172280,15.923076923076923
280,451,0,8404,3172731,16.107142857142858
260,379,0,8405,3173110,14.576923076923077
180,268,0,8406,3173378,14.88888888888889
310,386,0,8407,3173764,12.451612903225806
300,446,0,8408,3174210,14.866666666666667
240,344,0,8409,3174554,14.333333333333334
440,726,0,8410,3175280,16.5
310,437,0,8411,3175717,14.096774193548388
230,366,0,8412,3176083,15.91304347826087
310,458,0,8413,3176541,14.774193548387096
220,286,0,8414,3176827,13.0
180,253,0,8415,3177080,14.055555555555555
240,323,0,8416,3177403,13.458333333333334
410,591,0,8417,3177994,14.414634146341463
300,464,0,8418,3178458,15.466666666666667
210,288,0,8419,3178746,13.714285714285714
270,411,0,8420,3179157,15.222222222222221
250,400,0,8421,3179557,16.0
330,437,0,8422,3179994,13.242424242424242
150,195,0,8423,3180189,13.0
190,235,0,8424,3180424,12.368421052631579
250,399,0,8425,3180823,15.96
340,461,0,8426,3181284,13.558823529411764
470,871,0,8427,3182155,18.53191489361702
340,511,0,8428,3182666,15.029411764705882
400,675,0,8429,3183341,16.875
200,328,0,8430,3183669,16.4
150,203,0,8431,3183872,13.533333333333333
170,188,0,8432,3184060,11.058823529411764
270,357,0,8433,3184417,13.222222222222221
150,197,0,8434,3184614,13.133333333333333
400,692,0,8435,3185306,17.3
460,760,0,8436,3186066,16.52173913043478
260,420,0,8437,3186486,16.153846153846153
60,65,0,8438,3186551,10.833333333333334
290,451,0,8439,3187002,15.551724137931034
50,54,0,8440,3187056,10.8
230,327,0,8441,3187383,14.217391304347826
240,337,0,8442,3187720,14.041666666666666
250,366,0,8443,3188086,14.64
380,638,0,8444,3188724,16.789473684210527
230,307,0,8445,3189031,13.347826086956522
310,409,0,8446,3189440,13.193548387096774
220,295,0,8447,3189735,13.409090909090908
230,291,0,8448,3190026,12.652173913043478
200,268,0,8449,3190294,13.4
250,316,0,8450,3190610,12.64
140,239,0,8451,3190849,17.071428571428573
380,577,0,8452,3191426,15.18421052631579
480,727,0,8453,3192153,15.145833333333334
400,671,0,8454,3192824,16.775
150,200,0,8455,3193024,13.333333333333334
240,377,0,8456,3193401,15.708333333333334
300,461,0,8457,3193862,15.366666666666667
170,233,0,8458,3194095,13.705882352941176
240,321,0,8459,3194416,13.375
250,389,0,8460,3194805,15.56
160,306,0,8461,3195111,19.125
170,276,0,8462,3195387,16.235294117647058
330,517,0,8463,3195904,15.666666666666666
160,205,0,8464,3196109,12.8125
300,435,0,8465,3196544,14.5
140,219,0,8466,3196763,15.642857142857142
240,328,0,8467,3197091,13.666666666666666
350,499,0,8468,3197590,14.257142857142858
230,345,0,8469,3197935,15.0
230,331,0,8470,3198266,14.391304347826088
110,149,0,8471,3198415,13.545454545454545
150,240,0,8472,3198655,16.0
270,393,0,8473,3199048,14.555555555555555
420,727,0,8474,3199775,17.30952380952381
400,564,0,8475,3200339,14.1
150,240,0,8476,3200579,16.0
310,344,0,8477,3200923,11.096774193548388
450,708,0,8478,3201631,15.733333333333333
170,262,0,8479,3201893,15.411764705882353
400,620,0,8480,3202513,15.5
170,229,0,8481,3202742,13.470588235294118
170,237,0,8482,3202979,13.941176470588236
70,95,0,8483,3203074,13.571428571428571
130,182,0,8484,3203256,14.0
250,278,0,8485,3203534,11.12
540,801,0,8486,3204335,14.833333333333334
400,707,0,8487,3205042,17.675
260,319,0,8488,3205361,12.26923076923077
400,592,0,8489,3205953,14.8
340,522,0,8490,3206475,15.352941176470589
170,262,0,8491,3206737,15.411764705882353
200,243,0,8492,3206980,12.15
340,467,0,8493,3207447,13.735294117647058
150,256,0,8494,3207703,17.066666666666666
210,308,0,8495,3208011,14.666666666666666
260,394,0,8496,3208405,15.153846153846153
210,251,0,8497,3208656,11.952380952380953
150,197,0,8498,3208853,13.133333333333333
110,187,0,8499,3209040,17.0
320,497,0,8500,3209537,15.53125
250,405,0,8501,3209942,16.2
190,259,0,8502,3210201,13.631578947368421
340,556,0,8503,3210757,16.352941176470587
200,322,0,8504,3211079,16.1
160,217,0,8505,3211296,13.5625
180,241,0,8506,3211537,13.38888888888889
230,354,0,8507,3211891,15.391304347826088
290,393,0,8508,3212284,13.551724137931034
200,327,0,8509,3212611,16.35
210,303,0,8510,3212914,14.428571428571429
100,132,0,8511,3213046,13.2
110,152,0,8512,3213198,13.818181818181818
280,457,0,8513,3213655,16.321428571428573
330,516,0,8514,3214171,15.636363636363637
190,318,0,8515,3214489,16.736842105263158
200,264,0,8516,3214753,13.2
380,561,0,8517,3215314,14.763157894736842
300,348,0,8518,3215662,11.6
340,486,0,8519,3216148,14.294117647058824
240,389,0,8520,3216537,16.208333333333332
160,184,0,8521,3216721,11.5
340,572,0,8522,3217293,16.823529411764707
170,232,0,8523,3217525,13.647058823529411
190,283,0,8524,3217808,14.894736842105264
390,623,0,8525,3218431,15.974358974358974
120,158,0,8526,3218589,13.166666666666666
360,598,0,8527,3219187,16.61111111111111
300,461,0,8528,3219648,15.366666666666667
210,293,0,8529,3219941,13.952380952380953
180,203,0,8530,3220144,11.277777777777779
400,637,0,8531,3220781,15.925
240,330,0,8532,3221111,13.75
140,231,0,8533,3221342,16.5
340,422,0,8534,3221764,12.411764705882353
140,194,0,8535,3221958,13.857142857142858
240,347,0,8536,3222305,14.458333333333334
150,172,0,8537,3222477,11.466666666666667
280,382,0,8538,3222859,13.642857142857142
220,288,0,8539,3223147,13.090909090909092
280,415,0,8540,3223562,14.821428571428571
170,255,0,8541,3223817,15.0
240,373,0,8542,3224190,15.541666666666666
200,269,0,8543,3224459,13.45
140,183,0,8544,3224642,13.071428571428571
210,262,0,8545,3224904,12.476190476190476
250,363,0,8546,3225267,14.52
340,537,0,8547,3225804,15.794117647058824
440,678,0,8548,3226482,15.409090909090908
280,440,0,8549,3226922,15.714285714285714
290,440,0,8550,3227362,15.172413793103448
320,536,0,8551,3227898,16.75
230,276,0,8552,3228174,12.0
280,455,0,8553,3228629,16.25
290,440,0,8554,3229069,15.172413793103448
180,279,0,8555,3229348,15.5
230,342,0,8556,3229690,14.869565217391305
160,171,0,8557,3229861,10.6875
330,580,0,8558,3230441,17.575757575757574
200,244,0,8559,3230685,12.2
120,163,0,8560,3230848,13.583333333333334
230,281,0,8561,3231129,12.217391304347826
300,478,0,8562,3231607,15.933333333333334
130,246,0,8563,3231853,18.923076923076923
280,432,0,8564,3232285,15.428571428571429
460,714,0,8565,3232999,15.521739130434783
180,259,0,8566,3233258,14.38888888888889
160,226,0,8567,3233484,14.125
300,468,0,8568,3233952,15.6
150,230,0,8569,3234182,15.333333333333334
200,278,0,8570,3234460,13.9
430,590,0,8571,3235050,13.720930232558139
170,161,0,8572,3235211,9.470588235294118
260,353,0,8573,3235564,13.576923076923077
210,332,0,8574,3235896,15.80952380952381
420,667,0,8575,3236563,15.880952380952381
140,194,0,8576,3236757,13.857142857142858
490,732,0,8577,3237489,14.938775510204081
240,405,0,8578,3237894,16.875
170,217,0,8579,3238111,12.764705882352942
360,525,0,8580,3238636,14.583333333333334
200,237,0,8581,3238873,11.85
80,117,0,8582,3238990,14.625
430,666,0,8583,3239656,15.488372093023257
240,387,0,8584,3240043,16.125
260,336,0,8585,3240379,12.923076923076923
190,212,0,8586,3240591,11.157894736842104
270,336,0,8587,3240927,12.444444444444445
340,507,0,8588,3241434,14.911764705882353
170,251,0,8589,3241685,14.764705882352942
280,501,0,8590,3242186,17.892857142857142
440,714,0,8591,3242900,16.227272727272727
220,323,0,8592,3243223,14.681818181818182
530,900,0,8593,3244123,16.9811320754717
370,556,0,8594,3244679,15.027027027027026
200,312,0,8595,3244991,15.6
350,533,0,8596,3245524,15.228571428571428
240,332,0,8597,3245856,13.833333333333334
250,247,0,8598,3246103,9.88
250,376,0,8599,3246479,15.04
190,316,0,8600,3246795,16.63157894736842
230,329,0,8601,3247124,14.304347826086957
290,337,0,8602,3247461,11.620689655172415
120,182,0,8603,3247643,15.166666666666666
110,161,0,8604,3247804,14.636363636363637
390,626,0,8605,3248430,16.05128205128205
200,334,0,8606,3248764,16.7
220,313,0,8607,3249077,14.227272727272727
200,305,0,8608,3249382,15.25
180,215,0,8609,3249597,11.944444444444445
200,259,0,8610,3249856,12.95
380,502,0,8611,3250358,13.210526315789474
350,490,0,8612,3250848,14.0
220,307,0,8613,3251155,13.954545454545455
240,304,0,8614,3251459,12.666666666666666
300,443,0,8615,3251902,14.766666666666667
310,495,0,8616,3252397,15.96774193548387
320,429,0,8617,3252826,13.40625
490,861,0,8618,3253687,17.571428571428573
130,143,0,8619,3253830,11.0
150,207,0,8620,3254037,13.8
360,587,0,8621,3254624,16.305555555555557
300,478,0,8622,3255102,15.933333333333334
200,264,0,8623,3255366,13.2
250,381,0,8624,3255747,15.24
190,288,0,8625,3256035,15.157894736842104
170,244,0,8626,3256279,14.352941176470589
160,185,0,8627,3256464,11.5625
330,503,0,8628,3256967,15.242424242424242
510,771,0,8629,3257738,15.117647058823529
190,295,0,8630,3258033,15.526315789473685
480,820,0,8631,3258853,17.083333333333332
210,317,0,8632,3259170,15.095238095238095
250,366,0,8633,3259536,14.64
600,898,0,8634,3260434,14.966666666666667
310,443,0,8635,3260877,14.290322580645162
500,882,0,8636,3261759,17.64
300,402,0,8637,3262161,13.4
160,201,0,8638,3262362,12.5625
380,526,0,8639,3262888,13.842105263157896
320,472,0,8640,3263360,14.75
260,422,0,8641,3263782,16.23076923076923
350,543,0,8642,3264325,15.514285714285714
390,666,0,8643,3264991,17.076923076923077
210,274,0,8644,3265265,13.047619047619047
360,571,0,8645,3265836,15.86111111111111
320,548,0,8646,3266384,17.125
430,641,0,8647,3267025,14.906976744186046
280,432,0,8648,3267457,15.428571428571429
170,197,0,8649,3267654,11.588235294117647
150,167,0,8650,3267821,11.133333333333333
110,139,0,8651,3267960,12.636363636363637
300,449,0,8652,3268409,14.966666666666667
180,250,0,8653,3268659,13.88888888888889
140,223,0,8654,3268882,15.928571428571429
30,33,0,8655,3268915,11.0
390,573,0,8656,3269488,14.692307692307692
190,219,0,8657,3269707,11.526315789473685
130,203,0,8658,3269910,15.615384615384615
250,360,0,8659,3270270,14.4
400,552,0,8660,3270822,13.8
150,147,0,8661,3270969,9.8
220,319,0,8662,3271288,14.5
500,817,0,8663,3272105,16.34
420,643,0,8664,3272748,15.30952380952381
280,439,0,8665,3273187,15.678571428571429
280,365,0,8666,3273552,13.035714285714286
50,57,0,8667,3273609,11.4
220,358,0,8668,3273967,16.272727272727273
140,178,0,8669,3274145,12.714285714285714
110,149,0,8670,3274294,13.545454545454545
80,101,0,8671,3274395,12.625
180,252,0,8672,3274647,14.0
240,429,0,8673,3275076,17.875
260,364,0,8674,3275440,14.0
410,651,0,8675,3276091,15.878048780487806
190,255,0,8676,3276346,13.421052631578947
400,616,0,8677,3276962,15.4
200,299,0,8678,3277261,14.95
250,355,0,8679,3277616,14.2
230,344,0,8680,3277960,14.956521739130435
220,329,0,8681,3278289,14.954545454545455
190,287,0,8682,3278576,15.105263157894736
200,295,0,8683,3278871,14.75
170,228,0,8684,3279099,13.411764705882353
140,208,0,8685,3279307,14.857142857142858
360,518,0,8686,3279825,14.38888888888889
390,614,0,8687,3280439,15.743589743589743
120,144,0,8688,3280583,12.0
250,406,0,8689,3280989,16.24
130,166,0,8690,3281155,12.76923076923077
170,284,0,8691,3281439,16.705882352941178
330,502,0,8692,3281941,15.212121212121213
280,417,0,8693,3282358,14.892857142857142
260,414,0,8694,3282772,15.923076923076923
380,604,0,8695,3283376,15.894736842105264
300,358,0,8696,3283734,11.933333333333334
280,384,0,8697,3284118,13.714285714285714
330,518,0,8698,3284636,15.696969696969697
210,280,0,8699,3284916,13.333333333333334
130,164,0,8700,3285080,12.615384615384615
200,303,0,8701,3285383,15.15
140,214,0,8702,3285597,15.285714285714286
330,473,0,8703,3286070,14.333333333333334
350,541,0,8704,3286611,15.457142857142857
220,315,0,8705,3286926,14.318181818181818
280,353,0,8706,3287279,12.607142857142858
160,222,0,8707,3287501,13.875
260,419,0,8708,3287920,16.115384615384617
120,145,0,8709,3288065,12.083333333333334
140,175,0,8710,3288240,12.5
340,520,0,8711,3288760,15.294117647058824
320,424,0,8712,3289184,13.25
310,536,0,8713,3289720,17.29032258064516
210,272,0,8714,3289992,12.952380952380953
140,181,0,8715,3290173,12.928571428571429
370,587,0,8716,3290760,15.864864864864865
290,510,0,8717,3291270,17.586206896551722
230,301,0,8718,3291571,13.08695652173913
240,289,0,8719,3291860,12.041666666666666
140,153,0,8720,3292013,10.928571428571429
180,225,0,8721,3292238,12.5
330,517,0,8722,3292755,15.666666666666666
160,244,0,8723,3292999,15.25
360,643,0,8724,3293642,17.86111111111111
190,292,0,8725,3293934,15.368421052631579
190,260,0,8726,3294194,13.68421052631579
200,323,0,8727,3294517,16.15
170,259,0,8728,3294776,15.235294117647058
260,410,0,8729,3295186,15.76923076923077
280,356,0,8730,3295542,12.714285714285714
80,111,0,8731,3295653,13.875
240,315,0,8732,3295968,13.125
380,810,0,8733,3296778,21.31578947368421
190,296,0,8734,3297074,15.578947368421053
250,396,0,8735,3297470,15.84
370,582,0,8736,3298052,15.72972972972973
340,488,0,8737,3298540,14.352941176470589
200,307,0,8738,3298847,15.35
490,722,0,8739,3299569,14.73469387755102
240,356,0,8740,3299925,14.833333333333334
180,262,0,8741,3300187,14.555555555555555
270,376,0,8742,3300563,13.925925925925926
450,624,0,8743,3301187,13.866666666666667
380,729,0,8744,3301916,19.18421052631579
230,323,0,8745,3302239,14.043478260869565
250,359,0,8746,3302598,14.36
160,206,0,8747,3302804,12.875
370,639,0,8748,3303443,17.27027027027027
410,646,0,8749,3304089,15.75609756097561
260,399,0,8750,3304488,15.346153846153847
130,216,0,8751,3304704,16.615384615384617
200,317,0,8752,3305021,15.85
340,477,0,8753,3305498,14.029411764705882
100,113,0,8754,3305611,11.3
190,226,0,8755,3305837,11.894736842105264
240,373,0,8756,3306210,15.541666666666666
100,140,0,8757,3306350,14.0
230,355,0,8758,3306705,15.434782608695652
480,702,0,8759,3307407,14.625
140,161,0,8760,3307568,11.5
110,166,0,8761,3307734,15.090909090909092
380,509,0,8762,3308243,13.394736842105264
250,500,0,8763,3308743,20.0
150,191,0,8764,3308934,12.733333333333333
370,558,0,8765,3309492,15.08108108108108
160,236,0,8766,3309728,14.75
240,339,0,8767,3310067,14.125
330,518,0,8768,3310585,15.696969696969697
160,216,0,8769,3310801,13.5
430,693,0,8770,3311494,16.11627906976744
200,230,0,8771,3311724,11.5
190,285,0,8772,3312009,15.0
110,142,0,8773,3312151,12.909090909090908
140,211,0,8774,3312362,15.071428571428571
200,237,0,8775,3312599,11.85
300,422,0,8776,3313021,14.066666666666666
240,367,0,8777,3313388,15.291666666666666
350,499,0,8778,3313887,14.257142857142858
290,474,0,8779,3314361,16.344827586206897
190,291,0,8780,3314652,15.31578947368421
290,392,0,8781,3315044,13.517241379310345
390,568,0,8782,3315612,14.564102564102564
400,706,0,8783,3316318,17.65
110,127,0,8784,3316445,11.545454545454545
250,441,0,8785,3316886,17.64
280,283,0,8786,3317169,10.107142857142858
290,464,0,8787,3317633,16.0
210,284,0,8788,3317917,13.523809523809524
210,333,0,8789,3318250,15.857142857142858
150,211,0,8790,3318461,14.066666666666666
260,321,0,8791,3318782,12.346153846153847
190,303,0,8792,3319085,15.947368421052632
170,231,0,8793,3319316,13.588235294117647
230,367,0,8794,3319683,15.956521739130435
290,455,0,8795,3320138,15.689655172413794
400,701,0,8796,3320839,17.525
160,214,0,8797,3321053,13.375
280,446,0,8798,3321499,15.928571428571429
110,176,0,8799,3321675,16.0
300,511,0,8800,3322186,17.033333333333335
120,138,0,8801,3322324,11.5
180,212,0,8802,3322536,11.777777777777779
230,382,0,8803,3322918,16.608695652173914
290,406,0,8804,3323324,14.0
200,299,0,8805,3323623,14.95
330,519,0,8806,3324142,15.727272727272727
170,266,0,8807,3324408,15.647058823529411
260,402,0,8808,3324810,15.461538461538462
140,175,0,8809,3324985,12.5
480,736,0,8810,3325721,15.333333333333334
380,609,0,8811,3326330,16.026315789473685
260,408,0,8812,3326738,15.692307692307692
240,328,0,8813,3327066,13.666666666666666
170,234,0,8814,3327300,13.764705882352942
280,490,0,8815,3327790,17.5
190,283,0,8816,3328073,14.894736842105264
160,215,0,8817,3328288,13.4375
510,888,0,8818,3329176,17.41176470588235
290,448,0,8819,3329624,15.448275862068966
300,516,0,8820,3330140,17.2
260,382,0,8821,3330522,14.692307692307692
210,288,0,8822,3330810,13.714285714285714
180,297,0,8823,3331107,16.5
390,520,0,8824,3331627,13.333333333333334
110,128,0,8825,3331755,11.636363636363637
240,338,0,8826,3332093,14.083333333333334
430,703,0,8827,3332796,16.348837209302324
160,272,0,8828,3333068,17.0
340,449,0,8829,3333517,13.205882352941176
130,139,0,8830,3333656,10.692307692307692
360,607,0,8831,3334263,16.86111111111111
190,288,0,8832,3334551,15.157894736842104
90,114,0,8833,3334665,12.666666666666666
210,308,0,8834,3334973,14.666666666666666
100,97,0,8835,3335070,9.7
310,557,0,8836,3335627,17.967741935483872
330,507,0,8837,3336134,15.363636363636363
120,160,0,8838,3336294,13.333333333333334
100,171,0,8839,3336465,17.1
140,182,0,8840,3336647,13.0
220,320,0,8841,3336967,14.545454545454545
310,482,0,8842,3337449,15.548387096774194
550,975,0,8843,3338424,17.727272727272727
270,409,0,8844,3338833,15.148148148148149
130,180,0,8845,3339013,13.846153846153847
160,241,0,8846,3339254,15.0625
360,515,0,8847,3339769,14.305555555555555
280,410,0,8848,3340179,14.642857142857142
110,130,0,8849,3340309,11.818181818181818
190,262,0,8850,3340571,13.789473684210526
380,551,0,8851,3341122,14.5
290,435,0,8852,3341557,15.0
120,153,0,8853,3341710,12.75
240,369,0,8854,3342079,15.375
240,331,0,8855,3342410,13.791666666666666
190,260,0,8856,3342670,13.68421052631579
320,474,0,8857,3343144,14.8125
220,322,0,8858,3343466,14.636363636363637
290,449,0,8859,3343915,15.482758620689655
580,981,0,8860,3344896,16.913793103448278
260,456,0,8861,3345352,17.53846153846154
230,293,0,8862,3345645,12.73913043478261
300,542,0,8863,3346187,18.066666666666666
150,210,0,8864,3346397,14.0
130,139,0,8865,3346536,10.692307692307692
200,330,0,8866,3346866,16.5
260,372,0,8867,3347238,14.307692307692308
330,513,0,8868,3347751,15.545454545454545
130,219,0,8869,3347970,16.846153846153847
340,534,0,8870,3348504,15.705882352941176
380,657,0,8871,3349161,17.289473684210527
160,209,0,8872,3349370,13.0625
430,642,0,8873,3350012,14.930232558139535
280,421,0,8874,3350433,15.035714285714286
130,181,0,8875,3350614,13.923076923076923
250,379,0,8876,3350993,15.16
220,266,0,8877,3351259,12.090909090909092
450,647,0,8878,3351906,14.377777777777778
130,151,0,8879,3352057,11.615384615384615
340,504,0,8880,3352561,14.823529411764707
290,422,0,8881,3352983,14.551724137931034
180,308,0,8882,3353291,17.11111111111111
250,344,0,8883,3353635,13.76
470,740,0,8884,3354375,15.74468085106383
190,346,0,8885,3354721,18.210526315789473
130,182,0,8886,3354903,14.0
200,281,0,8887,3355184,14.05
90,145,0,8888,3355329,16.11111111111111
290,382,0,8889,3355711,13.172413793103448
290,471,0,8890,3356182,16.24137931034483
380,537,0,8891,3356719,14.131578947368421
250,438,0,8892,3357157,17.52
350,469,0,8893,3357626,13.4
200,264,0,8894,3357890,13.2
270,397,0,8895,3358287,14.703703703703704
260,449,0,8896,3358736,17.26923076923077
540,944,0,8897,3359680,17.48148148148148
150,211,0,8898,3359891,14.066666666666666
390,475,0,8899,3360366,12.179487179487179
120,166,0,8900,3360532,13.833333333333334
230,364,0,8901,3360896,15.826086956521738
160,185,0,8902,3361081,11.5625
130,152,0,8903,3361233,11.692307692307692
250,352,0,8904,3361585,14.08
150,200,0,8905,3361785,13.333333333333334
190,306,0,8906,3362091,16.105263157894736
150,149,0,8907,3362240,9.933333333333334
260,400,0,8908,3362640,15.384615384615385
90,121,0,8909,3362761,13.444444444444445
150,205,0,8910,3362966,13.666666666666666
160,192,0,8911,3363158,12.0
110,162,0,8912,3363320,14.727272727272727
340,493,0,8913,3363813,14.5
420,529,0,8914,3364342,12.595238095238095
170,261,0,8915,3364603,15.352941176470589
290,395,0,8916,3364998,13.620689655172415
180,217,0,8917,3365215,12.055555555555555
260,390,0,8918,3365605,15.0
370,644,0,8919,3366249,17.405405405405407
280,405,0,8920,3366654,14.464285714285714
210,314,0,8921,3366968,14.952380952380953
290,386,0,8922,3367354,13.310344827586206
280,495,0,8923,3367849,17.678571428571427
440,772,0,8924,3368621,17.545454545454547
400,642,0,8925,3369263,16.05
230,370,0,8926,3369633,16.08695652173913
250,325,0,8927,3369958,13.0
200,325,0,8928,3370283,16.25
150,209,0,8929,3370492,13.933333333333334
160,223,0,8930,3370715,13.9375
340,484,0,8931,3371199,14.235294117647058
290,378,0,8932,3371577,13.03448275862069
380,511,0,8933,3372088,13.447368421052632
200,280,0,8934,3372368,14.0
380,523,0,8935,3372891,13.763157894736842
470,806,0,8936,3373697,17.148936170212767
170,236,0,8937,3373933,13.882352941176471
430,649,0,8938,3374582,15.093023255813954
470,974,0,8939,3375556,20.72340425531915
240,378,0,8940,3375934,15.75
240,407,0,8941,3376341,16.958333333333332
160,221,0,8942,3376562,13.8125
40,53,0,8943,3376615,13.25
430,620,0,8944,3377235,14.418604651162791
210,333,0,8945,3377568,15.857142857142858
150,199,0,8946,3377767,13.266666666666667
300,475,0,8947,3378242,15.833333333333334
240,363,0,8948,3378605,15.125
310,404,0,8949,3379009,13.03225806451613
160,223,0,8950,3379232,13.9375
320,510,0,8951,3379742,15.9375
160,202,0,8952,3379944,12.625
330,523,0,8953,3380467,15.848484848484848
130,149,0,8954,3380616,11.461538461538462
430,733,0,8955,3381349,17.046511627906977
280,463,0,8956,3381812,16.535714285714285
60,86,0,8957,3381898,14.333333333333334
350,556,0,8958,3382454,15.885714285714286
50,41,0,8959,3382495,8.2
180,248,0,8960,3382743,13.777777777777779
250,413,0,8961,3383156,16.52
270,435,0,8962,3383591,16.11111111111111
350,490,0,8963,3384081,14.0
250,364,0,8964,3384445,14.56
50,65,0,8965,3384510,13.0
230,323,0,8966,3384833,14.043478260869565
190,195,0,8967,3385028,10.263157894736842
220,299,0,8968,3385327,13.590909090909092
110,132,0,8969,3385459,12.0
220,279,0,8970,3385738,12.681818181818182
260,348,0,8971,3386086,13.384615384615385
130,198,0,8972,3386284,15.23076923076923
150,190,0,8973,3386474,12.666666666666666
220,227,0,8974,3386701,10.318181818181818
370,591,0,8975,3387292,15.972972972972974
220,357,0,8976,3387649,16.227272727272727
240,346,0,8977,3387995,14.416666666666666
190,215,0,8978,3388210,11.31578947368421
190,318,0,8979,3388528,16.736842105263158
160,193,0,8980,3388721,12.0625
360,520,0,8981,3389241,14.444444444444445
390,690,0,8982,3389931,17.692307692307693
200,275,0,8983,3390206,13.75
420,659,0,8984,3390865,15.69047619047619
380,583,0,8985,3391448,15.342105263157896
120,178,0,8986,3391626,14.833333333333334
250,306,0,8987,3391932,12.24
350,591,0,8988,3392523,16.885714285714286
260,370,0,8989,3392893,14.23076923076923
150,225,0,8990,3393118,15.0
160,204,0,8991,3393322,12.75
220,321,0,8992,3393643,14.590909090909092
320,359,0,8993,3394002,11.21875
140,173,0,8994,3394175,12.357142857142858
370,514,0,8995,3394689,13.891891891891891
190,287,0,8996,3394976,15.105263157894736
290,403,0,8997,3395379,13.89655172413793
400,603,0,8998,3395982,15.075
70,102,0,8999,3396084,14.571428571428571
200,211,0,9000,3396295,10.55
300,486,0,9001,3396781,16.2
360,597,0,9002,3397378,16.583333333333332
180,196,0,9003,3397574,10.88888888888889
210,268,0,9004,3397842,12.761904761904763
250,412,0,9005,3398254,16.48
410,622,0,9006,3398876,15.170731707317072
130,187,0,9007,3399063,14.384615384615385
440,648,0,9008,3399711,14.727272727272727
170,263,0,9009,3399974,15.470588235294118
440,722,0,9010,3400696,16.40909090909091
200,292,0,9011,3400988,14.6
180,277,0,9012,3401265,15.38888888888889
200,262,0,9013,3401527,13.1
270,435,0,9014,3401962,16.11111111111111
260,387,0,9015,3402349,14.884615384615385
140,202,0,9016,3402551,14.428571428571429
340,563,0,9017,3403114,16.558823529411764
120,157,0,9018,3403271,13.083333333333334
350,532,0,9019,3403803,15.2
320,532,0,9020,3404335,16.625
210,250,0,9021,3404585,11.904761904761905
200,269,0,9022,3404854,13.45
160,190,0,9023,3405044,11.875
400,704,0,9024,3405748,17.6
360,560,0,9025,3406308,15.555555555555555
120,216,0,9026,3406524,18.0
150,203,0,9027,3406727,13.533333333333333
340,548,0,9028,3407275,16.11764705882353
200,273,0,9029,3407548,13.65
240,309,0,9030,3407857,12.875
300,549,0,9031,3408406,18.3
300,439,0,9032,3408845,14.633333333333333
300,350,0,9033,3409195,11.666666666666666
110,93,0,9034,3409288,8.454545454545455
90,117,0,9035,3409405,13.0
220,315,0,9036,3409720,14.318181818181818
540,868,0,9037,3410588,16.074074074074073
350,496,0,9038,3411084,14.17142857142857
220,270,0,9039,3411354,12.272727272727273
150,224,0,9040,3411578,14.933333333333334
250,319,0,9041,3411897,12.76
110,145,0,9042,3412042,13.181818181818182
260,394,0,9043,3412436,15.153846153846153
120,168,0,9044,3412604,14.0
240,459,0,9045,3413063,19.125
260,382,0,9046,3413445,14.692307692307692
200,285,0,9047,3413730,14.25
150,197,0,9048,3413927,13.133333333333333
310,445,0,9049,3414372,14.35483870967742
180,295,0,9050,3414667,16.38888888888889
410,686,0,9051,3415353,16.73170731707317
380,536,0,9052,3415889,14.105263157894736
440,609,0,9053,3416498,13.840909090909092
170,214,0,9054,3416712,12.588235294117647
140,216,0,9055,3416928,15.428571428571429
210,286,0,9056,3417214,13.619047619047619
120,178,0,9057,3417392,14.833333333333334
140,244,0,9058,3417636,17.428571428571427
220,282,0,9059,3417918,12.818181818181818
330,500,0,9060,3418418,15.151515151515152
190,308,0,9061,3418726,16.210526315789473
230,354,0,9062,3419080,15.391304347826088
270,450,0,9063,3419530,16.666666666666668
240,400,0,9064,3419930,16.666666666666668
240,299,0,9065,3420229,12.458333333333334
360,486,0,9066,3420715,13.5
130,179,0,9067,3420894,13.76923076923077
320,381,0,9068,3421275,11.90625
240,364,0,9069,3421639,15.166666666666666
180,226,0,9070,3421865,12.555555555555555
440,674,0,9071,3422539,15.318181818181818
100,138,0,9072,3422677,13.8
240,365,0,9073,3423042,15.208333333333334
200,307,0,9074,3423349,15.35
280,419,0,9075,3423768,14.964285714285714
420,696,0,9076,3424464,16.571428571428573
280,399,0,9077,3424863,14.25
390,636,0,9078,3425499,16.307692307692307
440,639,0,9079,3426138,14.522727272727273
260,346,0,9080,3426484,13.307692307692308
300,393,0,9081,3426877,13.1
310,413,0,9082,3427290,13.32258064516129
290,415,0,9083,3427705,14.310344827586206
280,418,0,9084,3428123,14.928571428571429
160,209,0,9085,3428332,13.0625
170,233,0,9086,3428565,13.705882352941176
280,363,0,9087,3428928,12.964285714285714
270,352,0,9088,3429280,13.037037037037036
160,193,0,9089,3429473,12.0625
310,544,0,9090,3430017,17.548387096774192
240,347,0,9091,3430364,14.458333333333334
360,558,0,9092,3430922,15.5
270,361,0,9093,3431283,13.37037037037037
280,493,0,9094,3431776,17.607142857142858
320,485,0,9095,3432261,15.15625
280,377,0,9096,3432638,13.464285714285714
500,862,0,9097,3433500,17.24
210,272,0,9098,3433772,12.952380952380953
190,266,0,9099,3434038,14.0
350,468,0,9100,3434506,13.371428571428572
480,838,0,9101,3435344,17.458333333333332
310,542,0,9102,3435886,17.483870967741936
220,354,0,9103,3436240,16.09090909090909
180,263,0,9104,3436503,14.61111111111111
200,264,0,9105,3436767,13.2
320,490,0,9106,3437257,15.3125
170,234,0,9107,3437491,13.764705882352942
250,330,0,9108,3437821,13.2
180,245,0,9109,3438066,13.61111111111111
340,516,0,9110,3438582,15.176470588235293
250,400,0,9111,3438982,16.0
300,496,0,9112,3439478,16.533333333333335
230,295,0,9113,3439773,12.826086956521738
80,96,0,9114,3439869,12.0
210,244,0,9115,3440113,11.619047619047619
50,57,0,9116,3440170,11.4
480,825,0,9117,3440995,17.1875
200,319,0,9118,3441314,15.95
340,489,0,9119,3441803,14.382352941176471
200,277,0,9120,3442080,13.85
100,133,0,9121,3442213,13.3
260,403,0,9122,3442616,15.5
180,267,0,9123,3442883,14.833333333333334
230,382,0,9124,3443265,16.608695652173914
210,269,0,9125,3443534,12.80952380952381
370,582,0,9126,3444116,15.72972972972973
240,405,0,9127,3444521,16.875
220,363,0,9128,3444884,16.5
190,281,0,9129,3445165,14.789473684210526
190,296,0,9130,3445461,15.578947368421053
330,518,0,9131,3445979,15.696969696969697
200,285,0,9132,3446264,14.25
190,320,0,9133,3446584,16.842105263157894
160,206,0,9134,3446790,12.875
260,416,0,9135,3447206,16.0
280,403,0,9136,3447609,14.392857142857142
300,418,0,9137,3448027,13.933333333333334
330,551,0,9138,3448578,16.696969696969695
220,313,0,9139,3448891,14.227272727272727
160,235,0,9140,3449126,14.6875
230,304,0,9141,3449430,13.217391304347826
130,199,0,9142,3449629,15.307692307692308
270,365,0,9143,3449994,13.518518518518519
290,465,0,9144,3450459,16.03448275862069
180,262,0,9145,3450721,14.555555555555555
150,250,0,9146,3450971,16.666666666666668
130,171,0,9147,3451142,13.153846153846153
160,217,0,9148,3451359,13.5625
440,829,0,9149,3452188,18.84090909090909
220,310,0,9150,3452498,14.090909090909092
230,435,0,9151,3452933,18.91304347826087
300,391,0,9152,3453324,13.033333333333333
160,242,0,9153,3453566,15.125
210,297,0,9154,3453863,14.142857142857142
190,234,0,9155,3454097,12.31578947368421
180,269,0,9156,3454366,14.944444444444445
110,145,0,9157,3454511,13.181818181818182
180,236,0,9158,3454747,13.11111111111111
60,70,0,9159,3454817,11.666666666666666
240,292,0,9160,3455109,12.166666666666666
380,582,0,9161,3455691,15.31578947368421
350,476,0,9162,3456167,13.6
220,390,0,9163,3456557,17.727272727272727
250,400,0,9164,3456957,16.0
170,233,0,9165,3457190,13.705882352941176
380,551,0,9166,3457741,14.5
240,343,0,9167,3458084,14.291666666666666
230,241,0,9168,3458325,10.478260869565217
120,139,0,9169,3458464,11.583333333333334
130,216,0,9170,3458680,16.615384615384617
250,405,0,9171,3459085,16.2
290,412,0,9172,3459497,14.206896551724139
220,308,0,9173,3459805,14.0
380,659,0,9174,3460464,17.342105263157894
230,318,0,9175,3460782,13.826086956521738
280,416,0,9176,3461198,14.857142857142858
350,542,0,9177,3461740,15.485714285714286
280,452,0,9178,3462192,16.142857142857142
240,337,0,9179,3462529,14.041666666666666
100,125,0,9180,3462654,12.5
200,218,0,9181,3462872,10.9
400,639,0,9182,3463511,15.975
220,319,0,9183,3463830,14.5
220,285,0,9184,3464115,12.954545454545455
160,216,0,9185,3464331,13.5
150,236,0,9186,3464567,15.733333333333333
360,663,0,9187,3465230,18.416666666666668
280,331,0,9188,3465561,11.821428571428571
220,326,0,9189,3465887,14.818181818181818
540,963,0,9190,3466850,17.833333333333332
350,552,0,9191,3467402,15.771428571428572
200,308,0,9192,3467710,15.4
350,568,0,9193,3468278,16.228571428571428
360,564,0,9194,3468842,15.666666666666666
180,275,0,9195,3469117,15.277777777777779
270,439,0,9196,3469556,16.25925925925926
220,360,0,9197,3469916,16.363636363636363
110,156,0,9198,3470072,14.181818181818182
210,337,0,9199,3470409,16.047619047619047
440,871,0,9200,3471280,19.795454545454547
260,361,0,9201,3471641,13.884615384615385
180,256,0,9202,3471897,14.222222222222221
260,284,0,9203,3472181,10.923076923076923
380,533,0,9204,3472714,14.026315789473685
240,350,0,9205,3473064,14.583333333333334
190,236,0,9206,3473300,12.421052631578947
100,117,0,9207,3473417,11.7
190,281,0,9208,3473698,14.789473684210526
400,492,0,9209,3474190,12.3
190,276,0,9210,3474466,14.526315789473685
310,476,0,9211,3474942,15.35483870967742
160,193,0,9212,3475135,12.0625
220,274,0,9213,3475409,12.454545454545455
130,178,0,9214,3475587,13.692307692307692
260,416,0,9215,3476003,16.0
150,192,0,9216,3476195,12.8
310,515,0,9217,3476710,16.612903225806452
120,199,0,9218,3476909,16.583333333333332
300,441,0,9219,3477350,14.7
370,607,0,9220,3477957,16.405405405405407
560,939,0,9221,3478896,16.767857142857142
330,442,0,9222,3479338,13.393939393939394
160,220,0,9223,3479558,13.75
210,330,0,9224,3479888,15.714285714285714
220,281,0,9225,3480169,12.772727272727273
540,956,0,9226,3481125,17.703703703703702
470,784,0,9227,3481909,16.680851063829788
210,330,0,9228,3482239,15.714285714285714
290,432,0,9229,3482671,14.89655172413793
440,616,0,9230,3483287,14.0
300,472,0,9231,3483759,15.733333333333333
120,152,0,9232,3483911,12.666666666666666
270,367,0,9233,3484278,13.592592592592593
190,238,0,9234,3484516,12.526315789473685
150,167,0,9235,3484683,11.133333333333333
290,440,0,9236,3485123,15.172413793103448
390,609,0,9237,3485732,15.615384615384615
200,272,0,9238,3486004,13.6
170,212,0,9239,3486216,12.470588235294118
240,310,0,9240,3486526,12.916666666666666
280,443,0,9241,3486969,15.821428571428571
300,428,0,9242,3487397,14.266666666666667
310,459,0,9243,3487856,14.806451612903226
280,351,0,9244,3488207,12.535714285714286
200,266,0,9245,3488473,13.3
350,530,0,9246,3489003,15.142857142857142
360,542,0,9247,3489545,15.055555555555555
100,150,0,9248,3489695,15.0
200,271,0,9249,3489966,13.55
190,248,0,9250,3490214,13.052631578947368
150,176,0,9251,3490390,11.733333333333333
260,407,0,9252,3490797,15.653846153846153
280,419,0,9253,3491216,14.964285714285714
120,175,0,9254,3491391,14.583333333333334
220,270,0,9255,3491661,12.272727272727273
140,180,0,9256,3491841,12.857142857142858
140,145,0,9257,3491986,10.357142857142858
450,759,0,9258,3492745,16.866666666666667
290,467,0,9259,3493212,16.103448275862068
420,662,0,9260,3493874,15.761904761904763
150,186,0,9261,3494060,12.4
340,519,0,9262,3494579,15.264705882352942
260,403,0,9263,3494982,15.5
210,303,0,9264,3495285,14.428571428571429
80,69,0,9265,3495354,8.625
290,398,0,9266,3495752,13.724137931034482
180,242,0,9267,3495994,13.444444444444445
360,554,0,9268,3496548,15.38888888888889
150,193,0,9269,3496741,12.866666666666667
190,293,0,9270,3497034,15.421052631578947
200,327,0,9271,3497361,16.35
380,577,0,9272,3497938,15.18421052631579
270,419,0,9273,3498357,15.518518518518519
310,509,0,9274,3498866,16.419354838709676
280,429,0,9275,3499295,15.321428571428571
390,646,0,9276,3499941,16.564102564102566
130,178,0,9277,3500119,13.692307692307692
210,284,0,9278,3500403,13.523809523809524
80,83,0,9279,3500486,10.375
210,274,0,9280,3500760,13.047619047619047
120,182,0,9281,3500942,15.166666666666666
250,308,0,9282,3501250,12.32
200,293,0,9283,3501543,14.65
230,333,0,9284,3501876,14.478260869565217
390,628,0,9285,3502504,16.102564102564102
220,341,0,9286,3502845,15.5
260,357,0,9287,3503202,13.73076923076923
300,503,0,9288,3503705,16.766666666666666
180,227,0,9289,3503932,12.61111111111111
190,256,0,9290,3504188,13.473684210526315
320,519,0,9291,3504707,16.21875
240,392,0,9292,3505099,16.333333333333332
310,484,0,9293,3505583,15.612903225806452
240,278,0,9294,3505861,11.583333333333334
120,170,0,9295,3506031,14.166666666666666
260,380,0,9296,3506411,14.615384615384615
250,366,0,9297,3506777,14.64
430,586,0,9298,3507363,13.627906976744185
370,577,0,9299,3507940,15.594594594594595
240,306,0,9300,3508246,12.75
330,510,0,9301,3508756,15.454545454545455
90,140,0,9302,3508896,15.555555555555555
120,149,0,9303,3509045,12.416666666666666
310,548,0,9304,3509593,17.677419354838708
280,432,0,9305,3510025,15.428571428571429
280,478,0,9306,3510503,17.071428571428573
180,296,0,9307,3510799,16.444444444444443
100,148,0,9308,3510947,14.8
200,343,0,9309,3511290,17.15
70,104,0,9310,3511394,14.857142857142858
180,258,0,9311,3511652,14.333333333333334
150,192,0,9312,3511844,12.8
210,287,0,9313,3512131,13.666666666666666
250,333,0,9314,3512464,13.32
320,422,0,9315,3512886,13.1875
160,238,0,9316,3513124,14.875
220,263,0,9317,3513387,11.954545454545455
270,405,0,9318,3513792,15.0
280,394,0,9319,3514186,14.071428571428571
310,431,0,9320,3514617,13.903225806451612
210,339,0,9321,3514956,16.142857142857142
420,631,0,9322,3515587,15.023809523809524
400,703,0,9323,3516290,17.575
240,358,0,9324,3516648,14.916666666666666
50,77,0,9325,3516725,15.4
390,657,0,9326,3517382,16.846153846153847
210,341,0,9327,3517723,16.238095238095237
120,173,0,9328,3517896,14.416666666666666
210,286,0,9329,3518182,13.619047619047619
320,531,0,9330,3518713,16.59375
260,358,0,9331,3519071,13.76923076923077
250,324,0,9332,3519395,12.96
180,202,0,9333,3519597,11.222222222222221
260,406,0,9334,3520003,15.615384615384615
190,267,0,9335,3520270,14.052631578947368
240,392,0,9336,3520662,16.333333333333332
160,250,0,9337,3520912,15.625
210,335,0,9338,3521247,15.952380952380953
320,433,0,9339,3521680,13.53125
80,95,0,9340,3521775,11.875
140,149,0,9341,3521924,10.642857142857142
120,173,0,9342,3522097,14.416666666666666
290,447,0,9343,3522544,15.413793103448276
340,505,0,9344,3523049,14.852941176470589
130,155,0,9345,3523204,11.923076923076923
440,705,0,9346,3523909,16.022727272727273
250,366,0,9347,3524275,14.64
170,252,0,9348,3524527,14.823529411764707
370,664,0,9349,3525191,17.945945945945947
220,263,0,9350,3525454,11.954545454545455
310,542,0,9351,3525996,17.483870967741936
100,103,0,9352,3526099,10.3
290,434,0,9353,3526533,14.96551724137931
210,296,0,9354,3526829,14.095238095238095
360,589,0,9355,3527418,16.36111111111111
190,276,0,9356,3527694,14.526315789473685
160,215,0,9357,3527909,13.4375
240,372,0,9358,3528281,15.5
440,672,0,9359,3528953,15.272727272727273
270,500,0,9360,3529453,18.51851851851852
140,200,0,9361,3529653,14.285714285714286
470,736,0,9362,3530389,15.659574468085106
310,433,0,9363,3530822,13.96774193548387
290,438,0,9364,3531260,15.10344827586207
400,574,0,9365,3531834,14.35
140,210,0,9366,3532044,15.0
350,577,0,9367,3532621,16.485714285714284
170,167,0,9368,3532788,9.823529411764707
110,128,0,9369,3532916,11.636363636363637
300,430,0,9370,3533346,14.333333333333334
60,79,0,9371,3533425,13.166666666666666
130,151,0,9372,3533576,11.615384615384615
130,218,0,9373,3533794,16.76923076923077
220,349,0,9374,3534143,15.863636363636363
210,325,0,9375,3534468,15.476190476190476
240,304,0,9376,3534772,12.666666666666666
300,462,0,9377,3535234,15.4
210,269,0,9378,3535503,12.80952380952381
310,474,0,9379,3535977,15.290322580645162
150,213,0,9380,3536190,14.2
220,307,0,9381,3536497,13.954545454545455
380,550,0,9382,3537047,14.473684210526315
220,363,0,9383,3537410,16.5
400,700,0,9384,3538110,17.5
100,112,0,9385,3538222,11.2
140,175,0,9386,3538397,12.5
240,410,0,9387,3538807,17.083333333333332
120,236,0,9388,3539043,19.666666666666668
490,785,0,9389,3539828,16.020408163265305
320,482,0,9390,3540310,15.0625
340,530,0,9391,3540840,15.588235294117647
90,123,0,9392,3540963,13.666666666666666
220,343,0,9393,3541306,15.590909090909092
140,158,0,9394,3541464,11.285714285714286
190,347,0,9395,3541811,18.263157894736842
200,281,0,9396,3542092,14.05
110,124,0,9397,3542216,11.272727272727273
350,529,0,9398,3542745,15.114285714285714
180,291,0,9399,3543036,16.166666666666668
190,208,0,9400,3543244,10.947368421052632
310,438,0,9401,3543682,14.129032258064516
200,304,0,9402,3543986,15.2
240,373,0,9403,3544359,15.541666666666666
320,472,0,9404,3544831,14.75
120,135,0,9405,3544966,11.25
130,179,0,9406,3545145,13.76923076923077
250,298,0,9407,3545443,11.92
180,224,0,9408,3545667,12.444444444444445
330,434,0,9409,3546101,13.151515151515152
380,569,0,9410,3546670,14.973684210526315
240,392,0,9411,3547062,16.333333333333332
200,316,0,9412,3547378,15.8
140,218,0,9413,3547596,15.571428571428571
130,199,0,9414,3547795,15.307692307692308
280,428,0,9415,3548223,15.285714285714286
310,449,0,9416,3548672,14.483870967741936
190,296,0,9417,3548968,15.578947368421053
110,182,0,9418,3549150,16.545454545454547
430,679,0,9419,3549829,15.790697674418604
160,207,0,9420,3550036,12.9375
130,172,0,9421,3550208,13.23076923076923
240,349,0,9422,3550557,14.541666666666666
380,613,0,9423,3551170,16.13157894736842
320,447,0,9424,3551617,13.96875
80,111,0,9425,3551728,13.875
100,91,0,9426,3551819,9.1
330,574,0,9427,3552393,17.393939393939394
140,180,0,9428,3552573,12.857142857142858
400,600,0,9429,3553173,15.0
250,419,0,9430,3553592,16.76
150,233,0,9431,3553825,15.533333333333333
240,373,0,9432,3554198,15.541666666666666
400,577,0,9433,3554775,14.425
150,198,0,9434,3554973,13.2
320,526,0,9435,3555499,16.4375
270,455,0,9436,3555954,16.85185185185185
210,233,0,9437,3556187,11.095238095238095
240,393,0,9438,3556580,16.375
130,152,0,9439,3556732,11.692307692307692
200,329,0,9440,3557061,16.45
170,252,0,9441,3557313,14.823529411764707
250,388,0,9442,3557701,15.52
340,572,0,9443,3558273,16.823529411764707
360,678,0,9444,3558951,18.833333333333332
250,376,0,9445,3559327,15.04
270,349,0,9446,3559676,12.925925925925926
350,565,0,9447,3560241,16.142857142857142
520,844,0,9448,3561085,16.23076923076923
210,298,0,9449,3561383,14.19047619047619
300,346,0,9450,3561729,11.533333333333333
180,258,0,9451,3561987,14.333333333333334
210,346,0,9452,3562333,16.476190476190474
300,479,0,9453,3562812,15.966666666666667
260,372,0,9454,3563184,14.307692307692308
250,404,0,9455,3563588,16.16
170,196,0,9456,3563784,11.529411764705882
320,478,0,9457,3564262,14.9375
290,424,0,9458,3564686,14.620689655172415
270,457,0,9459,3565143,16.925925925925927
260,384,0,9460,3565527,14.76923076923077
280,450,0,9461,3565977,16.071428571428573
70,65,0,9462,3566042,9.285714285714286
70,106,0,9463,3566148,15.142857142857142
180,222,0,9464,3566370,12.333333333333334
160,243,0,9465,3566613,15.1875
150,249,0,9466,3566862,16.6
190,283,0,9467,3567145,14.894736842105264
310,501,0,9468,3567646,16.161290322580644
150,237,0,9469,3567883,15.8
270,382,0,9470,3568265,14.148148148148149
130,174,0,9471,3568439,13.384615384615385
280,385,0,9472,3568824,13.75
380,584,0,9473,3569408,15.368421052631579
210,291,0,9474,3569699,13.857142857142858
520,938,0,9475,3570637,18.03846153846154
360,561,0,9476,3571198,15.583333333333334
110,164,0,9477,3571362,14.909090909090908
370,563,0,9478,3571925,15.216216216216216
210,289,0,9479,3572214,13.761904761904763
130,177,0,9480,3572391,13.615384615384615
210,319,0,9481,3572710,15.19047619047619
210,326,0,9482,3573036,15.523809523809524
280,417,0,9483,3573453,14.892857142857142
430,692,0,9484,3574145,16.093023255813954
250,353,0,9485,3574498,14.12
180,272,0,9486,3574770,15.11111111111111
220,527,0,9487,3575297,23.954545454545453
280,392,0,9488,3575689,14.0
320,513,0,9489,3576202,16.03125
100,108,0,9490,3576310,10.8
440,666,0,9491,3576976,15.136363636363637
230,382,0,9492,3577358,16.608695652173914
170,243,0,9493,3577601,14.294117647058824
80,109,0,9494,3577710,13.625
290,444,0,9495,3578154,15.310344827586206
430,676,0,9496,3578830,15.720930232558139
110,165,0,9497,3578995,15.0
280,486,0,9498,3579481,17.357142857142858
150,224,0,9499,3579705,14.933333333333334
250,364,0,9500,3580069,14.56
300,401,0,9501,3580470,13.366666666666667
60,84,0,9502,3580554,14.0
410,583,0,9503,3581137,14.21951219512195
380,604,0,9504,3581741,15.894736842105264
250,379,0,9505,3582120,15.16
330,518,0,9506,3582638,15.696969696969697
230,303,0,9507,3582941,13.173913043478262
380,532,0,9508,3583473,14.0
270,432,0,9509,3583905,16.0
180,224,0,9510,3584129,12.444444444444445
330,547,0,9511,3584676,16.575757575757574
290,498,0,9512,3585174,17.17241379310345
420,706,0,9513,3585880,16.80952380952381
180,263,0,9514,3586143,14.61111111111111
310,477,0,9515,3586620,15.387096774193548
240,385,0,9516,3587005,16.041666666666668
120,152,0,9517,3587157,12.666666666666666
170,217,0,9518,3587374,12.764705882352942
290,419,0,9519,3587793,14.448275862068966
470,722,0,9520,3588515,15.361702127659575
310,485,0,9521,3589000,15.64516129032258
340,600,0,9522,3589600,17.647058823529413
90,84,0,9523,3589684,9.333333333333334
330,543,0,9524,3590227,16.454545454545453
350,561,0,9525,3590788,16.02857142857143
230,359,0,9526,3591147,15.608695652173912
340,478,0,9527,3591625,14.058823529411764
340,524,0,9528,3592149,15.411764705882353
230,316,0,9529,3592465,13.73913043478261
310,491,0,9530,3592956,15.838709677419354
300,406,0,9531,3593362,13.533333333333333
430,608,0,9532,3593970,14.13953488372093
250,373,0,9533,3594343,14.92
150,198,0,9534,3594541,13.2
190,267,0,9535,3594808,14.052631578947368
230,364,0,9536,3595172,15.826086956521738
390,517,0,9537,3595689,13.256410256410257
200,317,0,9538,3596006,15.85
230,315,0,9539,3596321,13.695652173913043
380,525,0,9540,3596846,13.81578947368421
110,183,0,9541,3597029,16.636363636363637
240,331,0,9542,3597360,13.791666666666666
400,671,0,9543,3598031,16.775
480,956,0,9544,3598987,19.916666666666668
330,607,0,9545,3599594,18.393939393939394
380,645,0,9546,3600239,16.973684210526315
190,292,0,9547,3600531,15.368421052631579
360,570,0,9548,3601101,15.833333333333334
310,541,0,9549,3601642,17.451612903225808
460,820,0,9550,3602462,17.82608695652174
220,359,0,9551,3602821,16.318181818181817
330,631,0,9552,3603452,19.12121212121212
310,500,0,9553,3603952,16.129032258064516
290,480,0,9554,3604432,16.551724137931036
110,123,0,9555,3604555,11.181818181818182
90,118,0,9556,3604673,13.11111111111111
180,327,0,9557,3605000,18.166666666666668
330,453,0,9558,3605453,13.727272727272727
300,388,0,9559,3605841,12.933333333333334
160,197,0,9560,3606038,12.3125
150,250,0,9561,3606288,16.666666666666668
200,297,0,9562,3606585,14.85
180,219,0,9563,3606804,12.166666666666666
360,596,0,9564,3607400,16.555555555555557
200,260,0,9565,3607660,13.0
190,258,0,9566,3607918,13.578947368421053
360,518,0,9567,3608436,14.38888888888889
290,448,0,9568,3608884,15.448275862068966
540,930,0,9569,3609814,17.22222222222222
410,776,0,9570,3610590,18.926829268292682
240,318,0,9571,3610908,13.25
130,207,0,9572,3611115,15.923076923076923
250,388,0,9573,3611503,15.52
380,576,0,9574,3612079,15.157894736842104
380,645,0,9575,3612724,16.973684210526315
320,462,0,9576,3613186,14.4375
520,753,0,9577,3613939,14.48076923076923
120,166,0,9578,3614105,13.833333333333334
90,126,0,9579,3614231,14.0
320,511,0,9580,3614742,15.96875
220,274,0,9581,3615016,12.454545454545455
120,172,0,9582,3615188,14.333333333333334
60,88,0,9583,3615276,14.666666666666666
370,549,0,9584,3615825,14.837837837837839
500,798,0,9585,3616623,15.96
200,341,0,9586,3616964,17.05
120,156,0,9587,3617120,13.0
450,731,0,9588,3617851,16.244444444444444
200,317,0,9589,3618168,15.85
230,339,0,9590,3618507,14.73913043478261
230,339,0,9591,3618846,14.73913043478261
440,667,0,9592,3619513,15.159090909090908
180,298,0,9593,3619811,16.555555555555557
250,363,0,9594,3620174,14.52
480,869,0,9595,3621043,18.104166666666668
270,448,0,9596,3621491,16.59259259259259
110,171,0,9597,3621662,15.545454545454545
250,390,0,9598,3622052,15.6
160,242,0,9599,3622294,15.125
300,444,0,9600,3622738,14.8
230,349,0,9601,3623087,15.173913043478262
340,596,0,9602,3623683,17.529411764705884
120,149,0,9603,3623832,12.416666666666666
130,180,0,9604,3624012,13.846153846153847
220,387,0,9605,3624399,17.59090909090909
330,642,0,9606,3625041,19.454545454545453
340,558,0,9607,3625599,16.41176470588235
260,398,0,9608,3625997,15.307692307692308
460,896,0,9609,3626893,19.47826086956522
580,1056,0,9610,3627949,18.20689655172414
150,204,0,9611,3628153,13.6
270,415,0,9612,3628568,15.37037037037037
180,269,0,9613,3628837,14.944444444444445
210,318,0,9614,3629155,15.142857142857142
260,372,0,9615,3629527,14.307692307692308
380,695,0,9616,3630222,18.289473684210527
180,220,0,9617,3630442,12.222222222222221
110,133,0,9618,3630575,12.090909090909092
250,390,0,9619,3630965,15.6
210,279,0,9620,3631244,13.285714285714286
180,245,0,9621,3631489,13.61111111111111
330,500,0,9622,3631989,15.151515151515152
270,427,0,9623,3632416,15.814814814814815
230,292,0,9624,3632708,12.695652173913043
300,503,0,9625,3633211,16.766666666666666
330,497,0,9626,3633708,15.06060606060606
150,164,0,9627,3633872,10.933333333333334
150,197,0,9628,3634069,13.133333333333333
390,694,0,9629,3634763,17.794871794871796
380,677,0,9630,3635440,17.81578947368421
160,200,0,9631,3635640,12.5
140,217,0,9632,3635857,15.5
290,374,0,9633,3636231,12.89655172413793
410,607,0,9634,3636838,14.804878048780488
160,202,0,9635,3637040,12.625
320,533,0,9636,3637573,16.65625
260,380,0,9637,3637953,14.615384615384615
250,338,0,9638,3638291,13.52
250,322,0,9639,3638613,12.88
220,276,0,9640,3638889,12.545454545454545
170,250,0,9641,3639139,14.705882352941176
250,431,0,9642,3639570,17.24
250,400,0,9643,3639970,16.0
370,583,0,9644,3640553,15.756756756756756
240,367,0,9645,3640920,15.291666666666666
500,798,0,9646,3641718,15.96
270,296,0,9647,3642014,10.962962962962964
330,520,0,9648,3642534,15.757575757575758
390,683,0,9649,3643217,17.512820512820515
380,615,0,9650,3643832,16.18421052631579
230,303,0,9651,3644135,13.173913043478262
260,358,0,9652,3644493,13.76923076923077
170,248,0,9653,3644741,14.588235294117647
320,408,0,9654,3645149,12.75
230,326,0,9655,3645475,14.173913043478262
370,659,0,9656,3646134,17.81081081081081
310,450,0,9657,3646584,14.516129032258064
180,269,0,9658,3646853,14.944444444444445
180,252,0,9659,3647105,14.0
190,291,0,9660,3647396,15.31578947368421
280,581,0,9661,3647977,20.75
300,507,0,9662,3648484,16.9
160,223,0,9663,3648707,13.9375
520,855,0,9664,3649562,16.442307692307693
180,307,0,9665,3649869,17.055555555555557
250,384,0,9666,3650253,15.36
100,152,0,9667,3650405,15.2
280,396,0,9668,3650801,14.142857142857142
210,323,0,9669,3651124,15.380952380952381
200,285,0,9670,3651409,14.25
140,165,0,9671,3651574,11.785714285714286
480,868,0,9672,3652442,18.083333333333332
440,576,0,9673,3653018,13.090909090909092
360,527,0,9674,3653545,14.63888888888889
230,285,0,9675,3653830,12.391304347826088
220,266,0,9676,3654096,12.090909090909092
430,603,0,9677,3654699,14.023255813953488
210,305,0,9678,3655004,14.523809523809524
170,215,0,9679,3655219,12.647058823529411
270,413,0,9680,3655632,15.296296296296296
360,589,0,9681,3656221,16.36111111111111
200,343,0,9682,3656564,17.15
290,413,0,9683,3656977,14.241379310344827
270,425,0,9684,3657402,15.74074074074074
210,315,0,9685,3657717,15.0
110,163,0,9686,3657880,14.818181818181818
400,651,0,9687,3658531,16.275
260,415,0,9688,3658946,15.961538461538462
270,408,0,9689,3659354,15.11111111111111
340,538,0,9690,3659892,15.823529411764707
230,399,0,9691,3660291,17.347826086956523
390,651,0,9692,3660942,16.692307692307693
140,237,0,9693,3661179,16.928571428571427
530,731,0,9694,3661910,13.79245283018868
320,473,0,9695,3662383,14.78125
180,257,0,9696,3662640,14.277777777777779
250,337,0,9697,3662977,13.48
230,349,0,9698,3663326,15.173913043478262
100,142,0,9699,3663468,14.2
220,355,0,9700,3663823,16.136363636363637
280,409,0,9701,3664232,14.607142857142858
230,331,0,9702,3664563,14.391304347826088
310,521,0,9703,3665084,16.806451612903224
320,403,0,9704,3665487,12.59375
260,420,0,9705,3665907,16.153846153846153
340,519,0,9706,3666426,15.264705882352942
70,75,0,9707,3666501,10.714285714285714
270,393,0,9708,3666894,14.555555555555555
240,376,0,9709,3667270,15.666666666666666
190,263,0,9710,3667533,13.842105263157896
210,317,0,9711,3667850,15.095238095238095
120,188,0,9712,3668038,15.666666666666666
220,325,0,9713,3668363,14.772727272727273
350,582,0,9714,3668945,16.62857142857143
260,412,0,9715,3669357,15.846153846153847
100,103,0,9716,3669460,10.3
330,480,0,9717,3669940,14.545454545454545
340,493,0,9718,3670433,14.5
220,395,0,9719,3670828,17.954545454545453
280,388,0,9720,3671216,13.857142857142858
240,353,0,9721,3671569,14.708333333333334
230,363,0,9722,3671932,15.782608695652174
130,158,0,9723,3672090,12.153846153846153
270,404,0,9724,3672494,14.962962962962964
180,257,0,9725,3672751,14.277777777777779
130,153,0,9726,3672904,11.76923076923077
200,283,0,9727,3673187,14.15
160,223,0,9728,3673410,13.9375
490,851,0,9729,3674261,17.367346938775512
330,428,0,9730,3674689,12.969696969696969
150,230,0,9731,3674919,15.333333333333334
140,217,0,9732,3675136,15.5
280,364,0,9733,3675500,13.0
330,561,0,9734,3676061,17.0
200,284,0,9735,3676345,14.2
370,569,0,9736,3676914,15.378378378378379
420,661,0,9737,3677575,15.738095238095237
190,211,0,9738,3677786,11.105263157894736
150,248,0,9739,3678034,16.533333333333335
320,518,0,9740,3678552,16.1875
170,212,0,9741,3678764,12.470588235294118
330,504,0,9742,3679268,15.272727272727273
420,669,0,9743,3679937,15.928571428571429
270,374,0,9744,3680311,13.851851851851851
310,492,0,9745,3680803,15.870967741935484
330,477,0,9746,3681280,14.454545454545455
300,439,0,9747,3681719,14.633333333333333
560,1008,0,9748,3682727,18.0
230,339,0,9749,3683066,14.73913043478261
330,443,0,9750,3683509,13.424242424242424
180,306,0,9751,3683815,17.0
410,605,0,9752,3684420,14.75609756097561
140,213,0,9753,3684633,15.214285714285714
210,258,0,9754,3684891,12.285714285714286
470,853,0,9755,3685744,18.148936170212767
450,771,0,9756,3686515,17.133333333333333
190,311,0,9757,3686826,16.36842105263158
510,823,0,9758,3687649,16.137254901960784
320,505,0,9759,3688154,15.78125
240,361,0,9760,3688515,15.041666666666666
220,298,0,9761,3688813,13.545454545454545
250,418,0,9762,3689231,16.72
220,307,0,9763,3689538,13.954545454545455
360,572,0,9764,3690110,15.88888888888889
210,316,0,9765,3690426,15.047619047619047
180,245,0,9766,3690671,13.61111111111111
300,418,0,9767,3691089,13.933333333333334
370,579,0,9768,3691668,15.64864864864865
220,317,0,9769,3691985,14.409090909090908
210,321,0,9770,3692306,15.285714285714286
210,276,0,9771,3692582,13.142857142857142
210,279,0,9772,3692861,13.285714285714286
220,357,0,9773,3693218,16.227272727272727
220,255,0,9774,3693473,11.590909090909092
260,315,0,9775,3693788,12.115384615384615
320,521,0,9776,3694309,16.28125
200,280,0,9777,3694589,14.0
330,541,0,9778,3695130,16.393939393939394
280,438,0,9779,3695568,15.642857142857142
100,125,0,9780,3695693,12.5
260,344,0,9781,3696037,13.23076923076923
270,388,0,9782,3696425,14.37037037037037
340,478,0,9783,3696903,14.058823529411764
200,219,0,9784,3697122,10.95
160,251,0,9785,3697373,15.6875
280,334,0,9786,3697707,11.928571428571429
240,389,0,9787,3698096,16.208333333333332
240,407,0,9788,3698503,16.958333333333332
150,204,0,9789,3698707,13.6
420,784,0,9790,3699491,18.666666666666668
250,374,0,9791,3699865,14.96
260,367,0,9792,3700232,14.115384615384615
420,693,0,9793,3700925,16.5
150,232,0,9794,3701157,15.466666666666667
100,152,0,9795,3701309,15.2
530,731,0,9796,3702040,13.79245283018868
130,171,0,9797,3702211,13.153846153846153
340,661,0,9798,3702872,19.441176470588236
400,573,0,9799,3703445,14.325
250,335,0,9800,3703780,13.4
260,422,0,9801,3704202,16.23076923076923
320,506,0,9802,3704708,15.8125
210,366,0,9803,3705074,17.428571428571427
280,382,0,9804,3705456,13.642857142857142
370,561,0,9805,3706017,15.162162162162161
150,207,0,9806,3706224,13.8
260,381,0,9807,3706605,14.653846153846153
170,233,0,9808,3706838,13.705882352941176
380,590,0,9809,3707428,15.526315789473685
350,509,0,9810,3707937,14.542857142857143
310,478,0,9811,3708415,15.419354838709678
160,252,0,9812,3708667,15.75
240,306,0,9813,3708973,12.75
280,445,0,9814,3709418,15.892857142857142
170,251,0,9815,3709669,14.764705882352942
230,322,0,9816,3709991,14.0
220,362,0,9817,3710353,16.454545454545453
220,314,0,9818,3710667,14.272727272727273
290,447,0,9819,3711114,15.413793103448276
70,110,0,9820,3711224,15.714285714285714
180,200,0,9821,3711424,11.11111111111111
190,253,0,9822,3711677,13.31578947368421
180,257,0,9823,3711934,14.277777777777779
90,122,0,9824,3712056,13.555555555555555
370,508,0,9825,3712564,13.72972972972973
160,274,0,9826,3712838,17.125
240,339,0,9827,3713177,14.125
260,317,0,9828,3713494,12.192307692307692
180,249,0,9829,3713743,13.833333333333334
310,465,0,9830,3714208,15.0
330,477,0,9831,3714685,14.454545454545455
160,249,0,9832,3714934,15.5625
250,300,0,9833,3715234,12.0
290,434,0,9834,3715668,14.96551724137931
110,114,0,9835,3715782,10.363636363636363
210,294,0,9836,3716076,14.0
220,367,0,9837,3716443,16.681818181818183
410,719,0,9838,3717162,17.536585365853657
270,475,0,9839,3717637,17.59259259259259
300,380,0,9840,3718017,12.666666666666666
430,595,0,9841,3718612,13.837209302325581
400,692,0,9842,3719304,17.3
350,452,0,9843,3719756,12.914285714285715
340,566,0,9844,3720322,16.647058823529413
170,229,0,9845,3720551,13.470588235294118
180,265,0,9846,3720816,14.722222222222221
60,51,0,9847,3720867,8.5
130,185,0,9848,3721052,14.23076923076923
420,688,0,9849,3721740,16.38095238095238
310,385,0,9850,3722125,12.419354838709678
100,125,0,9851,3722250,12.5
260,372,0,9852,3722622,14.307692307692308
430,640,0,9853,3723262,14.883720930232558
470,739,0,9854,3724001,15.72340425531915
110,139,0,9855,3724140,12.636363636363637
330,488,0,9856,3724628,14.787878787878787
240,334,0,9857,3724962,13.916666666666666
220,328,0,9858,3725290,14.909090909090908
360,518,0,9859,3725808,14.38888888888889
80,96,0,9860,3725904,12.0
390,687,0,9861,3726591,17.615384615384617
280,394,0,9862,3726985,14.071428571428571
250,308,0,9863,3727293,12.32
180,254,0,9864,3727547,14.11111111111111
180,255,0,9865,3727802,14.166666666666666
80,98,0,9866,3727900,12.25
110,146,0,9867,3728046,13.272727272727273
280,354,0,9868,3728400,12.642857142857142
290,458,0,9869,3728858,15.793103448275861
160,230,0,9870,3729088,14.375
280,394,0,9871,3729482,14.071428571428571
260,377,0,9872,3729859,14.5
310,421,0,9873,3730280,13.580645161290322
250,381,0,9874,3730661,15.24
260,424,0,9875,3731085,16.307692307692307
310,560,0,9876,3731645,18.06451612903226
200,275,0,9877,3731920,13.75
250,330,0,9878,3732250,13.2
240,393,0,9879,3732643,16.375
290,411,0,9880,3733054,14.172413793103448
400,677,0,9881,3733731,16.925
280,459,0,9882,3734190,16.392857142857142
110,166,0,9883,3734356,15.090909090909092
310,467,0,9884,3734823,15.064516129032258
150,216,0,9885,3735039,14.4
280,365,0,9886,3735404,13.035714285714286
360,599,0,9887,3736003,16.63888888888889
130,135,0,9888,3736138,10.384615384615385
500,910,0,9889,3737048,18.2
240,315,0,9890,3737363,13.125
210,331,0,9891,3737694,15.761904761904763
270,456,0,9892,3738150,16.88888888888889
170,214,0,9893,3738364,12.588235294117647
210,251,0,9894,3738615,11.952380952380953
190,237,0,9895,3738852,12.473684210526315
410,625,0,9896,3739477,15.24390243902439
350,507,0,9897,3739984,14.485714285714286
310,504,0,9898,3740488,16.258064516129032
220,270,0,9899,3740758,12.272727272727273
160,225,0,9900,3740983,14.0625
60,65,0,9901,3741048,10.833333333333334
230,345,0,9902,3741393,15.0
190,352,0,9903,3741745,18.526315789473685
200,298,0,9904,3742043,14.9
180,263,0,9905,3742306,14.61111111111111
480,782,0,9906,3743088,16.291666666666668
80,117,0,9907,3743205,14.625
180,271,0,9908,3743476,15.055555555555555
220,361,0,9909,3743837,16.40909090909091
200,229,0,9910,3744066,11.45
420,630,0,9911,3744696,15.0
230,352,0,9912,3745048,15.304347826086957
260,381,0,9913,3745429,14.653846153846153
220,296,0,9914,3745725,13.454545454545455
220,335,0,9915,3746060,15.227272727272727
150,199,0,9916,3746259,13.266666666666667
260,364,0,9917,3746623,14.0
170,253,0,9918,3746876,14.882352941176471
260,322,0,9919,3747198,12.384615384615385
330,557,0,9920,3747755,16.87878787878788
230,372,0,9921,3748127,16.17391304347826
320,444,0,9922,3748571,13.875
280,426,0,9923,3748997,15.214285714285714
220,313,0,9924,3749310,14.227272727272727
220,324,0,9925,3749634,14.727272727272727
280,431,0,9926,3750065,15.392857142857142
190,248,0,9927,3750313,13.052631578947368
260,425,0,9928,3750738,16.346153846153847
250,336,0,9929,3751074,13.44
140,192,0,9930,3751266,13.714285714285714
190,283,0,9931,3751549,14.894736842105264
280,500,0,9932,3752049,17.857142857142858
190,278,0,9933,3752327,14.631578947368421
300,508,0,9934,3752835,16.933333333333334
130,154,0,9935,3752989,11.846153846153847
340,532,0,9936,3753521,15.647058823529411
200,254,0,9937,3753775,12.7
150,214,0,9938,3753989,14.266666666666667
280,541,0,9939,3754530,19.321428571428573
160,203,0,9940,3754733,12.6875
150,219,0,9941,3754952,14.6
480,715,0,9942,3755667,14.895833333333334
210,302,0,9943,3755969,14.380952380952381
250,302,0,9944,3756271,12.08
320,530,0,9945,3756801,16.5625
220,330,0,9946,3757131,15.0
250,340,0,9947,3757471,13.6
70,107,0,9948,3757578,15.285714285714286
230,335,0,9949,3757913,14.565217391304348
290,665,0,9950,3758578,22.93103448275862
300,440,0,9951,3759018,14.666666666666666
240,370,0,9952,3759388,15.416666666666666
360,608,0,9953,3759996,16.88888888888889
260,404,0,9954,3760400,15.538461538461538
170,219,0,9955,3760619,12.882352941176471
320,476,0,9956,3761095,14.875
170,239,0,9957,3761334,14.058823529411764
230,289,0,9958,3761623,12.565217391304348
130,177,0,9959,3761800,13.615384615384615
290,494,0,9960,3762294,17.03448275862069
150,214,0,9961,3762508,14.266666666666667
220,341,0,9962,3762849,15.5
290,459,0,9963,3763308,15.827586206896552
210,322,0,9964,3763630,15.333333333333334
190,314,0,9965,3763944,16.526315789473685
120,167,0,9966,3764111,13.916666666666666
120,171,0,9967,3764282,14.25
270,370,0,9968,3764652,13.703703703703704
350,535,0,9969,3765187,15.285714285714286
70,121,0,9970,3765308,17.285714285714285
210,329,0,9971,3765637,15.666666666666666
240,359,0,9972,3765996,14.958333333333334
280,493,0,9973,3766489,17.607142857142858
120,195,0,9974,3766684,16.25
160,219,0,9975,3766903,13.6875
250,370,0,9976,3767273,14.8
150,206,0,9977,3767479,13.733333333333333
350,546,0,9978,3768025,15.6
380,573,0,9979,3768598,15.078947368421053
100,126,0,9980,3768724,12.6
240,324,0,9981,3769048,13.5
390,566,0,9982,3769614,14.512820512820513
140,205,0,9983,3769819,14.642857142857142
150,174,0,9984,3769993,11.6
280,436,0,9985,3770429,15.571428571428571
190,267,0,9986,3770696,14.052631578947368
340,564,0,9987,3771260,16.58823529411765
370,596,0,9988,3771856,16.10810810810811
290,440,0,9989,3772296,15.172413793103448
160,254,0,9990,3772550,15.875
320,489,0,9991,3773039,15.28125
250,405,0,9992,3773444,16.2
170,205,0,9993,3773649,12.058823529411764
390,634,0,9994,3774283,16.256410256410255
240,321,0,9995,3774604,13.375
300,423,0,9996,3775027,14.1
110,187,0,9997,3775214,17.0
100,158,0,9998,3775372,15.8
220,277,0,9999,3775649,12.590909090909092
340,532,0,10000,3776181,15.647058823529411
240,357,0,10001,3776538,14.875
530,876,0,10002,3777414,16.528301886792452
110,153,0,10003,3777567,13.909090909090908
220,306,0,10004,3777873,13.909090909090908
260,413,0,10005,3778286,15.884615384615385
190,295,0,10006,3778581,15.526315789473685
290,431,0,10007,3779012,14.862068965517242
210,306,0,10008,3779318,14.571428571428571
290,402,0,10009,3779720,13.862068965517242
280,383,0,10010,3780103,13.678571428571429
300,451,0,10011,3780554,15.033333333333333
290,448,0,10012,3781002,15.448275862068966
150,184,0,10013,3781186,12.266666666666667
280,381,0,10014,3781567,13.607142857142858
320,497,0,10015,3782064,15.53125
330,510,0,10016,3782574,15.454545454545455
180,212,0,10017,3782786,11.777777777777779
350,594,0,10018,3783380,16.97142857142857
130,171,0,10019,3783551,13.153846153846153
300,483,0,10020,3784034,16.1
170,218,0,10021,3784252,12.823529411764707
190,277,0,10022,3784529,14.578947368421053
260,472,0,10023,3785001,18.153846153846153
200,254,0,10024,3785255,12.7
210,275,0,10025,3785530,13.095238095238095
130,198,0,10026,3785728,15.23076923076923
170,294,0,10027,3786022,17.294117647058822
250,322,0,10028,3786344,12.88
430,614,0,10029,3786958,14.279069767441861
260,389,0,10030,3787347,14.961538461538462
160,191,0,10031,3787538,11.9375
300,446,0,10032,3787984,14.866666666666667
130,182,0,10033,3788166,14.0
270,428,0,10034,3788594,15.851851851851851
280,421,0,10035,3789015,15.035714285714286
220,328,0,10036,3789343,14.909090909090908
250,306,0,10037,3789649,12.24
320,421,0,10038,3790070,13.15625
270,403,0,10039,3790473,14.925925925925926
290,441,0,10040,3790914,15.206896551724139
300,420,0,10041,3791334,14.0
310,374,0,10042,3791708,12.064516129032258
270,319,0,10043,3792027,11.814814814814815
110,136,0,10044,3792163,12.363636363636363
430,685,0,10045,3792848,15.930232558139535
280,392,0,10046,3793240,14.0
260,340,0,10047,3793580,13.076923076923077
220,315,0,10048,3793895,14.318181818181818
290,345,0,10049,3794240,11.89655172413793
250,395,0,10050,3794635,15.8
200,283,0,10051,3794918,14.15
110,95,0,10052,3795013,8.636363636363637
180,242,0,10053,3795255,13.444444444444445
270,352,0,10054,3795607,13.037037037037036
190,273,0,10055,3795880,14.368421052631579
150,174,0,10056,3796054,11.6
260,446,0,10057,3796500,17.153846153846153
200,296,0,10058,3796796,14.8
150,169,0,10059,3796965,11.266666666666667
320,417,0,10060,3797382,13.03125
260,499,0,10061,3797881,19.192307692307693
250,319,0,10062,3798200,12.76
110,160,0,10063,3798360,14.545454545454545
190,276,0,10064,3798636,14.526315789473685
290,419,0,10065,3799055,14.448275862068966
270,359,0,10066,3799414,13.296296296296296
250,302,0,10067,3799716,12.08
310,414,0,10068,3800130,13.35483870967742
180,248,0,10069,3800378,13.777777777777779
300,490,0,10070,3800868,16.333333333333332
330,521,0,10071,3801389,15.787878787878787
370,568,0,10072,3801957,15.35135135135135
280,443,0,10073,3802400,15.821428571428571
80,86,0,10074,3802486,10.75
230,310,0,10075,3802796,13.478260869565217
300,461,0,10076,3803257,15.366666666666667
110,171,0,10077,3803428,15.545454545454545
370,633,0,10078,3804061,17.10810810810811
310,479,0,10079,3804540,15.451612903225806
80,126,0,10080,3804666,15.75
500,811,0,10081,3805477,16.22
140,214,0,10082,3805691,15.285714285714286
200,282,0,10083,3805973,14.1
270,395,0,10084,3806368,14.62962962962963
400,603,0,10085,3806971,15.075
220,307,0,10086,3807278,13.954545454545455
280,446,0,10087,3807724,15.928571428571429
160,248,0,10088,3807972,15.5
510,783,0,10089,3808755,15.352941176470589
140,227,0,10090,3808982,16.214285714285715
190,264,0,10091,3809246,13.894736842105264
370,554,0,10092,3809800,14.972972972972974
310,454,0,10093,3810254,14.64516129032258
150,183,0,10094,3810437,12.2
190,304,0,10095,3810741,16.0
260,440,0,10096,3811181,16.923076923076923
390,530,0,10097,3811711,13.58974358974359
110,163,0,10098,3811874,14.818181818181818
220,341,0,10099,3812215,15.5
180,281,0,10100,3812496,15.61111111111111
170,247,0,10101,3812743,14.529411764705882
170,246,0,10102,3812989,14.470588235294118
290,467,0,10103,3813456,16.103448275862068
300,458,0,10104,3813914,15.266666666666667
280,439,0,10105,3814353,15.678571428571429
330,491,0,10106,3814844,14.878787878787879
130,161,0,10107,3815005,12.384615384615385
350,564,0,10108,3815569,16.114285714285714
120,191,0,10109,3815760,15.916666666666666
160,241,0,10110,3816001,15.0625
340,566,0,10111,3816567,16.647058823529413
70,102,0,10112,3816669,14.571428571428571
340,463,0,10113,3817132,13.617647058823529
130,184,0,10114,3817316,14.153846153846153
140,179,0,10115,3817495,12.785714285714286
170,257,0,10116,3817752,15.117647058823529
290,346,0,10117,3818098,11.931034482758621
230,331,0,10118,3818429,14.391304347826088
170,258,0,10119,3818687,15.176470588235293
430,545,0,10120,3819232,12.674418604651162
350,460,0,10121,3819692,13.142857142857142
260,401,0,10122,3820093,15.423076923076923
240,381,0,10123,3820474,15.875
530,979,0,10124,3821453,18.471698113207548
160,214,0,10125,3821667,13.375
290,418,0,10126,3822085,14.413793103448276
320,468,0,10127,3822553,14.625
250,374,0,10128,3822927,14.96
270,388,0,10129,3823315,14.37037037037037
330,467,0,10130,3823782,14.151515151515152
200,277,0,10131,3824059,13.85
220,312,0,10132,3824371,14.181818181818182
290,385,0,10133,3824756,13.275862068965518
110,187,0,10134,3824943,17.0
290,452,0,10135,3825395,15.586206896551724
210,323,0,10136,3825718,15.380952380952381
150,206,0,10137,3825924,13.733333333333333
400,627,0,10138,3826551,15.675
240,335,0,10139,3826886,13.958333333333334
260,292,0,10140,3827178,11.23076923076923
230,351,0,10141,3827529,15.26086956521739
200,214,0,10142,3827743,10.7
330,529,0,10143,3828272,16.03030303030303
130,166,0,10144,3828438,12.76923076923077
80,85,0,10145,3828523,10.625
380,601,0,10146,3829124,15.81578947368421
380,490,0,10147,3829614,12.894736842105264
260,336,0,10148,3829950,12.923076923076923
290,357,0,10149,3830307,12.310344827586206
310,471,0,10150,3830778,15.193548387096774
320,550,0,10151,3831328,17.1875
190,243,0,10152,3831571,12.789473684210526
190,277,0,10153,3831848,14.578947368421053
330,481,0,10154,3832329,14.575757575757576
290,421,0,10155,3832750,14.517241379310345
260,345,0,10156,3833095,13.26923076923077
300,504,0,10157,3833599,16.8
310,482,0,10158,3834081,15.548387096774194
220,295,0,10159,3834376,13.409090909090908
260,447,0,10160,3834823,17.192307692307693
300,442,0,10161,3835265,14.733333333333333
180,274,0,10162,3835539,15.222222222222221
300,391,0,10163,3835930,13.033333333333333
90,135,0,10164,3836065,15.0
220,366,0,10165,3836431,16.636363636363637
450,679,0,10166,3837110,15.088888888888889
190,239,0,10167,3837349,12.578947368421053
380,577,0,10168,3837926,15.18421052631579
270,426,0,10169,3838352,15.777777777777779
190,252,0,10170,3838604,13.263157894736842
360,532,0,10171,3839136,14.777777777777779
480,796,0,10172,3839932,16.583333333333332
140,158,0,10173,3840090,11.285714285714286
200,308,0,10174,3840398,15.4
80,82,0,10175,3840480,10.25
390,600,0,10176,3841080,15.384615384615385
340,502,0,10177,3841582,14.764705882352942
260,393,0,10178,3841975,15.115384615384615
180,257,0,10179,3842232,14.277777777777779
180,193,0,10180,3842425,10.722222222222221
250,360,0,10181,3842785,14.4
250,313,0,10182,3843098,12.52
290,505,0,10183,3843603,17.413793103448278
230,335,0,10184,3843938,14.565217391304348
140,183,0,10185,3844121,13.071428571428571
340,569,0,10186,3844690,16.735294117647058
110,157,0,10187,3844847,14.272727272727273
280,426,0,10188,3845273,15.214285714285714
490,904,0,10189,3846177,18.448979591836736
250,370,0,10190,3846547,14.8
100,89,0,10191,3846636,8.9
370,641,0,10192,3847277,17.324324324324323
370,595,0,10193,3847872,16.08108108108108
240,393,0,10194,3848265,16.375
330,508,0,10195,3848773,15.393939393939394
130,211,0,10196,3848984,16.23076923076923
240,351,0,10197,3849335,14.625
240,354,0,10198,3849689,14.75
250,389,0,10199,3850078,15.56
90,109,0,10200,3850187,12.11111111111111
320,437,0,10201,3850624,13.65625
160,216,0,10202,3850840,13.5
390,594,0,10203,3851434,15.23076923076923
170,257,0,10204,3851691,15.117647058823529
250,416,0,10205,3852107,16.64
120,211,0,10206,3852318,17.583333333333332
220,329,0,10207,3852647,14.954545454545455
310,442,0,10208,3853089,14.258064516129032
170,241,0,10209,3853330,14.176470588235293
160,202,0,10210,3853532,12.625
150,220,0,10211,3853752,14.666666666666666
230,367,0,10212,3854119,15.956521739130435
170,223,0,10213,3854342,13.117647058823529
370,606,0,10214,3854948,16.37837837837838
260,378,0,10215,3855326,14.538461538461538
50,58,0,10216,3855384,11.6
270,385,0,10217,3855769,14.25925925925926
500,752,0,10218,3856521,15.04
170,226,0,10219,3856747,13.294117647058824
150,214,0,10220,3856961,14.266666666666667
240,348,0,10221,3857309,14.5
350,575,0,10222,3857884,16.428571428571427
180,234,0,10223,3858118,13.0
370,562,0,10224,3858680,15.18918918918919
410,580,0,10225,3859260,14.146341463414634
280,364,0,10226,3859624,13.0
180,299,0,10227,3859923,16.61111111111111
350,528,0,10228,3860451,15.085714285714285
250,379,0,10229,3860830,15.16
200,278,0,10230,3861108,13.9
170,266,0,10231,3861374,15.647058823529411
170,248,0,10232,3861622,14.588235294117647
80,100,0,10233,3861722,12.5
100,108,0,10234,3861830,10.8
340,503,0,10235,3862333,14.794117647058824
180,268,0,10236,3862601,14.88888888888889
290,462,0,10237,3863063,15.931034482758621
310,426,0,10238,3863489,13.741935483870968
180,247,0,10239,3863736,13.722222222222221
290,381,0,10240,3864117,13.137931034482758
170,276,0,10241,3864393,16.235294117647058
240,356,0,10242,3864749,14.833333333333334
280,434,0,10243,3865183,15.5
410,644,0,10244,3865827,15.707317073170731
310,410,0,10245,3866237,13.225806451612904
210,353,0,10246,3866590,16.80952380952381
180,279,0,10247,3866869,15.5
110,160,0,10248,3867029,14.545454545454545
220,292,0,10249,3867321,13.272727272727273
160,229,0,10250,3867550,14.3125
250,371,0,10251,3867921,14.84
220,351,0,10252,3868272,15.954545454545455
400,637,0,10253,3868909,15.925
230,324,0,10254,3869233,14.08695652173913
120,142,0,10255,3869375,11.833333333333334
250,418,0,10256,3869793,16.72
210,308,0,10257,3870101,14.666666666666666
120,168,0,10258,3870269,14.0
210,300,0,10259,3870569,14.285714285714286
190,245,0,10260,3870814,12.894736842105264
300,504,0,10261,3871318,16.8
210,264,0,10262,3871582,12.571428571428571
370,504,0,10263,3872086,13.621621621621621
400,663,0,10264,3872749,16.575
230,320,0,10265,3873069,13.91304347826087
300,502,0,10266,3873571,16.733333333333334
170,234,0,10267,3873805,13.764705882352942
340,469,0,10268,3874274,13.794117647058824
570,1139,0,10269,3875413,19.982456140350877
210,305,0,10270,3875718,14.523809523809524
170,226,0,10271,3875944,13.294117647058824
290,409,0,10272,3876353,14.10344827586207
140,215,0,10273,3876568,15.357142857142858
350,525,0,10274,3877093,15.0
480,836,0,10275,3877929,17.416666666666668
150,209,0,10276,3878138,13.933333333333334
220,312,0,10277,3878450,14.181818181818182
140,192,0,10278,3878642,13.714285714285714
380,492,0,10279,3879134,12.947368421052632
50,84,0,10280,3879218,16.8
200,335,0,10281,3879553,16.75
390,682,0,10282,3880235,17.487179487179485
350,567,0,10283,3880802,16.2
330,505,0,10284,3881307,15.303030303030303
240,396,0,10285,3881703,16.5
220,353,0,10286,3882056,16.045454545454547
290,445,0,10287,3882501,15.344827586206897
180,250,0,10288,3882751,13.88888888888889
360,580,0,10289,3883331,16.11111111111111
280,395,0,10290,3883726,14.107142857142858
470,770,0,10291,3884496,16.382978723404257
160,204,0,10292,3884700,12.75
160,219,0,10293,3884919,13.6875
230,329,0,10294,3885248,14.304347826086957
170,242,0,10295,3885490,14.235294117647058
420,593,0,10296,3886083,14.119047619047619
220,297,0,10297,3886380,13.5
150,182,0,10298,3886562,12.133333333333333
330,513,0,10299,3887075,15.545454545454545
230,315,0,10300,3887390,13.695652173913043
310,473,0,10301,3887863,15.258064516129032
280,407,0,10302,3888270,14.535714285714286
250,405,0,10303,3888675,16.2
410,631,0,10304,3889306,15.390243902439025
250,366,0,10305,3889672,14.64
270,381,0,10306,3890053,14.11111111111111
420,687,0,10307,3890740,16.357142857142858
220,328,0,10308,3891068,14.909090909090908
370,534,0,10309,3891602,14.432432432432432
260,372,0,10310,3891974,14.307692307692308
260,397,0,10311,3892371,15.26923076923077
220,377,0,10312,3892748,17.136363636363637
120,169,0,10313,3892917,14.083333333333334
370,684,0,10314,3893601,18.486486486486488
270,352,0,10315,3893953,13.037037037037036
240,275,0,10316,3894228,11.458333333333334
150,241,0,10317,3894469,16.066666666666666
300,428,0,10318,3894897,14.266666666666667
180,285,0,10319,3895182,15.833333333333334
490,787,0,10320,3895969,16.06122448979592
240,349,0,10321,3896318,14.541666666666666
240,410,0,10322,3896728,17.083333333333332
160,219,0,10323,3896947,13.6875
220,279,0,10324,3897226,12.681818181818182
230,324,0,10325,3897550,14.08695652173913
140,196,0,10326,3897746,14.0
160,238,0,10327,3897984,14.875
610,1000,0,10328,3898984,16.39344262295082
370,634,0,10329,3899618,17.135135135135137
300,511,0,10330,3900129,17.033333333333335
130,174,0,10331,3900303,13.384615384615385
350,532,0,10332,3900835,15.2
110,139,0,10333,3900974,12.636363636363637
80,99,0,10334,3901073,12.375
390,588,0,10335,3901661,15.076923076923077
130,165,0,10336,3901826,12.692307692307692
530,880,0,10337,3902706,16.60377358490566
220,337,0,10338,3903043,15.318181818181818
220,338,0,10339,3903381,15.363636363636363
330,594,0,10340,3903975,18.0
400,520,0,10341,3904495,13.0
130,210,0,10342,3904705,16.153846153846153
220,305,0,10343,3905010,13.863636363636363
280,452,0,10344,3905462,16.142857142857142
420,565,0,10345,3906027,13.452380952380953
150,202,0,10346,3906229,13.466666666666667
270,347,0,10347,3906576,12.851851851851851
360,608,0,10348,3907184,16.88888888888889
410,522,0,10349,3907706,12.731707317073171
210,306,0,10350,3908012,14.571428571428571
270,408,0,10351,3908420,15.11111111111111
140,201,0,10352,3908621,14.357142857142858
430,708,0,10353,3909329,16.46511627906977
240,320,0,10354,3909649,13.333333333333334
180,244,0,10355,3909893,13.555555555555555
190,311,0,10356,3910204,16.36842105263158
210,344,0,10357,3910548,16.38095238095238
190,236,0,10358,3910784,12.421052631578947
300,501,0,10359,3911285,16.7
90,125,0,10360,3911410,13.88888888888889
230,351,0,10361,3911761,15.26086956521739
260,401,0,10362,3912162,15.423076923076923
210,306,0,10363,3912468,14.571428571428571
430,700,0,10364,3913168,16.27906976744186
160,219,0,10365,3913387,13.6875
140,191,0,10366,3913578,13.642857142857142
260,296,0,10367,3913874,11.384615384615385
350,536,0,10368,3914410,15.314285714285715
290,485,0,10369,3914895,16.724137931034484
300,373,0,10370,3915268,12.433333333333334
230,341,0,10371,3915609,14.826086956521738
340,538,0,10372,3916147,15.823529411764707
230,321,0,10373,3916468,13.956521739130435
270,386,0,10374,3916854,14.296296296296296
230,450,0,10375,3917304,19.565217391304348
190,301,0,10376,3917605,15.842105263157896
240,374,0,10377,3917979,15.583333333333334
130,128,0,10378,3918107,9.846153846153847
300,427,0,10379,3918534,14.233333333333333
80,124,0,10380,3918658,15.5
290,348,0,10381,3919006,12.0
140,229,0,10382,3919235,16.357142857142858
240,354,0,10383,3919589,14.75
460,715,0,10384,3920304,15.543478260869565
400,744,0,10385,3921048,18.6
380,566,0,10386,3921614,14.894736842105264
320,417,0,10387,3922031,13.03125
200,279,0,10388,3922310,13.95
430,693,0,10389,3923003,16.11627906976744
280,474,0,10390,3923477,16.928571428571427
510,701,0,10391,3924178,13.745098039215685
110,217,0,10392,3924395,19.727272727272727
410,601,0,10393,3924996,14.658536585365853
230,310,0,10394,3925306,13.478260869565217
120,159,0,10395,3925465,13.25
170,225,0,10396,3925690,13.235294117647058
300,419,0,10397,3926109,13.966666666666667
250,290,0,10398,3926399,11.6
290,447,0,10399,3926846,15.413793103448276
290,369,0,10400,3927215,12.724137931034482
220,355,0,10401,3927570,16.136363636363637
190,259,0,10402,3927829,13.631578947368421
230,276,0,10403,3928105,12.0
370,441,0,10404,3928546,11.91891891891892
200,236,0,10405,3928782,11.8
220,340,0,10406,3929122,15.454545454545455
520,875,0,10407,3929997,16.826923076923077
70,112,0,10408,3930109,16.0
240,373,0,10409,3930482,15.541666666666666
320,408,0,10410,3930890,12.75
200,291,0,10411,3931181,14.55
460,738,0,10412,3931919,16.043478260869566
260,395,0,10413,3932314,15.192307692307692
130,197,0,10414,3932511,15.153846153846153
250,317,0,10415,3932828,12.68
280,421,0,10416,3933249,15.035714285714286
190,232,0,10417,3933481,12.210526315789474
280,430,0,10418,3933911,15.357142857142858
400,555,0,10419,3934466,13.875
460,700,0,10420,3935166,15.217391304347826
280,418,0,10421,3935584,14.928571428571429
240,417,0,10422,3936001,17.375
510,915,0,10423,3936916,17.941176470588236
460,745,0,10424,3937661,16.195652173913043
270,379,0,10425,3938040,14.037037037037036
250,372,0,10426,3938412,14.88
380,548,0,10427,3938960,14.421052631578947
110,167,0,10428,3939127,15.181818181818182
350,608,0,10429,3939735,17.37142857142857
250,386,0,10430,3940121,15.44
220,329,0,10431,3940450,14.954545454545455
230,272,0,10432,3940722,11.826086956521738
340,433,0,10433,3941155,12.735294117647058
330,525,0,10434,3941680,15.909090909090908
400,609,0,10435,3942289,15.225
210,235,0,10436,3942524,11.19047619047619
290,373,0,10437,3942897,12.862068965517242
350,491,0,10438,3943388,14.028571428571428
230,308,0,10439,3943696,13.391304347826088
350,550,0,10440,3944246,15.714285714285714
200,306,0,10441,3944552,15.3
220,303,0,10442,3944855,13.772727272727273
380,553,0,10443,3945408,14.552631578947368
190,251,0,10444,3945659,13.210526315789474
240,359,0,10445,3946018,14.958333333333334
210,380,0,10446,3946398,18.095238095238095
330,588,0,10447,3946986,17.818181818181817
270,406,0,10448,3947392,15.037037037037036
310,542,0,10449,3947934,17.483870967741936
290,498,0,10450,3948432,17.17241379310345
470,717,0,10451,3949149,15.25531914893617
280,470,0,10452,3949619,16.785714285714285
410,551,0,10453,3950170,13.439024390243903
100,186,0,10454,3950356,18.6
280,403,0,10455,3950759,14.392857142857142
320,434,0,10456,3951193,13.5625
200,297,0,10457,3951490,14.85
250,371,0,10458,3951861,14.84
170,324,0,10459,3952185,19.058823529411764
360,582,0,10460,3952767,16.166666666666668
240,317,0,10461,3953084,13.208333333333334
430,635,0,10462,3953719,14.767441860465116
270,414,0,10463,3954133,15.333333333333334
160,180,0,10464,3954313,11.25
260,314,0,10465,3954627,12.076923076923077
170,227,0,10466,3954854,13.352941176470589
510,844,0,10467,3955698,16.54901960784314
220,283,0,10468,3955981,12.863636363636363
170,234,0,10469,3956215,13.764705882352942
180,321,0,10470,3956536,17.833333333333332
230,335,0,10471,3956871,14.565217391304348
220,327,0,10472,3957198,14.863636363636363
130,202,0,10473,3957400,15.538461538461538
280,382,0,10474,3957782,13.642857142857142
240,317,0,10475,3958099,13.208333333333334
440,659,0,10476,3958758,14.977272727272727
290,479,0,10477,3959237,16.517241379310345
370,531,0,10478,3959768,14.35135135135135
190,269,0,10479,3960037,14.157894736842104
260,417,0,10480,3960454,16.03846153846154
100,155,0,10481,3960609,15.5
210,342,0,10482,3960951,16.285714285714285
200,303,0,10483,3961254,15.15
150,231,0,10484,3961485,15.4
450,705,0,10485,3962190,15.666666666666666
510,961,0,10486,3963151,18.84313725490196
380,643,0,10487,3963794,16.92105263157895
290,405,0,10488,3964199,13.96551724137931
130,147,0,10489,3964346,11.307692307692308
230,356,0,10490,3964702,15.478260869565217
270,392,0,10491,3965094,14.518518518518519
310,424,0,10492,3965518,13.67741935483871
410,595,0,10493,3966113,14.512195121951219
190,244,0,10494,3966357,12.842105263157896
150,198,0,10495,3966555,13.2
370,666,0,10496,3967221,18.0
310,446,0,10497,3967667,14.387096774193548
340,563,0,10498,3968230,16.558823529411764
160,267,0,10499,3968497,16.6875
250,332,0,10500,3968829,13.28
200,283,0,10501,3969112,14.15
260,380,0,10502,3969492,14.615384615384615
220,325,0,10503,3969817,14.772727272727273
200,300,0,10504,3970117,15.0
190,282,0,10505,3970399,14.842105263157896
340,432,0,10506,3970831,12.705882352941176
210,351,0,10507,3971182,16.714285714285715
140,161,0,10508,3971343,11.5
360,566,0,10509,3971909,15.722222222222221
160,251,0,10510,3972160,15.6875
310,462,0,10511,3972622,14.903225806451612
290,417,0,10512,3973039,14.379310344827585
130,157,0,10513,3973196,12.076923076923077
110,141,0,10514,3973337,12.818181818181818
260,398,0,10515,3973735,15.307692307692308
190,295,0,10516,3974030,15.526315789473685
210,383,0,10517,3974413,18.238095238095237
210,261,0,10518,3974674,12.428571428571429
220,315,0,10519,3974989,14.318181818181818
200,272,0,10520,3975261,13.6
180,217,0,10521,3975478,12.055555555555555
200,330,0,10522,3975808,16.5
380,591,0,10523,3976399,15.552631578947368
190,278,0,10524,3976677,14.631578947368421
160,260,0,10525,3976937,16.25
270,363,0,10526,3977300,13.444444444444445
280,448,0,10527,3977748,16.0
170,259,0,10528,3978007,15.235294117647058
460,761,0,10529,3978768,16.543478260869566
220,332,0,10530,3979100,15.090909090909092
170,196,0,10531,3979296,11.529411764705882
270,345,0,10532,3979641,12.777777777777779
260,315,0,10533,3979956,12.115384615384615
180,288,0,10534,3980244,16.0
330,508,0,10535,3980752,15.393939393939394
280,398,0,10536,3981150,14.214285714285714
320,511,0,10537,3981661,15.96875
260,449,0,10538,3982110,17.26923076923077
170,218,0,10539,3982328,12.823529411764707
330,483,0,10540,3982811,14.636363636363637
260,410,0,10541,3983221,15.76923076923077
260,389,0,10542,3983610,14.961538461538462
210,276,0,10543,3983886,13.142857142857142
300,410,0,10544,3984296,13.666666666666666
100,142,0,10545,3984438,14.2
200,304,0,10546,3984742,15.2
230,354,0,10547,3985096,15.391304347826088
180,242,0,10548,3985338,13.444444444444445
270,370,0,10549,3985708,13.703703703703704
130,242,0,10550,3985950,18.615384615384617
340,530,0,10551,3986480,15.588235294117647
380,673,0,10552,3987153,17.710526315789473
260,374,0,10553,3987527,14.384615384615385
460,655,0,10554,3988182,14.23913043478261
210,319,0,10555,3988501,15.19047619047619
280,431,0,10556,3988932,15.392857142857142
200,322,0,10557,3989254,16.1
210,278,0,10558,3989532,13.238095238095237
180,290,0,10559,3989822,16.11111111111111
300,461,0,10560,3990283,15.366666666666667
160,229,0,10561,3990512,14.3125
200,328,0,10562,3990840,16.4
290,475,0,10563,3991315,16.379310344827587
140,182,0,10564,3991497,13.0
180,207,0,10565,3991704,11.5
170,224,0,10566,3991928,13.176470588235293
260,412,0,10567,3992340,15.846153846153847
300,395,0,10568,3992735,13.166666666666666
150,244,0,10569,3992979,16.266666666666666
220,308,0,10570,3993287,14.0
250,387,0,10571,3993674,15.48
320,449,0,10572,3994123,14.03125
400,678,0,10573,3994801,16.95
260,354,0,10574,3995155,13.615384615384615
440,738,0,10575,3995893,16.772727272727273
250,443,0,10576,3996336,17.72
230,319,0,10577,3996655,13.869565217391305
190,294,0,10578,3996949,15.473684210526315
200,250,0,10579,3997199,12.5
200,253,0,10580,3997452,12.65
400,712,0,10581,3998164,17.8
160,242,0,10582,3998406,15.125
350,597,0,10583,3999003,17.057142857142857
220,365,0,10584,3999368,16.59090909090909
100,127,0,10585,3999495,12.7
340,467,0,10586,3999962,13.735294117647058
240,319,0,10587,4000281,13.291666666666666
170,221,0,10588,4000502,13.0
370,643,0,10589,4001145,17.37837837837838
290,445,0,10590,4001590,15.344827586206897
240,388,0,10591,4001978,16.166666666666668
300,439,0,10592,4002417,14.633333333333333
180,319,0,10593,4002736,17.72222222222222
270,388,0,10594,4003124,14.37037037037037
280,496,0,10595,4003620,17.714285714285715
160,279,0,10596,4003899,17.4375
180,279,0,10597,4004178,15.5
250,380,0,10598,4004558,15.2
90,128,0,10599,4004686,14.222222222222221
300,469,0,10600,4005155,15.633333333333333
230,364,0,10601,4005519,15.826086956521738
270,418,0,10602,4005937,15.481481481481481
250,352,0,10603,4006289,14.08
210,314,0,10604,4006603,14.952380952380953
120,187,0,10605,4006790,15.583333333333334
230,352,0,10606,4007142,15.304347826086957
110,135,0,10607,4007277,12.272727272727273
210,315,0,10608,4007592,15.0
290,417,0,10609,4008009,14.379310344827585
240,334,0,10610,4008343,13.916666666666666
360,589,0,10611,4008932,16.36111111111111
360,620,0,10612,4009552,17.22222222222222
270,361,0,10613,4009913,13.37037037037037
140,153,0,10614,4010066,10.928571428571429
510,879,0,10615,4010945,17.235294117647058
350,574,0,10616,4011519,16.4
140,193,0,10617,4011712,13.785714285714286
80,125,0,10618,4011837,15.625
250,364,0,10619,4012201,14.56
270,438,0,10620,4012639,16.22222222222222
280,459,0,10621,4013098,16.392857142857142
410,656,0,10622,4013754,16.0
330,453,0,10623,4014207,13.727272727272727
130,151,0,10624,4014358,11.615384615384615
250,359,0,10625,4014717,14.36
70,74,0,10626,4014791,10.571428571428571
330,496,0,10627,4015287,15.030303030303031
220,297,0,10628,4015584,13.5
400,651,0,10629,4016235,16.275
340,482,0,10630,4016717,14.176470588235293
390,549,0,10631,4017266,14.076923076923077
240,339,0,10632,4017605,14.125
430,638,0,10633,4018243,14.837209302325581
230,358,0,10634,4018601,15.565217391304348
220,320,0,10635,4018921,14.545454545454545
160,253,0,10636,4019174,15.8125
290,465,0,10637,4019639,16.03448275862069
350,549,0,10638,4020188,15.685714285714285
140,141,0,10639,4020329,10.071428571428571
300,418,0,10640,4020747,13.933333333333334
280,434,0,10641,4021181,15.5
190,258,0,10642,4021439,13.578947368421053
210,335,0,10643,4021774,15.952380952380953
490,865,0,10644,4022639,17.653061224489797
380,627,0,10645,4023266,16.5
160,225,0,10646,4023491,14.0625
220,333,0,10647,4023824,15.136363636363637
280,405,0,10648,4024229,14.464285714285714
490,846,0,10649,4025075,17.26530612244898
260,317,0,10650,4025392,12.192307692307692
220,294,0,10651,4025686,13.363636363636363
280,378,0,10652,4026064,13.5
190,252,0,10653,4026316,13.263157894736842
330,460,0,10654,4026776,13.93939393939394
280,493,0,10655,4027269,17.607142857142858
200,279,0,10656,4027548,13.95
120,183,0,10657,4027731,15.25
250,403,0,10658,4028134,16.12
240,305,0,10659,4028439,12.708333333333334
340,465,0,10660,4028904,13.676470588235293
70,87,0,10661,4028991,12.428571428571429
150,203,0,10662,4029194,13.533333333333333
240,360,0,10663,4029554,15.0
280,402,0,10664,4029956,14.357142857142858
330,517,0,10665,4030473,15.666666666666666
230,340,0,10666,4030813,14.782608695652174
420,616,0,10667,4031429,14.666666666666666
330,423,0,10668,4031852,12.818181818181818
200,316,0,10669,4032168,15.8
330,557,0,10670,4032725,16.87878787878788
430,606,0,10671,4033331,14.093023255813954
300,381,0,10672,4033712,12.7
290,496,0,10673,4034208,17.103448275862068
200,299,0,10674,4034507,14.95
320,498,0,10675,4035005,15.5625
330,467,0,10676,4035472,14.151515151515152
230,367,0,10677,4035839,15.956521739130435
180,204,0,10678,4036043,11.333333333333334
160,217,0,10679,4036260,13.5625
160,225,0,10680,4036485,14.0625
210,297,0,10681,4036782,14.142857142857142
290,408,0,10682,4037190,14.068965517241379
140,212,0,10683,4037402,15.142857142857142
190,238,0,10684,4037640,12.526315789473685
100,152,0,10685,4037792,15.2
180,232,0,10686,4038024,12.88888888888889
220,337,0,10687,4038361,15.318181818181818
320,426,0,10688,4038787,13.3125
190,284,0,10689,4039071,14.947368421052632
340,532,0,10690,4039603,15.647058823529411
180,284,0,10691,4039887,15.777777777777779
220,327,0,10692,4040214,14.863636363636363
50,73,0,10693,4040287,14.6
260,480,0,10694,4040767,18.46153846153846
430,632,0,10695,4041399,14.69767441860465
150,208,0,10696,4041607,13.866666666666667
450,754,0,10697,4042361,16.755555555555556
250,388,0,10698,4042749,15.52
190,248,0,10699,4042997,13.052631578947368
360,607,0,10700,4043604,16.86111111111111
140,162,0,10701,4043766,11.571428571428571
190,270,0,10702,4044036,14.210526315789474
210,364,0,10703,4044400,17.333333333333332
400,625,0,10704,4045025,15.625
210,296,0,10705,4045321,14.095238095238095
320,550,0,10706,4045871,17.1875
330,495,0,10707,4046366,15.0
230,325,0,10708,4046691,14.130434782608695
350,492,0,10709,4047183,14.057142857142857
220,274,0,10710,4047457,12.454545454545455
420,658,0,10711,4048115,15.666666666666666
250,346,0,10712,4048461,13.84
390,564,0,10713,4049025,14.461538461538462
440,642,0,10714,4049667,14.590909090909092
400,645,0,10715,4050312,16.125
210,294,0,10716,4050606,14.0
140,206,0,10717,4050812,14.714285714285714
180,210,0,10718,4051022,11.666666666666666
60,50,0,10719,4051072,8.333333333333334
220,330,0,10720,4051402,15.0
380,633,0,10721,4052035,16.657894736842106
100,156,0,10722,4052191,15.6
410,686,0,10723,4052877,16.73170731707317
350,594,0,10724,4053471,16.97142857142857
180,285,0,10725,4053756,15.833333333333334
250,271,0,10726,4054027,10.84
170,308,0,10727,4054335,18.11764705882353
90,148,0,10728,4054483,16.444444444444443
260,336,0,10729,4054819,12.923076923076923
300,492,0,10730,4055311,16.4
330,450,0,10731,4055761,13.636363636363637
380,620,0,10732,4056381,16.31578947368421
230,333,0,10733,4056714,14.478260869565217
140,175,0,10734,4056889,12.5
340,547,0,10735,4057436,16.08823529411765
360,619,0,10736,4058055,17.194444444444443
170,182,0,10737,4058237,10.705882352941176
250,327,0,10738,4058564,13.08
240,385,0,10739,4058949,16.041666666666668
430,657,0,10740,4059606,15.279069767441861
300,437,0,10741,4060043,14.566666666666666
230,300,0,10742,4060343,13.043478260869565
150,146,0,10743,4060489,9.733333333333333
450,736,0,10744,4061225,16.355555555555554
280,505,0,10745,4061730,18.035714285714285
180,236,0,10746,4061966,13.11111111111111
280,447,0,10747,4062413,15.964285714285714
300,458,0,10748,4062871,15.266666666666667
300,435,0,10749,4063306,14.5
350,573,0,10750,4063879,16.37142857142857
60,78,0,10751,4063957,13.0
240,348,0,10752,4064305,14.5
210,296,0,10753,4064601,14.095238095238095
410,782,0,10754,4065383,19.073170731707318
400,599,0,10755,4065982,14.975
110,149,0,10756,4066131,13.545454545454545
190,306,0,10757,4066437,16.105263157894736
380,679,0,10758,4067116,17.86842105263158
210,298,0,10759,4067414,14.19047619047619
230,436,0,10760,4067850,18.956521739130434
80,130,0,10761,4067980,16.25
250,387,0,10762,4068367,15.48
200,326,0,10763,4068693,16.3
250,381,0,10764,4069074,15.24
210,305,0,10765,4069379,14.523809523809524
130,144,0,10766,4069523,11.076923076923077
420,589,0,10767,4070112,14.023809523809524
340,481,0,10768,4070593,14.147058823529411
160,314,0,10769,4070907,19.625
270,378,0,10770,4071285,14.0
190,306,0,10771,4071591,16.105263157894736
250,364,0,10772,4071955,14.56
170,264,0,10773,4072219,15.529411764705882
350,434,0,10774,4072653,12.4
200,291,0,10775,4072944,14.55
310,457,0,10776,4073401,14.741935483870968
210,284,0,10777,4073685,13.523809523809524
240,349,0,10778,4074034,14.541666666666666
120,125,0,10779,4074159,10.416666666666666
270,399,0,10780,4074558,14.777777777777779
230,358,0,10781,4074916,15.565217391304348
340,605,0,10782,4075521,17.794117647058822
220,276,0,10783,4075797,12.545454545454545
100,146,0,10784,4075943,14.6
250,316,0,10785,4076259,12.64
330,513,0,10786,4076772,15.545454545454545
200,296,0,10787,4077068,14.8
220,306,0,10788,4077374,13.909090909090908
290,425,0,10789,4077799,14.655172413793103
500,870,0,10790,4078669,17.4
350,451,0,10791,4079120,12.885714285714286
220,339,0,10792,4079459,15.409090909090908
290,425,0,10793,4079884,14.655172413793103
310,463,0,10794,4080347,14.935483870967742
110,101,0,10795,4080448,9.181818181818182
500,805,0,10796,4081253,16.1
100,116,0,10797,4081369,11.6
200,278,0,10798,4081647,13.9
200,295,0,10799,4081942,14.75
110,161,0,10800,4082103,14.636363636363637
230,366,0,10801,4082469,15.91304347826087
380,621,0,10802,4083090,16.342105263157894
260,354,0,10803,4083444,13.615384615384615
190,248,0,10804,4083692,13.052631578947368
110,159,0,10805,4083851,14.454545454545455
460,882,0,10806,4084733,19.17391304347826
220,311,0,10807,4085044,14.136363636363637
210,330,0,10808,4085374,15.714285714285714
210,264,0,10809,4085638,12.571428571428571
250,413,0,10810,4086051,16.52
240,324,0,10811,4086375,13.5
100,148,0,10812,4086523,14.8
230,327,0,10813,4086850,14.217391304347826
310,437,0,10814,4087287,14.096774193548388
150,232,0,10815,4087519,15.466666666666667
230,386,0,10816,4087905,16.782608695652176
150,197,0,10817,4088102,13.133333333333333
370,631,0,10818,4088733,17.054054054054053
230,321,0,10819,4089054,13.956521739130435
120,183,0,10820,4089237,15.25
410,605,0,10821,4089842,14.75609756097561
90,118,0,10822,4089960,13.11111111111111
330,502,0,10823,4090462,15.212121212121213
250,485,0,10824,4090947,19.4
350,527,0,10825,4091474,15.057142857142857
260,419,0,10826,4091893,16.115384615384617
250,382,0,10827,4092275,15.28
170,269,0,10828,4092544,15.823529411764707
190,283,0,10829,4092827,14.894736842105264
80,136,0,10830,4092963,17.0
50,58,0,10831,4093021,11.6
190,323,0,10832,4093344,17.0
210,244,0,10833,4093588,11.619047619047619
250,342,0,10834,4093930,13.68
220,292,0,10835,4094222,13.272727272727273
350,589,0,10836,4094811,16.82857142857143
150,251,0,10837,4095062,16.733333333333334
160,212,0,10838,4095274,13.25
180,285,0,10839,4095559,15.833333333333334
290,413,0,10840,4095972,14.241379310344827
150,161,0,10841,4096133,10.733333333333333
290,453,0,10842,4096586,15.620689655172415
160,163,0,10843,4096749,10.1875
220,360,0,10844,4097109,16.363636363636363
390,620,0,10845,4097729,15.897435897435898
410,666,0,10846,4098395,16.24390243902439
380,627,0,10847,4099022,16.5
270,369,0,10848,4099391,13.666666666666666
300,434,0,10849,4099825,14.466666666666667
150,192,0,10850,4100017,12.8
520,785,0,10851,4100802,15.096153846153847
260,318,0,10852,4101120,12.23076923076923
370,614,0,10853,4101734,16.594594594594593
210,377,0,10854,4102111,17.952380952380953
300,432,0,10855,4102543,14.4
140,245,0,10856,4102788,17.5
310,516,0,10857,4103304,16.64516129032258
130,157,0,10858,4103461,12.076923076923077
240,338,0,10859,4103799,14.083333333333334
350,624,0,10860,4104423,17.82857142857143
260,395,0,10861,4104818,15.192307692307692
190,283,0,10862,4105101,14.894736842105264
140,166,0,10863,4105267,11.857142857142858
210,299,0,10864,4105566,14.238095238095237
330,531,0,10865,4106097,16.09090909090909
310,593,0,10866,4106690,19.129032258064516
370,619,0,10867,4107309,16.72972972972973
250,328,0,10868,4107637,13.12
350,532,0,10869,4108169,15.2
190,240,0,10870,4108409,12.631578947368421
390,678,0,10871,4109087,17.384615384615383
270,398,0,10872,4109485,14.74074074074074
220,336,0,10873,4109821,15.272727272727273
120,146,0,10874,4109967,12.166666666666666
450,777,0,10875,4110744,17.266666666666666
80,109,0,10876,4110853,13.625
130,172,0,10877,4111025,13.23076923076923
500,831,0,10878,4111856,16.62
260,431,0,10879,4112287,16.576923076923077
370,547,0,10880,4112834,14.783783783783784
220,312,0,10881,4113146,14.181818181818182
240,309,0,10882,4113455,12.875
120,135,0,10883,4113590,11.25
230,381,0,10884,4113971,16.565217391304348
250,465,0,10885,4114436,18.6
110,178,0,10886,4114614,16.181818181818183
260,448,0,10887,4115062,17.23076923076923
100,151,0,10888,4115213,15.1
280,385,0,10889,4115598,13.75
400,708,0,10890,4116306,17.7
290,389,0,10891,4116695,13.413793103448276
300,462,0,10892,4117157,15.4
290,406,0,10893,4117563,14.0
190,223,0,10894,4117786,11.736842105263158
260,281,0,10895,4118067,10.807692307692308
290,434,0,10896,4118501,14.96551724137931
190,283,0,10897,4118784,14.894736842105264
460,792,0,10898,4119576,17.217391304347824
250,314,0,10899,4119890,12.56
330,511,0,10900,4120401,15.484848484848484
210,297,0,10901,4120698,14.142857142857142
330,529,0,10902,4121227,16.03030303030303
210,359,0,10903,4121586,17.095238095238095
460,869,0,10904,4122455,18.891304347826086
110,144,0,10905,4122599,13.090909090909092
200,263,0,10906,4122862,13.15
150,216,0,10907,4123078,14.4
320,382,0,10908,4123460,11.9375
260,409,0,10909,4123869,15.73076923076923
250,346,0,10910,4124215,13.84
180,236,0,10911,4124451,13.11111111111111
310,368,0,10912,4124819,11.870967741935484
120,142,0,10913,4124961,11.833333333333334
290,400,0,10914,4125361,13.793103448275861
280,476,0,10915,4125837,17.0
340,459,0,10916,4126296,13.5
190,322,0,10917,4126618,16.94736842105263
170,244,0,10918,4126862,14.352941176470589
190,281,0,10919,4127143,14.789473684210526
120,166,0,10920,4127309,13.833333333333334
260,390,0,10921,4127699,15.0
240,328,0,10922,4128027,13.666666666666666
200,284,0,10923,4128311,14.2
100,172,0,10924,4128483,17.2
200,270,0,10925,4128753,13.5
300,389,0,10926,4129142,12.966666666666667
300,508,0,10927,4129650,16.933333333333334
400,572,0,10928,4130222,14.3
140,211,0,10929,4130433,15.071428571428571
140,161,0,10930,4130594,11.5
300,413,0,10931,4131007,13.766666666666667
410,775,0,10932,4131782,18.902439024390244
370,583,0,10933,4132365,15.756756756756756
300,367,0,10934,4132732,12.233333333333333
360,639,0,10935,4133371,17.75
240,374,0,10936,4133745,15.583333333333334
90,119,0,10937,4133864,13.222222222222221
370,606,0,10938,4134470,16.37837837837838
230,339,0,10939,4134809,14.73913043478261
280,424,0,10940,4135233,15.142857142857142
370,512,0,10941,4135745,13.837837837837839
430,651,0,10942,4136396,15.13953488372093
250,391,0,10943,4136787,15.64
310,478,0,10944,4137265,15.419354838709678
200,307,0,10945,4137572,15.35
280,441,0,10946,4138013,15.75
240,368,0,10947,4138381,15.333333333333334
160,265,0,10948,4138646,16.5625
180,283,0,10949,4138929,15.722222222222221
300,509,0,10950,4139438,16.966666666666665
290,388,0,10951,4139826,13.379310344827585
410,718,0,10952,4140544,17.51219512195122
230,349,0,10953,4140893,15.173913043478262
170,204,0,10954,4141097,12.0
340,602,0,10955,4141699,17.705882352941178
290,435,0,10956,4142134,15.0
230,334,0,10957,4142468,14.521739130434783
390,526,0,10958,4142994,13.487179487179487
150,203,0,10959,4143197,13.533333333333333
150,242,0,10960,4143439,16.133333333333333
300,480,0,10961,4143919,16.0
140,190,0,10962,4144109,13.571428571428571
210,340,0,10963,4144449,16.19047619047619
260,340,0,10964,4144789,13.076923076923077
160,233,0,10965,4145022,14.5625
230,362,0,10966,4145384,15.73913043478261
440,756,0,10967,4146140,17.181818181818183
310,512,0,10968,4146652,16.516129032258064
360,614,0,10969,4147266,17.055555555555557
250,349,0,10970,4147615,13.96
170,231,0,10971,4147846,13.588235294117647
220,308,0,10972,4148154,14.0
380,593,0,10973,4148747,15.605263157894736
200,297,0,10974,4149044,14.85
290,478,0,10975,4149522,16.482758620689655
480,808,0,10976,4150330,16.833333333333332
110,156,0,10977,4150486,14.181818181818182
80,109,0,10978,4150595,13.625
320,457,0,10979,4151052,14.28125
360,576,0,10980,4151628,16.0
280,419,0,10981,4152047,14.964285714285714
90,138,0,10982,4152185,15.333333333333334
210,299,0,10983,4152484,14.238095238095237
170,257,0,10984,4152741,15.117647058823529
290,409,0,10985,4153150,14.10344827586207
210,257,0,10986,4153407,12.238095238095237
270,324,0,10987,4153731,12.0
330,535,0,10988,4154266,16.21212121212121
170,212,0,10989,4154478,12.470588235294118
320,505,0,10990,4154983,15.78125
230,384,0,10991,4155367,16.695652173913043
420,669,0,10992,4156036,15.928571428571429
270,380,0,10993,4156416,14.074074074074074
280,472,0,10994,4156888,16.857142857142858
300,453,0,10995,4157341,15.1
290,448,0,10996,4157789,15.448275862068966
320,444,0,10997,4158233,13.875
230,287,0,10998,4158520,12.478260869565217
170,263,0,10999,4158783,15.470588235294118
370,565,0,11000,4159348,15.27027027027027
120,134,0,11001,4159482,11.166666666666666
110,129,0,11002,4159611,11.727272727272727
220,287,0,11003,4159898,13.045454545454545
180,237,0,11004,4160135,13.166666666666666
240,323,0,11005,4160458,13.458333333333334
180,290,0,11006,4160748,16.11111111111111
300,544,0,11007,4161292,18.133333333333333
180,232,0,11008,4161524,12.88888888888889
190,303,0,11009,4161827,15.947368421052632
220,319,0,11010,4162146,14.5
320,455,0,11011,4162601,14.21875
390,565,0,11012,4163166,14.487179487179487
270,420,0,11013,4163586,15.555555555555555
190,275,0,11014,4163861,14.473684210526315
310,582,0,11015,4164443,18.774193548387096
460,693,0,11016,4165136,15.065217391304348
350,554,0,11017,4165690,15.82857142857143
210,319,0,11018,4166009,15.19047619047619
230,401,0,11019,4166410,17.434782608695652
120,167,0,11020,4166577,13.916666666666666
320,506,0,11021,4167083,15.8125
230,287,0,11022,4167370,12.478260869565217
180,249,0,11023,4167619,13.833333333333334
250,342,0,11024,4167961,13.68
190,259,0,11025,4168220,13.631578947368421
290,508,0,11026,4168728,17.517241379310345
380,565,0,11027,4169293,14.868421052631579
130,118,0,11028,4169411,9.076923076923077
250,385,0,11029,4169796,15.4
280,476,0,11030,4170272,17.0
230,311,0,11031,4170583,13.521739130434783
200,264,0,11032,4170847,13.2
490,806,0,11033,4171653,16.448979591836736
160,199,0,11034,4171852,12.4375
300,463,0,11035,4172315,15.433333333333334
390,654,0,11036,4172969,16.76923076923077
190,232,0,11037,4173201,12.210526315789474
520,922,0,11038,4174123,17.73076923076923
250,417,0,11039,4174540,16.68
270,364,0,11040,4174904,13.481481481481481
190,228,0,11041,4175132,12.0
400,558,0,11042,4175690,13.95
250,376,0,11043,4176066,15.04
260,431,0,11044,4176497,16.576923076923077
280,442,0,11045,4176939,15.785714285714286
260,373,0,11046,4177312,14.346153846153847
390,571,0,11047,4177883,14.64102564102564
290,423,0,11048,4178306,14.586206896551724
100,101,0,11049,4178407,10.1
150,234,0,11050,4178641,15.6
240,407,0,11051,4179048,16.958333333333332
150,214,0,11052,4179262,14.266666666666667
250,358,0,11053,4179620,14.32
140,183,0,11054,4179803,13.071428571428571
680,1118,0,11055,4180921,16.441176470588236
620,1050,0,11056,4181971,16.93548387096774
180,266,0,11057,4182237,14.777777777777779
100,185,0,11058,4182422,18.5
160,215,0,11059,4182637,13.4375
550,963,0,11060,4183600,17.509090909090908
70,66,0,11061,4183666,9.428571428571429
210,268,0,11062,4183934,12.761904761904763
380,665,0,11063,4184599,17.5
400,712,0,11064,4185311,17.8
270,444,0,11065,4185755,16.444444444444443
280,408,0,11066,4186163,14.571428571428571
240,377,0,11067,4186540,15.708333333333334
230,387,0,11068,4186927,16.82608695652174
310,404,0,11069,4187331,13.03225806451613
190,237,0,11070,4187568,12.473684210526315
380,656,0,11071,4188224,17.263157894736842
270,418,0,11072,4188642,15.481481481481481
120,146,0,11073,4188788,12.166666666666666
380,699,0,11074,4189487,18.394736842105264
310,484,0,11075,4189971,15.612903225806452
280,320,0,11076,4190291,11.428571428571429
170,207,0,11077,4190498,12.176470588235293
290,485,0,11078,4190983,16.724137931034484
250,398,0,11079,4191381,15.92
340,546,0,11080,4191927,16.058823529411764
420,603,0,11081,4192530,14.357142857142858
170,191,0,11082,4192721,11.235294117647058
390,622,0,11083,4193343,15.948717948717949
260,397,0,11084,4193740,15.26923076923077
380,623,0,11085,4194363,16.394736842105264
330,539,0,11086,4194902,16.333333333333332
130,144,0,11087,4195046,11.076923076923077
310,535,0,11088,4195581,17.258064516129032
310,461,0,11089,4196042,14.870967741935484
360,565,0,11090,4196607,15.694444444444445
60,78,0,11091,4196685,13.0
260,402,0,11092,4197087,15.461538461538462
200,288,0,11093,4197375,14.4
220,287,0,11094,4197662,13.045454545454545
360,560,0,11095,4198222,15.555555555555555
150,172,0,11096,4198394,11.466666666666667
300,453,0,11097,4198847,15.1
190,232,0,11098,4199079,12.210526315789474
260,401,0,11099,4199480,15.423076923076923
320,553,0,11100,4200033,17.28125
170,243,0,11101,4200276,14.294117647058824
450,683,0,11102,4200959,15.177777777777777
240,353,0,11103,4201312,14.708333333333334
470,770,0,11104,4202082,16.382978723404257
250,350,0,11105,4202432,14.0
210,328,0,11106,4202760,15.619047619047619
120,154,0,11107,4202914,12.833333333333334
130,181,0,11108,4203095,13.923076923076923
130,139,0,11109,4203234,10.692307692307692
290,514,0,11110,4203748,17.724137931034484
320,459,0,11111,4204207,14.34375
370,745,0,11112,4204952,20.135135135135137
490,901,0,11113,4205853,18.387755102040817
290,426,0,11114,4206279,14.689655172413794
210,294,0,11115,4206573,14.0
100,148,0,11116,4206721,14.8
210,277,0,11117,4206998,13.19047619047619
230,288,0,11118,4207286,12.521739130434783
230,392,0,11119,4207678,17.043478260869566
290,496,0,11120,4208174,17.103448275862068
150,238,0,11121,4208412,15.866666666666667
220,340,0,11122,4208752,15.454545454545455
280,476,0,11123,4209228,17.0
240,323,0,11124,4209551,13.458333333333334
410,632,0,11125,4210183,15.414634146341463
320,512,0,11126,4210695,16.0
200,284,0,11127,4210979,14.2
220,294,0,11128,4211273,13.363636363636363
180,235,0,11129,4211508,13.055555555555555
210,317,0,11130,4211825,15.095238095238095
260,388,0,11131,4212213,14.923076923076923
120,128,0,11132,4212341,10.666666666666666
90,116,0,11133,4212457,12.88888888888889
150,209,0,11134,4212666,13.933333333333334
180,297,0,11135,4212963,16.5
90,102,0,11136,4213065,11.333333333333334
380,549,0,11137,4213614,14.447368421052632
140,206,0,11138,4213820,14.714285714285714
160,213,0,11139,4214033,13.3125
140,182,0,11140,4214215,13.0
200,276,0,11141,4214491,13.8
240,404,0,11142,4214895,16.833333333333332
330,502,0,11143,4215397,15.212121212121213
150,201,0,11144,4215598,13.4
320,639,0,11145,4216237,19.96875
90,125,0,11146,4216362,13.88888888888889
100,106,0,11147,4216468,10.6
290,431,0,11148,4216899,14.862068965517242
190,229,0,11149,4217128,12.052631578947368
130,180,0,11150,4217308,13.846153846153847
450,734,0,11151,4218042,16.31111111111111
380,583,0,11152,4218625,15.342105263157896
90,120,0,11153,4218745,13.333333333333334
410,534,0,11154,4219279,13.024390243902438
120,161,0,11155,4219440,13.416666666666666
150,192,0,11156,4219632,12.8
90,125,0,11157,4219757,13.88888888888889
200,298,0,11158,4220055,14.9
340,534,0,11159,4220589,15.705882352941176
250,362,0,11160,4220951,14.48
340,541,0,11161,4221492,15.911764705882353
200,314,0,11162,4221806,15.7
250,388,0,11163,4222194,15.52
350,528,0,11164,4222722,15.085714285714285
280,349,0,11165,4223071,12.464285714285714
230,299,0,11166,4223370,13.0
400,655,0,11167,4224025,16.375
450,652,0,11168,4224677,14.488888888888889
310,494,0,11169,4225171,15.935483870967742
330,426,0,11170,4225597,12.909090909090908
210,238,0,11171,4225835,11.333333333333334
630,937,0,11172,4226772,14.873015873015873
110,145,0,11173,4226917,13.181818181818182
220,300,0,11174,4227217,13.636363636363637
440,779,0,11175,4227996,17.704545454545453
170,238,0,11176,4228234,14.0
240,365,0,11177,4228599,15.208333333333334
270,379,0,11178,4228978,14.037037037037036
290,430,0,11179,4229408,14.827586206896552
160,202,0,11180,4229610,12.625
200,349,0,11181,4229959,17.45
280,370,0,11182,4230329,13.214285714285714
180,338,0,11183,4230667,18.77777777777778
290,407,0,11184,4231074,14.03448275862069
190,297,0,11185,4231371,15.631578947368421
100,115,0,11186,4231486,11.5
330,477,0,11187,4231963,14.454545454545455
140,206,0,11188,4232169,14.714285714285714
340,472,0,11189,4232641,13.882352941176471
150,262,0,11190,4232903,17.466666666666665
230,371,0,11191,4233274,16.130434782608695
180,239,0,11192,4233513,13.277777777777779
140,214,0,11193,4233727,15.285714285714286
210,277,0,11194,4234004,13.19047619047619
260,394,0,11195,4234398,15.153846153846153
290,442,0,11196,4234840,15.241379310344827
380,628,0,11197,4235468,16.526315789473685
80,100,0,11198,4235568,12.5
270,351,0,11199,4235919,13.0
230,343,0,11200,4236262,14.91304347826087
290,397,0,11201,4236659,13.689655172413794
280,417,0,11202,4237076,14.892857142857142
230,340,0,11203,4237416,14.782608695652174
270,429,0,11204,4237845,15.88888888888889
300,492,0,11205,4238337,16.4
180,263,0,11206,4238600,14.61111111111111
80,100,0,11207,4238700,12.5
260,362,0,11208,4239062,13.923076923076923
260,377,0,11209,4239439,14.5
110,118,0,11210,4239557,10.727272727272727
120,138,0,11211,4239695,11.5
450,620,0,11212,4240315,13.777777777777779
220,289,0,11213,4240604,13.136363636363637
140,223,0,11214,4240827,15.928571428571429
260,406,0,11215,4241233,15.615384615384615
200,315,0,11216,4241548,15.75
210,261,0,11217,4241809,12.428571428571429
130,155,0,11218,4241964,11.923076923076923
220,356,0,11219,4242320,16.181818181818183
390,603,0,11220,4242923,15.461538461538462
140,168,0,11221,4243091,12.0
240,285,0,11222,4243376,11.875
220,357,0,11223,4243733,16.227272727272727
240,370,0,11224,4244103,15.416666666666666
170,242,0,11225,4244345,14.235294117647058
170,240,0,11226,4244585,14.117647058823529
200,299,0,11227,4244884,14.95
240,403,0,11228,4245287,16.791666666666668
100,101,0,11229,4245388,10.1
380,541,0,11230,4245929,14.236842105263158
150,187,0,11231,4246116,12.466666666666667
250,298,0,11232,4246414,11.92
260,370,0,11233,4246784,14.23076923076923
180,258,0,11234,4247042,14.333333333333334
340,514,0,11235,4247556,15.117647058823529
250,472,0,11236,4248028,18.88
230,368,0,11237,4248396,16.0
350,585,0,11238,4248981,16.714285714285715
340,510,0,11239,4249491,15.0
190,219,0,11240,4249710,11.526315789473685
270,338,0,11241,4250048,12.518518518518519
370,631,0,11242,4250679,17.054054054054053
240,310,0,11243,4250989,12.916666666666666
230,281,0,11244,4251270,12.217391304347826
360,553,0,11245,4251823,15.36111111111111
140,178,0,11246,4252001,12.714285714285714
250,363,0,11247,4252364,14.52
240,438,0,11248,4252802,18.25
190,233,0,11249,4253035,12.263157894736842
400,558,0,11250,4253593,13.95
120,107,0,11251,4253700,8.916666666666666
190,236,0,11252,4253936,12.421052631578947
310,442,0,11253,4254378,14.258064516129032
230,346,0,11254,4254724,15.043478260869565
330,470,0,11255,4255194,14.242424242424242
300,393,0,11256,4255587,13.1
250,321,0,11257,4255908,12.84
290,484,0,11258,4256392,16.689655172413794
180,244,0,11259,4256636,13.555555555555555
240,358,0,11260,4256994,14.916666666666666
350,557,0,11261,4257551,15.914285714285715
280,420,0,11262,4257971,15.0
240,356,0,11263,4258327,14.833333333333334
210,323,0,11264,4258650,15.380952380952381
200,371,0,11265,4259021,18.55
220,289,0,11266,4259310,13.136363636363637
260,389,0,11267,4259699,14.961538461538462
160,198,0,11268,4259897,12.375
100,93,0,11269,4259990,9.3
160,247,0,11270,4260237,15.4375
40,30,0,11271,4260267,7.5
360,631,0,11272,4260898,17.52777777777778
160,216,0,11273,4261114,13.5
350,568,0,11274,4261682,16.228571428571428
60,82,0,11275,4261764,13.666666666666666
420,681,0,11276,4262445,16.214285714285715
210,324,0,11277,4262769,15.428571428571429
260,425,0,11278,4263194,16.346153846153847
220,359,0,11279,4263553,16.318181818181817
90,102,0,11280,4263655,11.333333333333334
280,407,0,11281,4264062,14.535714285714286
150,170,0,11282,4264232,11.333333333333334
410,609,0,11283,4264841,14.853658536585366
260,391,0,11284,4265232,15.038461538461538
160,182,0,11285,4265414,11.375
250,504,0,11286,4265918,20.16
150,176,0,11287,4266094,11.733333333333333
500,701,0,11288,4266795,14.02
290,391,0,11289,4267186,13.482758620689655
120,139,0,11290,4267325,11.583333333333334
340,405,0,11291,4267730,11.911764705882353
100,115,0,11292,4267845,11.5
60,76,0,11293,4267921,12.666666666666666
180,280,0,11294,4268201,15.555555555555555
320,453,0,11295,4268654,14.15625
190,284,0,11296,4268938,14.947368421052632
320,473,0,11297,4269411,14.78125
440,666,0,11298,4270077,15.136363636363637
190,291,0,11299,4270368,15.31578947368421
160,265,0,11300,4270633,16.5625
130,150,0,11301,4270783,11.538461538461538
170,224,0,11302,4271007,13.176470588235293
250,417,0,11303,4271424,16.68
180,274,0,11304,4271698,15.222222222222221
180,268,0,11305,4271966,14.88888888888889
120,123,0,11306,4272089,10.25
290,448,0,11307,4272537,15.448275862068966
280,369,0,11308,4272906,13.178571428571429
90,105,0,11309,4273011,11.666666666666666
160,193,0,11310,4273204,12.0625
230,309,0,11311,4273513,13.434782608695652
260,369,0,11312,4273882,14.192307692307692
370,555,0,11313,4274437,15.0
220,338,0,11314,4274775,15.363636363636363
350,580,0,11315,4275355,16.571428571428573
210,262,0,11316,4275617,12.476190476190476
190,247,0,11317,4275864,13.0
280,361,0,11318,4276225,12.892857142857142
270,406,0,11319,4276631,15.037037037037036
180,255,0,11320,4276886,14.166666666666666
250,385,0,11321,4277271,15.4
160,286,0,11322,4277557,17.875
130,172,0,11323,4277729,13.23076923076923
240,336,0,11324,4278065,14.0
380,502,0,11325,4278567,13.210526315789474
310,466,0,11326,4279033,15.03225806451613
200,295,0,11327,4279328,14.75
200,326,0,11328,4279654,16.3
130,152,0,11329,4279806,11.692307692307692
240,348,0,11330,4280154,14.5
300,489,0,11331,4280643,16.3
270,332,0,11332,4280975,12.296296296296296
170,206,0,11333,4281181,12.117647058823529
250,375,0,11334,4281556,15.0
170,215,0,11335,4281771,12.647058823529411
280,408,0,11336,4282179,14.571428571428571
550,894,0,11337,4283073,16.254545454545454
240,391,0,11338,4283464,16.291666666666668
280,466,0,11339,4283930,16.642857142857142
490,739,0,11340,4284669,15.081632653061224
330,450,0,11341,4285119,13.636363636363637
220,305,0,11342,4285424,13.863636363636363
230,316,0,11343,4285740,13.73913043478261
310,484,0,11344,4286224,15.612903225806452
320,478,0,11345,4286702,14.9375
150,194,0,11346,4286896,12.933333333333334
260,403,0,11347,4287299,15.5
150,130,0,11348,4287429,8.666666666666666
300,456,0,11349,4287885,15.2
200,282,0,11350,4288167,14.1
240,366,0,11351,4288533,15.25
550,1019,0,11352,4289552,18.527272727272727
150,238,0,11353,4289790,15.866666666666667
240,341,0,11354,4290131,14.208333333333334
250,376,0,11355,4290507,15.04
300,431,0,11356,4290938,14.366666666666667
150,242,0,11357,4291180,16.133333333333333
160,211,0,11358,4291391,13.1875
320,455,0,11359,4291846,14.21875
80,90,0,11360,4291936,11.25
380,628,0,11361,4292564,16.526315789473685
190,324,0,11362,4292888,17.05263157894737
250,355,0,11363,4293243,14.2
260,391,0,11364,4293634,15.038461538461538
120,158,0,11365,4293792,13.166666666666666
340,500,0,11366,4294292,14.705882352941176
250,453,0,11367,4294745,18.12
200,250,0,11368,4294995,12.5
140,176,0,11369,4295171,12.571428571428571
370,518,0,11370,4295689,14.0
290,423,0,11371,4296112,14.586206896551724
300,400,0,11372,4296512,13.333333333333334
140,212,0,11373,4296724,15.142857142857142
280,421,0,11374,4297145,15.035714285714286
440,731,0,11375,4297876,16.613636363636363
280,423,0,11376,4298299,15.107142857142858
120,137,0,11377,4298436,11.416666666666666
250,386,0,11378,4298822,15.44
240,361,0,11379,4299183,15.041666666666666
310,500,0,11380,4299683,16.129032258064516
240,396,0,11381,4300079,16.5
120,142,0,11382,4300221,11.833333333333334
130,160,0,11383,4300381,12.307692307692308
240,338,0,11384,4300719,14.083333333333334
270,437,0,11385,4301156,16.185185185185187
350,493,0,11386,4301649,14.085714285714285
350,571,0,11387,4302220,16.314285714285713
170,257,0,11388,4302477,15.117647058823529
70,79,0,11389,4302556,11.285714285714286
180,217,0,11390,4302773,12.055555555555555
280,351,0,11391,4303124,12.535714285714286
100,155,0,11392,4303279,15.5
350,536,0,11393,4303815,15.314285714285715
80,111,0,11394,4303926,13.875
360,656,0,11395,4304582,18.22222222222222
230,387,0,11396,4304969,16.82608695652174
260,372,0,11397,4305341,14.307692307692308
320,490,0,11398,4305831,15.3125
230,340,0,11399,4306171,14.782608695652174
360,595,0,11400,4306766,16.52777777777778
110,152,0,11401,4306918,13.818181818181818
320,512,0,11402,4307430,16.0
320,481,0,11403,4307911,15.03125
70,68,0,11404,4307979,9.714285714285714
150,209,0,11405,4308188,13.933333333333334
170,282,0,11406,4308470,16.58823529411765
140,182,0,11407,4308652,13.0
490,746,0,11408,4309398,15.224489795918368
150,192,0,11409,4309590,12.8
410,595,0,11410,4310185,14.512195121951219
260,412,0,11411,4310597,15.846153846153847
380,651,0,11412,4311248,17.13157894736842
230,329,0,11413,4311577,14.304347826086957
140,193,0,11414,4311770,13.785714285714286
270,319,0,11415,4312089,11.814814814814815
280,393,0,11416,4312482,14.035714285714286
380,579,0,11417,4313061,15.236842105263158
420,719,0,11418,4313780,17.11904761904762
250,401,0,11419,4314181,16.04
330,494,0,11420,4314675,14.969696969696969
210,302,0,11421,4314977,14.380952380952381
140,204,0,11422,4315181,14.571428571428571
290,428,0,11423,4315609,14.758620689655173
380,514,0,11424,4316123,13.526315789473685
230,362,0,11425,4316485,15.73913043478261
90,140,0,11426,4316625,15.555555555555555
260,376,0,11427,4317001,14.461538461538462
220,313,0,11428,4317314,14.227272727272727
170,323,0,11429,4317637,19.0
260,410,0,11430,4318047,15.76923076923077
290,434,0,11431,4318481,14.96551724137931
220,312,0,11432,4318793,14.181818181818182
160,218,0,11433,4319011,13.625
180,252,0,11434,4319263,14.0
240,374,0,11435,4319637,15.583333333333334
120,138,0,11436,4319775,11.5
130,167,0,11437,4319942,12.846153846153847
110,130,0,11438,4320072,11.818181818181818
300,521,0,11439,4320593,17.366666666666667
280,381,0,11440,4320974,13.607142857142858
210,353,0,11441,4321327,16.80952380952381
220,307,0,11442,4321634,13.954545454545455
130,152,0,11443,4321786,11.692307692307692
170,211,0,11444,4321997,12.411764705882353
330,556,0,11445,4322553,16.848484848484848
400,588,0,11446,4323141,14.7
400,654,0,11447,4323795,16.35
260,421,0,11448,4324216,16.192307692307693
220,324,0,11449,4324540,14.727272727272727
100,111,0,11450,4324651,11.1
350,445,0,11451,4325096,12.714285714285714
250,382,0,11452,4325478,15.28
210,286,0,11453,4325764,13.619047619047619
90,146,0,11454,4325910,16.22222222222222
400,623,0,11455,4326533,15.575
230,348,0,11456,4326881,15.130434782608695
370,593,0,11457,4327474,16.027027027027028
330,427,0,11458,4327901,12.93939393939394
250,354,0,11459,4328255,14.16
270,428,0,11460,4328683,15.851851851851851
330,462,0,11461,4329145,14.0
260,417,0,11462,4329562,16.03846153846154
180,289,0,11463,4329851,16.055555555555557
190,294,0,11464,4330145,15.473684210526315
240,311,0,11465,4330456,12.958333333333334
290,409,0,11466,4330865,14.10344827586207
120,177,0,11467,4331042,14.75
330,541,0,11468,4331583,16.393939393939394
330,458,0,11469,4332041,13.878787878787879
480,842,0,11470,4332883,17.541666666666668
220,282,0,11471,4333165,12.818181818181818
380,669,0,11472,4333834,17.605263157894736
290,454,0,11473,4334288,15.655172413793103
240,354,0,11474,4334642,14.75
160,225,0,11475,4334867,14.0625
300,423,0,11476,4335290,14.1
240,335,0,11477,4335625,13.958333333333334
150,208,0,11478,4335833,13.866666666666667
270,411,0,11479,4336244,15.222222222222221
250,369,0,11480,4336613,14.76
300,407,0,11481,4337020,13.566666666666666
240,394,0,11482,4337414,16.416666666666668
410,726,0,11483,4338140,17.70731707317073
290,460,0,11484,4338600,15.862068965517242
180,256,0,11485,4338856,14.222222222222221
390,616,0,11486,4339472,15.794871794871796
190,300,0,11487,4339772,15.789473684210526
220,335,0,11488,4340107,15.227272727272727
80,111,0,11489,4340218,13.875
180,259,0,11490,4340477,14.38888888888889
370,553,0,11491,4341030,14.945945945945946
200,258,0,11492,4341288,12.9
270,445,0,11493,4341733,16.48148148148148
260,420,0,11494,4342153,16.153846153846153
190,276,0,11495,4342429,14.526315789473685
100,127,0,11496,4342556,12.7
170,247,0,11497,4342803,14.529411764705882
370,450,0,11498,4343253,12.162162162162161
170,245,0,11499,4343498,14.411764705882353
220,310,0,11500,4343808,14.090909090909092
360,500,0,11501,4344308,13.88888888888889
240,324,0,11502,4344632,13.5
120,169,0,11503,4344801,14.083333333333334
190,248,0,11504,4345049,13.052631578947368
240,326,0,11505,4345375,13.583333333333334
140,188,0,11506,4345563,13.428571428571429
190,273,0,11507,4345836,14.368421052631579
180,251,0,11508,4346087,13.944444444444445
180,251,0,11509,4346338,13.944444444444445
150,219,0,11510,4346557,14.6
160,278,0,11511,4346835,17.375
210,306,0,11512,4347141,14.571428571428571
240,378,0,11513,4347519,15.75
250,445,0,11514,4347964,17.8
330,528,0,11515,4348492,16.0
190,259,0,11516,4348751,13.631578947368421
240,378,0,11517,4349129,15.75
120,169,0,11518,4349298,14.083333333333334
250,361,0,11519,4349659,14.44
220,340,0,11520,4349999,15.454545454545455
290,440,0,11521,4350439,15.172413793103448
220,295,0,11522,4350734,13.409090909090908
90,121,0,11523,4350855,13.444444444444445
350,491,0,11524,4351346,14.028571428571428
420,610,0,11525,4351956,14.523809523809524
250,354,0,11526,4352310,14.16
310,415,0,11527,4352725,13.387096774193548
140,126,0,11528,4352851,9.0
450,813,0,11529,4353664,18.066666666666666
200,241,0,11530,4353905,12.05
280,390,0,11531,4354295,13.928571428571429
280,404,0,11532,4354699,14.428571428571429
200,320,0,11533,4355019,16.0
90,108,0,11534,4355127,12.0
360,570,0,11535,4355697,15.833333333333334
210,305,0,11536,4356002,14.523809523809524
240,352,0,11537,4356354,14.666666666666666
120,165,0,11538,4356519,13.75
90,143,0,11539,4356662,15.88888888888889
160,214,0,11540,4356876,13.375
600,1022,0,11541,4357898,17.033333333333335
190,242,0,11542,4358140,12.736842105263158
60,68,0,11543,4358208,11.333333333333334
200,268,0,11544,4358476,13.4
160,204,0,11545,4358680,12.75
150,154,0,11546,4358834,10.266666666666667
220,401,0,11547,4359235,18.227272727272727
180,239,0,11548,4359474,13.277777777777779
340,607,0,11549,4360081,17.852941176470587
230,290,0,11550,4360371,12.608695652173912
450,947,0,11551,4361318,21.044444444444444
210,243,0,11552,4361561,11.571428571428571
300,507,0,11553,4362068,16.9
300,477,0,11554,4362545,15.9
150,257,0,11555,4362802,17.133333333333333
260,304,0,11556,4363106,11.692307692307692
210,303,0,11557,4363409,14.428571428571429
380,544,0,11558,4363953,14.31578947368421
240,355,0,11559,4364308,14.791666666666666
340,472,0,11560,4364780,13.882352941176471
330,537,0,11561,4365317,16.272727272727273
150,211,0,11562,4365528,14.066666666666666
270,431,0,11563,4365959,15.962962962962964
240,324,0,11564,4366283,13.5
290,443,0,11565,4366726,15.275862068965518
200,238,0,11566,4366964,11.9
240,280,0,11567,4367244,11.666666666666666
240,350,0,11568,4367594,14.583333333333334
170,194,0,11569,4367788,11.411764705882353
300,447,0,11570,4368235,14.9
480,762,0,11571,4368997,15.875
130,171,0,11572,4369168,13.153846153846153
380,594,0,11573,4369762,15.631578947368421
240,289,0,11574,4370051,12.041666666666666
290,492,0,11575,4370543,16.96551724137931
300,429,0,11576,4370972,14.3
400,615,0,11577,4371587,15.375
220,353,0,11578,4371940,16.045454545454547
310,505,0,11579,4372445,16.29032258064516
100,109,0,11580,4372554,10.9
250,316,0,11581,4372870,12.64
110,148,0,11582,4373018,13.454545454545455
290,444,0,11583,4373462,15.310344827586206
250,369,0,11584,4373831,14.76
260,416,0,11585,4374247,16.0
360,498,0,11586,4374745,13.833333333333334
140,234,0,11587,4374979,16.714285714285715
60,79,0,11588,4375058,13.166666666666666
70,91,0,11589,4375149,13.0
440,688,0,11590,4375837,15.636363636363637
330,507,0,11591,4376344,15.363636363636363
300,425,0,11592,4376769,14.166666666666666
130,162,0,11593,4376931,12.461538461538462
150,198,0,11594,4377129,13.2
260,388,0,11595,4377517,14.923076923076923
150,219,0,11596,4377736,14.6
360,568,0,11597,4378304,15.777777777777779
220,340,0,11598,4378644,15.454545454545455
250,397,0,11599,4379041,15.88
170,245,0,11600,4379286,14.411764705882353
250,402,0,11601,4379688,16.08
190,220,0,11602,4379908,11.578947368421053
120,191,0,11603,4380099,15.916666666666666
350,536,0,11604,4380635,15.314285714285715
300,430,0,11605,4381065,14.333333333333334
110,149,0,11606,4381214,13.545454545454545
180,285,0,11607,4381499,15.833333333333334
320,475,0,11608,4381974,14.84375
240,414,0,11609,4382388,17.25
180,263,0,11610,4382651,14.61111111111111
200,251,0,11611,4382902,12.55
350,416,0,11612,4383318,11.885714285714286
120,166,0,11613,4383484,13.833333333333334
170,239,0,11614,4383723,14.058823529411764
90,147,0,11615,4383870,16.333333333333332
150,220,0,11616,4384090,14.666666666666666
170,227,0,11617,4384317,13.352941176470589
310,500,0,11618,4384817,16.129032258064516
360,475,0,11619,4385292,13.194444444444445
280,434,0,11620,4385726,15.5
360,545,0,11621,4386271,15.13888888888889
390,635,0,11622,4386906,16.28205128205128
300,424,0,11623,4387330,14.133333333333333
190,301,0,11624,4387631,15.842105263157896
390,566,0,11625,4388197,14.512820512820513
200,303,0,11626,4388500,15.15
390,508,0,11627,4389008,13.025641025641026
350,509,0,11628,4389517,14.542857142857143
140,203,0,11629,4389720,14.5
140,208,0,11630,4389928,14.857142857142858
180,300,0,11631,4390228,16.666666666666668
350,482,0,11632,4390710,13.771428571428572
340,497,0,11633,4391207,14.617647058823529
500,813,0,11634,4392020,16.26
440,577,0,11635,4392597,13.113636363636363
290,492,0,11636,4393089,16.96551724137931
90,121,0,11637,4393210,13.444444444444445
330,484,0,11638,4393694,14.666666666666666
270,433,0,11639,4394127,16.037037037037038
170,255,0,11640,4394382,15.0
270,378,0,11641,4394760,14.0
300,393,0,11642,4395153,13.1
190,288,0,11643,4395441,15.157894736842104
200,285,0,11644,4395726,14.25
240,368,0,11645,4396094,15.333333333333334
270,431,0,11646,4396525,15.962962962962964
70,78,0,11647,4396603,11.142857142857142
180,265,0,11648,4396868,14.722222222222221
180,271,0,11649,4397139,15.055555555555555
140,189,0,11650,4397328,13.5
260,391,0,11651,4397719,15.038461538461538
210,290,0,11652,4398009,13.80952380952381
320,484,0,11653,4398493,15.125
510,712,0,11654,4399205,13.96078431372549
60,76,0,11655,4399281,12.666666666666666
160,264,0,11656,4399545,16.5
340,473,0,11657,4400018,13.911764705882353
250,321,0,11658,4400339,12.84
130,170,0,11659,4400509,13.076923076923077
210,307,0,11660,4400816,14.619047619047619
290,428,0,11661,4401244,14.758620689655173
300,426,0,11662,4401670,14.2
390,670,0,11663,4402340,17.17948717948718
270,424,0,11664,4402764,15.703703703703704
190,252,0,11665,4403016,13.263157894736842
280,447,0,11666,4403463,15.964285714285714
110,178,0,11667,4403641,16.181818181818183
270,384,0,11668,4404025,14.222222222222221
230,339,0,11669,4404364,14.73913043478261
230,368,0,11670,4404732,16.0
390,598,0,11671,4405330,15.333333333333334
330,451,0,11672,4405781,13.666666666666666
200,262,0,11673,4406043,13.1
230,368,0,11674,4406411,16.0
330,577,0,11675,4406988,17.484848484848484
80,132,0,11676,4407120,16.5
170,307,0,11677,4407427,18.058823529411764
370,585,0,11678,4408012,15.81081081081081
310,434,0,11679,4408446,14.0
480,654,0,11680,4409100,13.625
190,253,0,11681,4409353,13.31578947368421
200,294,0,11682,4409647,14.7
290,440,0,11683,4410087,15.172413793103448
360,497,0,11684,4410584,13.805555555555555
470,644,0,11685,4411228,13.702127659574469
480,762,0,11686,4411990,15.875
390,602,0,11687,4412592,15.435897435897436
200,300,0,11688,4412892,15.0
120,159,0,11689,4413051,13.25
240,364,0,11690,4413415,15.166666666666666
330,498,0,11691,4413913,15.090909090909092
440,771,0,11692,4414684,17.522727272727273
250,451,0,11693,4415135,18.04
260,325,0,11694,4415460,12.5
370,701,0,11695,4416161,18.945945945945947
190,270,0,11696,4416431,14.210526315789474
170,219,0,11697,4416650,12.882352941176471
420,751,0,11698,4417401,17.88095238095238
400,635,0,11699,4418036,15.875
550,824,0,11700,4418860,14.981818181818182
360,570,0,11701,4419430,15.833333333333334
270,351,0,11702,4419781,13.0
100,138,0,11703,4419919,13.8
210,318,0,11704,4420237,15.142857142857142
270,305,0,11705,4420542,11.296296296296296
510,910,0,11706,4421452,17.84313725490196
160,215,0,11707,4421667,13.4375
150,221,0,11708,4421888,14.733333333333333
240,361,0,11709,4422249,15.041666666666666
330,513,0,11710,4422762,15.545454545454545
200,319,0,11711,4423081,15.95
290,377,0,11712,4423458,13.0
300,478,0,11713,4423936,15.933333333333334
170,253,0,11714,4424189,14.882352941176471
200,255,0,11715,4424444,12.75
320,484,0,11716,4424928,15.125
230,329,0,11717,4425257,14.304347826086957
400,591,0,11718,4425848,14.775
300,403,0,11719,4426251,13.433333333333334
190,231,0,11720,4426482,12.157894736842104
240,336,0,11721,4426818,14.0
70,86,0,11722,4426904,12.285714285714286
280,409,0,11723,4427313,14.607142857142858
330,484,0,11724,4427797,14.666666666666666
120,160,0,11725,4427957,13.333333333333334
260,347,0,11726,4428304,13.346153846153847
160,194,0,11727,4428498,12.125
350,545,0,11728,4429043,15.571428571428571
60,55,0,11729,4429098,9.166666666666666
150,223,0,11730,4429321,14.866666666666667
330,508,0,11731,4429829,15.393939393939394
360,641,0,11732,4430470,17.805555555555557
320,491,0,11733,4430961,15.34375
470,759,0,11734,4431720,16.148936170212767
350,575,0,11735,4432295,16.428571428571427
280,479,0,11736,4432774,17.107142857142858
110,139,0,11737,4432913,12.636363636363637
330,460,0,11738,4433373,13.93939393939394
230,367,0,11739,4433740,15.956521739130435
250,372,0,11740,4434112,14.88
200,312,0,11741,4434424,15.6
150,240,0,11742,4434664,16.0
170,230,0,11743,4434894,13.529411764705882
460,649,0,11744,4435543,14.108695652173912
250,289,0,11745,4435832,11.56
460,792,0,11746,4436624,17.217391304347824
210,249,0,11747,4436873,11.857142857142858
270,316,0,11748,4437189,11.703703703703704
220,275,0,11749,4437464,12.5
270,461,0,11750,4437925,17.074074074074073
290,386,0,11751,4438311,13.310344827586206
150,233,0,11752,4438544,15.533333333333333
270,403,0,11753,4438947,14.925925925925926
100,112,0,11754,4439059,11.2
120,156,0,11755,4439215,13.0
270,486,0,11756,4439701,18.0
200,249,0,11757,4439950,12.45
110,113,0,11758,4440063,10.272727272727273
220,235,0,11759,4440298,10.681818181818182
90,108,0,11760,4440406,12.0
150,221,0,11761,4440627,14.733333333333333
480,760,0,11762,4441387,15.833333333333334
400,628,0,11763,4442015,15.7
350,598,0,11764,4442613,17.085714285714285
250,339,0,11765,4442952,13.56
430,650,0,11766,4443602,15.116279069767442
360,453,0,11767,4444055,12.583333333333334
170,191,0,11768,4444246,11.235294117647058
350,612,0,11769,4444858,17.485714285714284
150,210,0,11770,4445068,14.0
260,436,0,11771,4445504,16.76923076923077
220,328,0,11772,4445832,14.909090909090908
340,474,0,11773,4446306,13.941176470588236
330,476,0,11774,4446782,14.424242424242424
230,337,0,11775,4447119,14.652173913043478
290,446,0,11776,4447565,15.379310344827585
160,230,0,11777,4447795,14.375
310,464,0,11778,4448259,14.96774193548387
450,774,0,11779,4449033,17.2
160,233,0,11780,4449266,14.5625
240,359,0,11781,4449625,14.958333333333334
320,495,0,11782,4450120,15.46875
280,388,0,11783,4450508,13.857142857142858
300,494,0,11784,4451002,16.466666666666665
180,278,0,11785,4451280,15.444444444444445
160,181,0,11786,4451461,11.3125
230,327,0,11787,4451788,14.217391304347826
280,386,0,11788,4452174,13.785714285714286
320,424,0,11789,4452598,13.25
210,246,0,11790,4452844,11.714285714285714
340,524,0,11791,4453368,15.411764705882353
240,400,0,11792,4453768,16.666666666666668
230,320,0,11793,4454088,13.91304347826087
260,357,0,11794,4454445,13.73076923076923
190,294,0,11795,4454739,15.473684210526315
200,232,0,11796,4454971,11.6
230,358,0,11797,4455329,15.565217391304348
450,715,0,11798,4456044,15.88888888888889
260,435,0,11799,4456479,16.73076923076923
310,487,0,11800,4456966,15.709677419354838
70,81,0,11801,4457047,11.571428571428571
150,187,0,11802,4457234,12.466666666666667
220,406,0,11803,4457640,18.454545454545453
320,519,0,11804,4458159,16.21875
90,106,0,11805,4458265,11.777777777777779
200,316,0,11806,4458581,15.8
270,429,0,11807,4459010,15.88888888888889
300,426,0,11808,4459436,14.2
230,304,0,11809,4459740,13.217391304347826
210,281,0,11810,4460021,13.380952380952381
150,161,0,11811,4460182,10.733333333333333
430,705,0,11812,4460887,16.3953488372093
80,71,0,11813,4460958,8.875
370,667,0,11814,4461625,18.027027027027028
250,404,0,11815,4462029,16.16
360,546,0,11816,4462575,15.166666666666666
240,344,0,11817,4462919,14.333333333333334
220,320,0,11818,4463239,14.545454545454545
270,418,0,11819,4463657,15.481481481481481
250,284,0,11820,4463941,11.36
170,231,0,11821,4464172,13.588235294117647
260,335,0,11822,4464507,12.884615384615385
80,107,0,11823,4464614,13.375
410,516,0,11824,4465130,12.585365853658537
280,401,0,11825,4465531,14.321428571428571
290,398,0,11826,4465929,13.724137931034482
200,267,0,11827,4466196,13.35
220,318,0,11828,4466514,14.454545454545455
240,351,0,11829,4466865,14.625
290,477,0,11830,4467342,16.448275862068964
260,401,0,11831,4467743,15.423076923076923
200,243,0,11832,4467986,12.15
40,44,0,11833,4468030,11.0
170,195,0,11834,4468225,11.470588235294118
250,353,0,11835,4468578,14.12
420,762,0,11836,4469340,18.142857142857142
260,404,0,11837,4469744,15.538461538461538
370,563,0,11838,4470307,15.216216216216216
350,632,0,11839,4470939,18.057142857142857
60,55,0,11840,4470994,9.166666666666666
190,238,0,11841,4471232,12.526315789473685
200,287,0,11842,4471519,14.35
220,334,0,11843,4471853,15.181818181818182
310,520,0,11844,4472373,16.774193548387096
170,205,0,11845,4472578,12.058823529411764
190,233,0,11846,4472811,12.263157894736842
380,519,0,11847,4473330,13.657894736842104
520,795,0,11848,4474125,15.288461538461538
200,268,0,11849,4474393,13.4
500,785,0,11850,4475178,15.7
220,315,0,11851,4475493,14.318181818181818
310,493,0,11852,4475986,15.903225806451612
130,153,0,11853,4476139,11.76923076923077
140,197,0,11854,4476336,14.071428571428571
140,174,0,11855,4476510,12.428571428571429
180,247,0,11856,4476757,13.722222222222221
400,633,0,11857,4477390,15.825
360,513,0,11858,4477903,14.25
220,216,0,11859,4478119,9.818181818181818
200,296,0,11860,4478415,14.8
270,418,0,11861,4478833,15.481481481481481
140,198,0,11862,4479031,14.142857142857142
70,97,0,11863,4479128,13.857142857142858
220,310,0,11864,4479438,14.090909090909092
450,635,0,11865,4480073,14.11111111111111
180,306,0,11866,4480379,17.0
160,239,0,11867,4480618,14.9375
220,286,0,11868,4480904,13.0
180,252,0,11869,4481156,14.0
330,516,0,11870,4481672,15.636363636363637
140,216,0,11871,4481888,15.428571428571429
330,453,0,11872,4482341,13.727272727272727
360,504,0,11873,4482845,14.0
350,527,0,11874,4483372,15.057142857142857
320,441,0,11875,4483813,13.78125
360,483,0,11876,4484296,13.416666666666666
270,421,0,11877,4484717,15.592592592592593
280,411,0,11878,4485128,14.678571428571429
220,315,0,11879,4485443,14.318181818181818
200,253,0,11880,4485696,12.65
220,288,0,11881,4485984,13.090909090909092
190,272,0,11882,4486256,14.31578947368421
200,297,0,11883,4486553,14.85
250,342,0,11884,4486895,13.68
230,318,0,11885,4487213,13.826086956521738
180,256,0,11886,4487469,14.222222222222221
130,178,0,11887,4487647,13.692307692307692
70,67,0,11888,4487714,9.571428571428571
100,129,0,11889,4487843,12.9
330,454,0,11890,4488297,13.757575757575758
130,197,0,11891,4488494,15.153846153846153
200,254,0,11892,4488748,12.7
260,342,0,11893,4489090,13.153846153846153
130,168,0,11894,4489258,12.923076923076923
70,52,0,11895,4489310,7.428571428571429
180,244,0,11896,4489554,13.555555555555555
350,532,0,11897,4490086,15.2
220,280,0,11898,4490366,12.727272727272727
350,513,0,11899,4490879,14.657142857142857
340,575,0,11900,4491454,16.91176470588235
120,162,0,11901,4491616,13.5
290,385,0,11902,4492001,13.275862068965518
130,176,0,11903,4492177,13.538461538461538
150,188,0,11904,4492365,12.533333333333333
280,397,0,11905,4492762,14.178571428571429
360,548,0,11906,4493310,15.222222222222221
220,286,0,11907,4493596,13.0
300,460,0,11908,4494056,15.333333333333334
170,305,0,11909,4494361,17.941176470588236
280,393,0,11910,4494754,14.035714285714286
160,215,0,11911,4494969,13.4375
160,221,0,11912,4495190,13.8125
170,256,0,11913,4495446,15.058823529411764
150,204,0,11914,4495650,13.6
170,266,0,11915,4495916,15.647058823529411
240,317,0,11916,4496233,13.208333333333334
200,306,0,11917,4496539,15.3
230,350,0,11918,4496889,15.217391304347826
240,383,0,11919,4497272,15.958333333333334
320,474,0,11920,4497746,14.8125
280,347,0,11921,4498093,12.392857142857142
180,303,0,11922,4498396,16.833333333333332
180,317,0,11923,4498713,17.61111111111111
210,329,0,11924,4499042,15.666666666666666
330,556,0,11925,4499598,16.848484848484848
190,270,0,11926,4499868,14.210526315789474
140,172,0,11927,4500040,12.285714285714286
360,560,0,11928,4500600,15.555555555555555
270,456,0,11929,4501056,16.88888888888889
380,560,0,11930,4501616,14.736842105263158
230,315,0,11931,4501931,13.695652173913043
230,316,0,11932,4502247,13.73913043478261
340,529,0,11933,4502776,15.558823529411764
380,621,0,11934,4503397,16.342105263157894
300,496,0,11935,4503893,16.533333333333335
260,405,0,11936,4504298,15.576923076923077
320,504,0,11937,4504802,15.75
460,696,0,11938,4505498,15.130434782608695
350,555,0,11939,4506053,15.857142857142858
170,302,0,11940,4506355,17.764705882352942
170,242,0,11941,4506597,14.235294117647058
200,317,0,11942,4506914,15.85
170,211,0,11943,4507125,12.411764705882353
200,336,0,11944,4507461,16.8
170,217,0,11945,4507678,12.764705882352942
200,302,0,11946,4507980,15.1
150,218,0,11947,4508198,14.533333333333333
310,498,0,11948,4508696,16.06451612903226
340,460,0,11949,4509156,13.529411764705882
230,392,0,11950,4509548,17.043478260869566
150,177,0,11951,4509725,11.8
330,506,0,11952,4510231,15.333333333333334
280,415,0,11953,4510646,14.821428571428571
160,205,0,11954,4510851,12.8125
140,211,0,11955,4511062,15.071428571428571
310,414,0,11956,4511476,13.35483870967742
290,450,0,11957,4511926,15.517241379310345
410,623,0,11958,4512549,15.195121951219512
280,305,0,11959,4512854,10.892857142857142
260,426,0,11960,4513280,16.384615384615383
330,439,0,11961,4513719,13.303030303030303
130,203,0,11962,4513922,15.615384615384615
300,423,0,11963,4514345,14.1
200,273,0,11964,4514618,13.65
310,498,0,11965,4515116,16.06451612903226
410,581,0,11966,4515697,14.170731707317072
320,546,0,11967,4516243,17.0625
380,644,0,11968,4516887,16.94736842105263
180,240,0,11969,4517127,13.333333333333334
140,197,0,11970,4517324,14.071428571428571
310,458,0,11971,4517782,14.774193548387096
240,340,0,11972,4518122,14.166666666666666
540,839,0,11973,4518961,15.537037037037036
150,217,0,11974,4519178,14.466666666666667
230,351,0,11975,4519529,15.26086956521739
240,295,0,11976,4519824,12.291666666666666
350,481,0,11977,4520305,13.742857142857142
150,197,0,11978,4520502,13.133333333333333
260,326,0,11979,4520828,12.538461538461538
250,407,0,11980,4521235,16.28
230,284,0,11981,4521519,12.347826086956522
210,323,0,11982,4521842,15.380952380952381
350,479,0,11983,4522321,13.685714285714285
180,266,0,11984,4522587,14.777777777777779
240,295,0,11985,4522882,12.291666666666666
230,294,0,11986,4523176,12.782608695652174
150,170,0,11987,4523346,11.333333333333334
240,335,0,11988,4523681,13.958333333333334
330,447,0,11989,4524128,13.545454545454545
310,548,0,11990,4524676,17.677419354838708
390,637,0,11991,4525313,16.333333333333332
340,559,0,11992,4525872,16.441176470588236
280,384,0,11993,4526256,13.714285714285714
140,165,0,11994,4526421,11.785714285714286
130,152,0,11995,4526573,11.692307692307692
110,146,0,11996,4526719,13.272727272727273
380,651,0,11997,4527370,17.13157894736842
270,404,0,11998,4527774,14.962962962962964
320,408,0,11999,4528182,12.75
290,466,0,12000,4528648,16.06896551724138
160,254,0,12001,4528902,15.875
300,427,0,12002,4529329,14.233333333333333
150,217,0,12003,4529546,14.466666666666667
140,227,0,12004,4529773,16.214285714285715
230,356,0,12005,4530129,15.478260869565217
310,455,0,12006,4530584,14.67741935483871
220,386,0,12007,4530970,17.545454545454547
270,419,0,12008,4531389,15.518518518518519
280,466,0,12009,4531855,16.642857142857142
190,259,0,12010,4532114,13.631578947368421
180,267,0,12011,4532381,14.833333333333334
260,348,0,12012,4532729,13.384615384615385
280,417,0,12013,4533146,14.892857142857142
160,205,0,12014,4533351,12.8125
210,340,0,12015,4533691,16.19047619047619
310,491,0,12016,4534182,15.838709677419354
230,301,0,12017,4534483,13.08695652173913
340,449,0,12018,4534932,13.205882352941176
390,619,0,12019,4535551,15.871794871794872
110,120,0,12020,4535671,10.909090909090908
190,285,0,12021,4535956,15.0
270,343,0,12022,4536299,12.703703703703704
330,443,0,12023,4536742,13.424242424242424
210,293,0,12024,4537035,13.952380952380953
360,519,0,12025,4537554,14.416666666666666
250,398,0,12026,4537952,15.92
190,326,0,12027,4538278,17.157894736842106
210,363,0,12028,4538641,17.285714285714285
200,268,0,12029,4538909,13.4
200,306,0,12030,4539215,15.3
510,859,0,12031,4540074,16.84313725490196
200,300,0,12032,4540374,15.0
260,384,0,12033,4540758,14.76923076923077
190,238,0,12034,4540996,12.526315789473685
220,305,0,12035,4541301,13.863636363636363
460,794,0,12036,4542095,17.26086956521739
170,212,0,12037,4542307,12.470588235294118
130,184,0,12038,4542491,14.153846153846153
190,263,0,12039,4542754,13.842105263157896
190,288,0,12040,4543042,15.157894736842104
320,531,0,12041,4543573,16.59375
210,320,0,12042,4543893,15.238095238095237
290,389,0,12043,4544282,13.413793103448276
140,214,0,12044,4544496,15.285714285714286
150,196,0,12045,4544692,13.066666666666666
210,293,0,12046,4544985,13.952380952380953
200,273,0,12047,4545258,13.65
190,282,0,12048,4545540,14.842105263157896
270,390,0,12049,4545930,14.444444444444445
260,404,0,12050,4546334,15.538461538461538
200,274,0,12051,4546608,13.7
200,338,0,12052,4546946,16.9
310,493,0,12053,4547439,15.903225806451612
190,251,0,12054,4547690,13.210526315789474
220,292,0,12055,4547982,13.272727272727273
180,289,0,12056,4548271,16.055555555555557
160,221,0,12057,4548492,13.8125
180,240,0,12058,4548732,13.333333333333334
270,381,0,12059,4549113,14.11111111111111
180,239,0,12060,4549352,13.277777777777779
300,454,0,12061,4549806,15.133333333333333
250,323,0,12062,4550129,12.92
170,229,0,12063,4550358,13.470588235294118
200,398,0,12064,4550756,19.9
350,517,0,12065,4551273,14.771428571428572
250,360,0,12066,4551633,14.4
160,208,0,12067,4551841,13.0
570,949,0,12068,4552790,16.649122807017545
530,954,0,12069,4553744,18.0
350,586,0,12070,4554330,16.742857142857144
70,101,0,12071,4554431,14.428571428571429
220,342,0,12072,4554773,15.545454545454545
200,281,0,12073,4555054,14.05
320,475,0,12074,4555529,14.84375
280,384,0,12075,4555913,13.714285714285714
120,166,0,12076,4556079,13.833333333333334
470,762,0,12077,4556841,16.21276595744681
200,315,0,12078,4557156,15.75
260,367,0,12079,4557523,14.115384615384615
400,628,0,12080,4558151,15.7
170,232,0,12081,4558383,13.647058823529411
350,539,0,12082,4558922,15.4
260,427,0,12083,4559349,16.423076923076923
410,624,0,12084,4559973,15.21951219512195
240,367,0,12085,4560340,15.291666666666666
160,217,0,12086,4560557,13.5625
310,505,0,12087,4561062,16.29032258064516
160,229,0,12088,4561291,14.3125
280,438,0,12089,4561729,15.642857142857142
240,410,0,12090,4562139,17.083333333333332
160,190,0,12091,4562329,11.875
280,441,0,12092,4562770,15.75
240,367,0,12093,4563137,15.291666666666666
110,203,0,12094,4563340,18.454545454545453
310,421,0,12095,4563761,13.580645161290322
150,200,0,12096,4563961,13.333333333333334
180,286,0,12097,4564247,15.88888888888889
260,329,0,12098,4564576,12.653846153846153
340,539,0,12099,4565115,15.852941176470589
410,710,0,12100,4565825,17.317073170731707
410,650,0,12101,4566475,15.853658536585366
220,352,0,12102,4566827,16.0
380,559,0,12103,4567386,14.710526315789474
60,80,0,12104,4567466,13.333333333333334
200,303,0,12105,4567769,15.15
540,810,0,12106,4568579,15.0
80,61,0,12107,4568640,7.625
310,439,0,12108,4569079,14.161290322580646
130,206,0,12109,4569285,15.846153846153847
430,658,0,12110,4569943,15.30232558139535
220,307,0,12111,4570250,13.954545454545455
440,750,0,12112,4571000,17.045454545454547
310,361,0,12113,4571361,11.64516129032258
280,478,0,12114,4571839,17.071428571428573
390,650,0,12115,4572489,16.666666666666668
350,512,0,12116,4573001,14.628571428571428
210,298,0,12117,4573299,14.19047619047619
340,578,0,12118,4573877,17.0
230,357,0,12119,4574234,15.521739130434783
150,218,0,12120,4574452,14.533333333333333
260,340,0,12121,4574792,13.076923076923077
110,136,0,12122,4574928,12.363636363636363
160,258,0,12123,4575186,16.125
240,346,0,12124,4575532,14.416666666666666
240,414,0,12125,4575946,17.25
480,754,0,12126,4576700,15.708333333333334
400,719,0,12127,4577419,17.975
120,172,0,12128,4577591,14.333333333333334
350,551,0,12129,4578142,15.742857142857142
270,401,0,12130,4578543,14.851851851851851
200,304,0,12131,4578847,15.2
530,873,0,12132,4579720,16.471698113207548
270,355,0,12133,4580075,13.148148148148149
210,290,0,12134,4580365,13.80952380952381
270,363,0,12135,4580728,13.444444444444445
100,127,0,12136,4580855,12.7
140,246,0,12137,4581101,17.571428571428573
400,637,0,12138,4581738,15.925
250,342,0,12139,4582080,13.68
340,470,0,12140,4582550,13.823529411764707
300,382,0,12141,4582932,12.733333333333333
320,493,0,12142,4583425,15.40625
160,189,0,12143,4583614,11.8125
340,551,0,12144,4584165,16.205882352941178
100,106,0,12145,4584271,10.6
310,481,0,12146,4584752,15.516129032258064
110,160,0,12147,4584912,14.545454545454545
260,360,0,12148,4585272,13.846153846153847
390,545,0,12149,4585817,13.974358974358974
140,182,0,12150,4585999,13.0
350,614,0,12151,4586613,17.542857142857144
280,336,0,12152,4586949,12.0
100,125,0,12153,4587074,12.5
120,153,0,12154,4587227,12.75
500,845,0,12155,4588072,16.9
120,171,0,12156,4588243,14.25
200,302,0,12157,4588545,15.1
450,620,0,12158,4589165,13.777777777777779
210,345,0,12159,4589510,16.428571428571427
170,240,0,12160,4589750,14.117647058823529
110,181,0,12161,4589931,16.454545454545453
320,558,0,12162,4590489,17.4375
230,400,0,12163,4590889,17.391304347826086
280,493,0,12164,4591382,17.607142857142858
230,334,0,12165,4591716,14.521739130434783
340,598,0,12166,4592314,17.58823529411765
170,248,0,12167,4592562,14.588235294117647
210,262,0,12168,4592824,12.476190476190476
220,279,0,12169,4593103,12.681818181818182
230,313,0,12170,4593416,13.608695652173912
170,194,0,12171,4593610,11.411764705882353
410,598,0,12172,4594208,14.585365853658537
200,297,0,12173,4594505,14.85
320,493,0,12174,4594998,15.40625
270,394,0,12175,4595392,14.592592592592593
220,275,0,12176,4595667,12.5
70,86,0,12177,4595753,12.285714285714286
290,410,0,12178,4596163,14.137931034482758
210,317,0,12179,4596480,15.095238095238095
200,283,0,12180,4596763,14.15
210,312,0,12181,4597075,14.857142857142858
210,341,0,12182,4597416,16.238095238095237
260,388,0,12183,4597804,14.923076923076923
190,260,0,12184,4598064,13.68421052631579
150,166,0,12185,4598230,11.066666666666666
180,264,0,12186,4598494,14.666666666666666
240,354,0,12187,4598848,14.75
290,430,0,12188,4599278,14.827586206896552
250,337,0,12189,4599615,13.48
170,224,0,12190,4599839,13.176470588235293
280,436,0,12191,4600275,15.571428571428571
290,424,0,12192,4600699,14.620689655172415
190,309,0,12193,4601008,16.263157894736842
280,409,0,12194,4601417,14.607142857142858
260,406,0,12195,4601823,15.615384615384615
280,463,0,12196,4602286,16.535714285714285
150,222,0,12197,4602508,14.8
160,176,0,12198,4602684,11.0
260,366,0,12199,4603050,14.076923076923077
350,529,0,12200,4603579,15.114285714285714
240,374,0,12201,4603953,15.583333333333334
150,208,0,12202,4604161,13.866666666666667
190,263,0,12203,4604424,13.842105263157896
360,528,0,12204,4604952,14.666666666666666
260,345,0,12205,4605297,13.26923076923077
200,285,0,12206,4605582,14.25
330,514,0,12207,4606096,15.575757575757576
300,540,0,12208,4606636,18.0
220,305,0,12209,4606941,13.863636363636363
170,278,0,12210,4607219,16.352941176470587
400,635,0,12211,4607854,15.875
140,167,0,12212,4608021,11.928571428571429
280,390,0,12213,4608411,13.928571428571429
240,316,0,12214,4608727,13.166666666666666
270,389,0,12215,4609116,14.407407407407407
380,652,0,12216,4609768,17.157894736842106
240,325,0,12217,4610093,13.541666666666666
130,181,0,12218,4610274,13.923076923076923
230,357,0,12219,4610631,15.521739130434783
100,91,0,12220,4610722,9.1
530,845,0,12221,4611567,15.943396226415095
170,221,0,12222,4611788,13.0
270,319,0,12223,4612107,11.814814814814815
270,363,0,12224,4612470,13.444444444444445
310,401,0,12225,4612871,12.935483870967742
300,465,0,12226,4613336,15.5
110,158,0,12227,4613494,14.363636363636363
230,312,0,12228,4613806,13.565217391304348
460,763,0,12229,4614569,16.58695652173913
90,132,0,12230,4614701,14.666666666666666
260,410,0,12231,4615111,15.76923076923077
120,157,0,12232,4615268,13.083333333333334
250,390,0,12233,4615658,15.6
260,355,0,12234,4616013,13.653846153846153
130,200,0,12235,4616213,15.384615384615385
400,643,0,12236,4616856,16.075
210,253,0,12237,4617109,12.047619047619047
180,228,0,12238,4617337,12.666666666666666
300,439,0,12239,4617776,14.633333333333333
220,267,0,12240,4618043,12.136363636363637
320,532,0,12241,4618575,16.625
460,762,0,12242,4619337,16.565217391304348
150,281,0,12243,4619618,18.733333333333334
440,777,0,12244,4620395,17.65909090909091
290,491,0,12245,4620886,16.93103448275862
180,289,0,12246,4621175,16.055555555555557
470,766,0,12247,4621941,16.29787234042553
210,276,0,12248,4622217,13.142857142857142
290,464,0,12249,4622681,16.0
310,474,0,12250,4623155,15.290322580645162
210,348,0,12251,4623503,16.571428571428573
170,225,0,12252,4623728,13.235294117647058
80,92,0,12253,4623820,11.5
280,410,0,12254,4624230,14.642857142857142
140,206,0,12255,4624436,14.714285714285714
240,271,0,12256,4624707,11.291666666666666
210,337,0,12257,4625044,16.047619047619047
230,321,0,12258,4625365,13.956521739130435
360,568,0,12259,4625933,15.777777777777779
390,623,0,12260,4626556,15.974358974358974
360,616,0,12261,4627172,17.11111111111111
240,397,0,12262,4627569,16.541666666666668
240,383,0,12263,4627952,15.958333333333334
260,414,0,12264,4628366,15.923076923076923
240,376,0,12265,4628742,15.666666666666666
360,538,0,12266,4629280,14.944444444444445
250,394,0,12267,4629674,15.76
280,397,0,12268,4630071,14.178571428571429
340,542,0,12269,4630613,15.941176470588236
400,709,0,12270,4631322,17.725
140,144,0,12271,4631466,10.285714285714286
260,378,0,12272,4631844,14.538461538461538
420,705,0,12273,4632549,16.785714285714285
270,427,0,12274,4632976,15.814814814814815
170,230,0,12275,4633206,13.529411764705882
470,625,0,12276,4633831,13.297872340425531
310,468,0,12277,4634299,15.096774193548388
510,1078,0,12278,4635377,21.137254901960784
250,309,0,12279,4635686,12.36
250,344,0,12280,4636030,13.76
170,210,0,12281,4636240,12.352941176470589
290,402,0,12282,4636642,13.862068965517242
170,272,0,12283,4636914,16.0
240,378,0,12284,4637292,15.75
200,295,0,12285,4637587,14.75
130,155,0,12286,4637742,11.923076923076923
250,345,0,12287,4638087,13.8
430,703,0,12288,4638790,16.348837209302324
220,319,0,12289,4639109,14.5
340,580,0,12290,4639689,17.058823529411764
250,329,0,12291,4640018,13.16
270,397,0,12292,4640415,14.703703703703704
270,494,0,12293,4640909,18.296296296296298
250,376,0,12294,4641285,15.04
400,663,0,12295,4641948,16.575
300,350,0,12296,4642298,11.666666666666666
360,508,0,12297,4642806,14.11111111111111
370,625,0,12298,4643431,16.89189189189189
180,234,0,12299,4643665,13.0
260,367,0,12300,4644032,14.115384615384615
350,525,0,12301,4644557,15.0
320,504,0,12302,4645061,15.75
300,439,0,12303,4645500,14.633333333333333
190,265,0,12304,4645765,13.947368421052632
330,476,0,12305,4646241,14.424242424242424
140,205,0,12306,4646446,14.642857142857142
280,431,0,12307,4646877,15.392857142857142
330,470,0,12308,4647347,14.242424242424242
190,282,0,12309,4647629,14.842105263157896
470,759,0,12310,4648388,16.148936170212767
220,293,0,12311,4648681,13.318181818181818
350,548,0,12312,4649229,15.657142857142857
430,629,0,12313,4649858,14.627906976744185
170,228,0,12314,4650086,13.411764705882353
270,483,0,12315,4650569,17.88888888888889
270,427,0,12316,4650996,15.814814814814815
430,750,0,12317,4651746,17.441860465116278
180,227,0,12318,4651973,12.61111111111111
470,799,0,12319,4652772,17.0
460,830,0,12320,4653602,18.043478260869566
220,346,0,12321,4653948,15.727272727272727
320,434,0,12322,4654382,13.5625
330,509,0,12323,4654891,15.424242424242424
210,304,0,12324,4655195,14.476190476190476
310,427,0,12325,4655622,13.774193548387096
130,166,0,12326,4655788,12.76923076923077
170,281,0,12327,4656069,16.529411764705884
170,191,0,12328,4656260,11.235294117647058
280,406,0,12329,4656666,14.5
290,400,0,12330,4657066,13.793103448275861
160,234,0,12331,4657300,14.625
220,305,0,12332,4657605,13.863636363636363
350,640,0,12333,4658245,18.285714285714285
320,461,0,12334,4658706,14.40625
90,130,0,12335,4658836,14.444444444444445
220,294,0,12336,4659130,13.363636363636363
240,261,0,12337,4659391,10.875
150,223,0,12338,4659614,14.866666666666667
200,270,0,12339,4659884,13.5
170,241,0,12340,4660125,14.176470588235293
150,233,0,12341,4660358,15.533333333333333
450,798,0,12342,4661156,17.733333333333334
250,332,0,12343,4661488,13.28
230,336,0,12344,4661824,14.608695652173912
190,222,0,12345,4662046,11.68421052631579
120,173,0,12346,4662219,14.416666666666666
370,540,0,12347,4662759,14.594594594594595
320,480,0,12348,4663239,15.0
210,266,0,12349,4663505,12.666666666666666
400,594,0,12350,4664099,14.85
460,754,0,12351,4664853,16.391304347826086
210,277,0,12352,4665130,13.19047619047619
150,154,0,12353,4665284,10.266666666666667
220,372,0,12354,4665656,16.90909090909091
290,450,0,12355,4666106,15.517241379310345
170,262,0,12356,4666368,15.411764705882353
390,652,0,12357,4667020,16.71794871794872
370,479,0,12358,4667499,12.945945945945946
360,578,0,12359,4668077,16.055555555555557
290,459,0,12360,4668536,15.827586206896552
290,450,0,12361,4668986,15.517241379310345
210,246,0,12362,4669232,11.714285714285714
300,477,0,12363,4669709,15.9
230,376,0,12364,4670085,16.347826086956523
150,203,0,12365,4670288,13.533333333333333
160,212,0,12366,4670500,13.25
400,546,0,12367,4671046,13.65
160,220,0,12368,4671266,13.75
220,304,0,12369,4671570,13.818181818181818
150,208,0,12370,4671778,13.866666666666667
270,430,0,12371,4672208,15.925925925925926
210,341,0,12372,4672549,16.238095238095237
470,854,0,12373,4673403,18.170212765957448
200,287,0,12374,4673690,14.35
340,520,0,12375,4674210,15.294117647058824
240,276,0,12376,4674486,11.5
450,717,0,12377,4675203,15.933333333333334
230,364,0,12378,4675567,15.826086956521738
70,95,0,12379,4675662,13.571428571428571
240,337,0,12380,4675999,14.041666666666666
330,557,0,12381,4676556,16.87878787878788
200,313,0,12382,4676869,15.65
100,145,0,12383,4677014,14.5
330,504,0,12384,4677518,15.272727272727273
120,140,0,12385,4677658,11.666666666666666
240,389,0,12386,4678047,16.208333333333332
240,387,0,12387,4678434,16.125
340,500,0,12388,4678934,14.705882352941176
280,431,0,12389,4679365,15.392857142857142
230,349,0,12390,4679714,15.173913043478262
200,264,0,12391,4679978,13.2
380,572,0,12392,4680550,15.052631578947368
150,171,0,12393,4680721,11.4
210,294,0,12394,4681015,14.0
220,327,0,12395,4681342,14.863636363636363
450,656,0,12396,4681998,14.577777777777778
330,595,0,12397,4682593,18.03030303030303
230,371,0,12398,4682964,16.130434782608695
330,538,0,12399,4683502,16.303030303030305
180,276,0,12400,4683778,15.333333333333334
250,470,0,12401,4684248,18.8
210,306,0,12402,4684554,14.571428571428571
180,274,0,12403,4684828,15.222222222222221
200,299,0,12404,4685127,14.95
120,148,0,12405,4685275,12.333333333333334
100,168,0,12406,4685443,16.8
380,609,0,12407,4686052,16.026315789473685
170,191,0,12408,4686243,11.235294117647058
210,234,0,12409,4686477,11.142857142857142
220,314,0,12410,4686791,14.272727272727273
150,271,0,12411,4687062,18.066666666666666
320,475,0,12412,4687537,14.84375
450,783,0,12413,4688320,17.4
250,378,0,12414,4688698,15.12
300,429,0,12415,4689127,14.3
130,154,0,12416,4689281,11.846153846153847
470,716,0,12417,4689997,15.23404255319149
220,334,0,12418,4690331,15.181818181818182
80,131,0,12419,4690462,16.375
240,368,0,12420,4690830,15.333333333333334
260,387,0,12421,4691217,14.884615384615385
270,410,0,12422,4691627,15.185185185185185
190,280,0,12423,4691907,14.736842105263158
270,418,0,12424,4692325,15.481481481481481
190,293,0,12425,4692618,15.421052631578947
360,514,0,12426,4693132,14.277777777777779
300,426,0,12427,4693558,14.2
410,766,0,12428,4694324,18.682926829268293
190,261,0,12429,4694585,13.736842105263158
240,371,0,12430,4694956,15.458333333333334
390,731,0,12431,4695687,18.743589743589745
260,371,0,12432,4696058,14.26923076923077
140,167,0,12433,4696225,11.928571428571429
220,308,0,12434,4696533,14.0
270,374,0,12435,4696907,13.851851851851851
210,329,0,12436,4697236,15.666666666666666
430,668,0,12437,4697904,15.534883720930232
270,423,0,12438,4698327,15.666666666666666
210,358,0,12439,4698685,17.047619047619047
200,298,0,12440,4698983,14.9
240,294,0,12441,4699277,12.25
410,749,0,12442,4700026,18.26829268292683
420,693,0,12443,4700719,16.5
380,581,0,12444,4701300,15.289473684210526
140,198,0,12445,4701498,14.142857142857142
340,528,0,12446,4702026,15.529411764705882
180,229,0,12447,4702255,12.722222222222221
520,917,0,12448,4703172,17.634615384615383
300,432,0,12449,4703604,14.4
270,348,0,12450,4703952,12.88888888888889
180,176,0,12451,4704128,9.777777777777779
230,284,0,12452,4704412,12.347826086956522
410,641,0,12453,4705053,15.634146341463415
320,463,0,12454,4705516,14.46875
200,317,0,12455,4705833,15.85
220,338,0,12456,4706171,15.363636363636363
100,105,0,12457,4706276,10.5
370,548,0,12458,4706824,14.81081081081081
120,191,0,12459,4707015,15.916666666666666
250,287,0,12460,4707302,11.48
260,349,0,12461,4707651,13.423076923076923
130,208,0,12462,4707859,16.0
80,95,0,12463,4707954,11.875
250,363,0,12464,4708317,14.52
320,494,0,12465,4708811,15.4375
130,147,0,12466,4708958,11.307692307692308
100,153,0,12467,4709111,15.3
190,269,0,12468,4709380,14.157894736842104
170,217,0,12469,4709597,12.764705882352942
140,198,0,12470,4709795,14.142857142857142
280,450,0,12471,4710245,16.071428571428573
260,347,0,12472,4710592,13.346153846153847
240,297,0,12473,4710889,12.375
370,556,0,12474,4711445,15.027027027027026
200,269,0,12475,4711714,13.45
330,532,0,12476,4712246,16.12121212121212
150,260,0,12477,4712506,17.333333333333332
240,316,0,12478,4712822,13.166666666666666
120,129,0,12479,4712951,10.75
330,547,0,12480,4713498,16.575757575757574
130,177,0,12481,4713675,13.615384615384615
410,615,0,12482,4714290,15.0
220,305,0,12483,4714595,13.863636363636363
210,291,0,12484,4714886,13.857142857142858
190,242,0,12485,4715128,12.736842105263158
400,744,0,12486,4715872,18.6
400,613,0,12487,4716485,15.325
240,298,0,12488,4716783,12.416666666666666
310,443,0,12489,4717226,14.290322580645162
250,373,0,12490,4717599,14.92
420,617,0,12491,4718216,14.69047619047619
320,457,0,12492,4718673,14.28125
270,347,0,12493,4719020,12.851851851851851
270,350,0,12494,4719370,12.962962962962964
160,265,0,12495,4719635,16.5625
230,361,0,12496,4719996,15.695652173913043
290,425,0,12497,4720421,14.655172413793103
190,209,0,12498,4720630,11.0
370,574,0,12499,4721204,15.513513513513514
280,410,0,12500,4721614,14.642857142857142
190,256,0,12501,4721870,13.473684210526315
350,526,0,12502,4722396,15.028571428571428
280,423,0,12503,4722819,15.107142857142858
150,205,0,12504,4723024,13.666666666666666
200,305,0,12505,4723329,15.25
250,362,0,12506,4723691,14.48
50,110,0,12507,4723801,22.0
170,255,0,12508,4724056,15.0
170,301,0,12509,4724357,17.705882352941178
270,368,0,12510,4724725,13.62962962962963
210,321,0,12511,4725046,15.285714285714286
310,504,0,12512,4725550,16.258064516129032
120,159,0,12513,4725709,13.25
250,332,0,12514,4726041,13.28
300,443,0,12515,4726484,14.766666666666667
130,146,0,12516,4726630,11.23076923076923
130,160,0,12517,4726790,12.307692307692308
410,678,0,12518,4727468,16.536585365853657
210,288,0,12519,4727756,13.714285714285714
280,451,0,12520,4728207,16.107142857142858
170,215,0,12521,4728422,12.647058823529411
230,392,0,12522,4728814,17.043478260869566
380,646,0,12523,4729460,17.0
430,769,0,12524,4730229,17.88372093023256
310,545,0,12525,4730774,17.580645161290324
110,139,0,12526,4730913,12.636363636363637
190,265,0,12527,4731178,13.947368421052632
120,132,0,12528,4731310,11.0
280,377,0,12529,4731687,13.464285714285714
150,266,0,12530,4731953,17.733333333333334
350,539,0,12531,4732492,15.4
270,448,0,12532,4732940,16.59259259259259
340,522,0,12533,4733462,15.352941176470589
290,425,0,12534,4733887,14.655172413793103
180,246,0,12535,4734133,13.666666666666666
230,300,0,12536,4734433,13.043478260869565
280,378,0,12537,4734811,13.5
160,290,0,12538,4735101,18.125
130,224,0,12539,4735325,17.23076923076923
120,137,0,12540,4735462,11.416666666666666
150,239,0,12541,4735701,15.933333333333334
210,268,0,12542,4735969,12.761904761904763
140,211,0,12543,4736180,15.071428571428571
180,289,0,12544,4736469,16.055555555555557
270,445,0,12545,4736914,16.48148148148148
160,200,0,12546,4737114,12.5
250,332,0,12547,4737446,13.28
290,434,0,12548,4737880,14.96551724137931
160,249,0,12549,4738129,15.5625
190,272,0,12550,4738401,14.31578947368421
360,622,0,12551,4739023,17.27777777777778
210,275,0,12552,4739298,13.095238095238095
210,381,0,12553,4739679,18.142857142857142
300,434,0,12554,4740113,14.466666666666667
280,443,0,12555,4740556,15.821428571428571
280,442,0,12556,4740998,15.785714285714286
230,331,0,12557,4741329,14.391304347826088
120,139,0,12558,4741468,11.583333333333334
280,438,0,12559,4741906,15.642857142857142
360,577,0,12560,4742483,16.02777777777778
290,519,0,12561,4743002,17.896551724137932
380,569,0,12562,4743571,14.973684210526315
150,198,0,12563,4743769,13.2
150,205,0,12564,4743974,13.666666666666666
380,579,0,12565,4744553,15.236842105263158
290,465,0,12566,4745018,16.03448275862069
150,218,0,12567,4745236,14.533333333333333
490,879,0,12568,4746115,17.93877551020408
140,186,0,12569,4746301,13.285714285714286
280,368,0,12570,4746669,13.142857142857142
360,654,0,12571,4747323,18.166666666666668
180,277,0,12572,4747600,15.38888888888889
320,525,0,12573,4748125,16.40625
300,438,0,12574,4748563,14.6
170,319,0,12575,4748882,18.764705882352942
310,490,0,12576,4749372,15.806451612903226
310,368,0,12577,4749740,11.870967741935484
210,264,0,12578,4750004,12.571428571428571
470,705,0,12579,4750709,15.0
520,823,0,12580,4751532,15.826923076923077
120,161,0,12581,4751693,13.416666666666666
400,611,0,12582,4752304,15.275
110,145,0,12583,4752449,13.181818181818182
230,285,0,12584,4752734,12.391304347826088
180,309,0,12585,4753043,17.166666666666668
360,623,0,12586,4753666,17.305555555555557
160,201,0,12587,4753867,12.5625
510,748,0,12588,4754615,14.666666666666666
240,332,0,12589,4754947,13.833333333333334
340,529,0,12590,4755476,15.558823529411764
150,217,0,12591,4755693,14.466666666666667
340,539,0,12592,4756232,15.852941176470589
190,219,0,12593,4756451,11.526315789473685
220,337,0,12594,4756788,15.318181818181818
220,323,0,12595,4757111,14.681818181818182
210,326,0,12596,4757437,15.523809523809524
420,642,0,12597,4758079,15.285714285714286
230,319,0,12598,4758398,13.869565217391305
400,604,0,12599,4759002,15.1
210,370,0,12600,4759372,17.61904761904762
140,148,0,12601,4759520,10.571428571428571
350,530,0,12602,4760050,15.142857142857142
280,378,0,12603,4760428,13.5
100,102,0,12604,4760530,10.2
190,229,0,12605,4760759,12.052631578947368
380,526,0,12606,4761285,13.842105263157896
170,272,0,12607,4761557,16.0
280,525,0,12608,4762082,18.75
340,564,0,12609,4762646,16.58823529411765
120,142,0,12610,4762788,11.833333333333334
450,660,0,12611,4763448,14.666666666666666
190,278,0,12612,4763726,14.631578947368421
270,388,0,12613,4764114,14.37037037037037
450,705,0,12614,4764819,15.666666666666666
230,282,0,12615,4765101,12.26086956521739
190,263,0,12616,4765364,13.842105263157896
220,258,0,12617,4765622,11.727272727272727
410,726,0,12618,4766348,17.70731707317073
240,369,0,12619,4766717,15.375
200,246,0,12620,4766963,12.3
190,293,0,12621,4767256,15.421052631578947
180,281,0,12622,4767537,15.61111111111111
210,326,0,12623,4767863,15.523809523809524
320,520,0,12624,4768383,16.25
220,262,0,12625,4768645,11.909090909090908
240,405,0,12626,4769050,16.875
170,278,0,12627,4769328,16.352941176470587
170,225,0,12628,4769553,13.235294117647058
120,145,0,12629,4769698,12.083333333333334
170,274,0,12630,4769972,16.11764705882353
140,189,0,12631,4770161,13.5
260,372,0,12632,4770533,14.307692307692308
230,253,0,12633,4770786,11.0
220,413,0,12634,4771199,18.772727272727273
280,416,0,12635,4771615,14.857142857142858
330,495,0,12636,4772110,15.0
210,303,0,12637,4772413,14.428571428571429
150,223,0,12638,4772636,14.866666666666667
300,493,0,12639,4773129,16.433333333333334
140,135,0,12640,4773264,9.642857142857142
180,281,0,12641,4773545,15.61111111111111
340,465,0,12642,4774010,13.676470588235293
250,378,0,12643,4774388,15.12
320,537,0,12644,4774925,16.78125
210,273,0,12645,4775198,13.0
450,773,0,12646,4775971,17.177777777777777
400,655,0,12647,4776626,16.375
280,469,0,12648,4777095,16.75
220,352,0,12649,4777447,16.0
310,461,0,12650,4777908,14.870967741935484
280,497,0,12651,4778405,17.75
360,479,0,12652,4778884,13.305555555555555
210,289,0,12653,4779173,13.761904761904763
390,522,0,12654,4779695,13.384615384615385
230,292,0,12655,4779987,12.695652173913043
200,261,0,12656,4780248,13.05
130,169,0,12657,4780417,13.0
390,659,0,12658,4781076,16.897435897435898
460,765,0,12659,4781841,16.630434782608695
280,335,0,12660,4782176,11.964285714285714
300,411,0,12661,4782587,13.7
230,300,0,12662,4782887,13.043478260869565
330,444,0,12663,4783331,13.454545454545455
320,435,0,12664,4783766,13.59375
310,477,0,12665,4784243,15.387096774193548
140,224,0,12666,4784467,16.0
270,415,0,12667,4784882,15.37037037037037
150,278,0,12668,4785160,18.533333333333335
180,284,0,12669,4785444,15.777777777777779
180,234,0,12670,4785678,13.0
300,466,0,12671,4786144,15.533333333333333
140,239,0,12672,4786383,17.071428571428573
200,261,0,12673,4786644,13.05
220,327,0,12674,4786971,14.863636363636363
520,867,0,12675,4787838,16.673076923076923
150,174,0,12676,4788012,11.6
270,373,0,12677,4788385,13.814814814814815
420,711,0,12678,4789096,16.928571428571427
510,960,0,12679,4790056,18.823529411764707
290,400,0,12680,4790456,13.793103448275861
240,258,0,12681,4790714,10.75
160,256,0,12682,4790970,16.0
260,348,0,12683,4791318,13.384615384615385
340,595,0,12684,4791913,17.5
150,256,0,12685,4792169,17.066666666666666
370,549,0,12686,4792718,14.837837837837839
240,419,0,12687,4793137,17.458333333333332
240,432,0,12688,4793569,18.0
140,147,0,12689,4793716,10.5
270,419,0,12690,4794135,15.518518518518519
290,485,0,12691,4794620,16.724137931034484
90,103,0,12692,4794723,11.444444444444445
300,454,0,12693,4795177,15.133333333333333
260,405,0,12694,4795582,15.576923076923077
280,373,0,12695,4795955,13.321428571428571
230,345,0,12696,4796300,15.0
250,404,0,12697,4796704,16.16
300,444,0,12698,4797148,14.8
130,251,0,12699,4797399,19.307692307692307
450,674,0,12700,4798073,14.977777777777778
140,167,0,12701,4798240,11.928571428571429
180,263,0,12702,4798503,14.61111111111111
270,418,0,12703,4798921,15.481481481481481
190,273,0,12704,4799194,14.368421052631579
430,694,0,12705,4799888,16.13953488372093
530,847,0,12706,4800735,15.981132075471699
280,398,0,12707,4801133,14.214285714285714
380,623,0,12708,4801756,16.394736842105264
220,335,0,12709,4802091,15.227272727272727
100,115,0,12710,4802206,11.5
150,241,0,12711,4802447,16.066666666666666
160,300,0,12712,4802747,18.75
310,474,0,12713,4803221,15.290322580645162
280,449,0,12714,4803670,16.035714285714285
160,159,0,12715,4803829,9.9375
250,383,0,12716,4804212,15.32
250,381,0,12717,4804593,15.24
150,252,0,12718,4804845,16.8
290,361,0,12719,4805206,12.448275862068966
110,110,0,12720,4805316,10.0
310,473,0,12721,4805789,15.258064516129032
370,530,0,12722,4806319,14.324324324324325
360,574,0,12723,4806893,15.944444444444445
180,291,0,12724,4807184,16.166666666666668
510,967,0,12725,4808151,18.96078431372549
230,323,0,12726,4808474,14.043478260869565
220,313,0,12727,4808787,14.227272727272727
370,572,0,12728,4809359,15.45945945945946
370,557,0,12729,4809916,15.054054054054054
250,347,0,12730,4810263,13.88
160,227,0,12731,4810490,14.1875
230,314,0,12732,4810804,13.652173913043478
210,364,0,12733,4811168,17.333333333333332
150,250,0,12734,4811418,16.666666666666668
80,119,0,12735,4811537,14.875
320,512,0,12736,4812049,16.0
260,371,0,12737,4812420,14.26923076923077
150,210,0,12738,4812630,14.0
590,1196,0,12739,4813826,20.271186440677965
140,213,0,12740,4814039,15.214285714285714
320,472,0,12741,4814511,14.75
330,577,0,12742,4815088,17.484848484848484
290,415,0,12743,4815503,14.310344827586206
190,241,0,12744,4815744,12.68421052631579
150,209,0,12745,4815953,13.933333333333334
240,346,0,12746,4816299,14.416666666666666
180,287,0,12747,4816586,15.944444444444445
320,482,0,12748,4817068,15.0625
60,65,0,12749,4817133,10.833333333333334
450,759,0,12750,4817892,16.866666666666667
240,395,0,12751,4818287,16.458333333333332
340,459,0,12752,4818746,13.5
220,337,0,12753,4819083,15.318181818181818
280,534,0,12754,4819617,19.071428571428573
240,348,0,12755,4819965,14.5
290,396,0,12756,4820361,13.655172413793103
340,511,0,12757,4820872,15.029411764705882
240,327,0,12758,4821199,13.625
150,206,0,12759,4821405,13.733333333333333
300,446,0,12760,4821851,14.866666666666667
400,671,0,12761,4822522,16.775
280,408,0,12762,4822930,14.571428571428571
200,279,0,12763,4823209,13.95
140,185,0,12764,4823394,13.214285714285714
250,360,0,12765,4823754,14.4
420,612,0,12766,4824366,14.571428571428571
170,248,0,12767,4824614,14.588235294117647
320,451,0,12768,4825065,14.09375
410,653,0,12769,4825718,15.926829268292684
280,462,0,12770,4826180,16.5
300,447,0,12771,4826627,14.9
260,400,0,12772,4827027,15.384615384615385
110,135,0,12773,4827162,12.272727272727273
160,229,0,12774,4827391,14.3125
150,196,0,12775,4827587,13.066666666666666
280,366,0,12776,4827953,13.071428571428571
330,494,0,12777,4828447,14.969696969696969
350,554,0,12778,4829001,15.82857142857143
120,144,0,12779,4829145,12.0
390,683,0,12780,4829828,17.512820512820515
300,397,0,12781,4830225,13.233333333333333
160,198,0,12782,4830423,12.375
210,252,0,12783,4830675,12.0
330,525,0,12784,4831200,15.909090909090908
230,296,0,12785,4831496,12.869565217391305
260,431,0,12786,4831927,16.576923076923077
320,448,0,12787,4832375,14.0
220,296,0,12788,4832671,13.454545454545455
230,323,0,12789,4832994,14.043478260869565
230,321,0,12790,4833315,13.956521739130435
390,586,0,12791,4833901,15.025641025641026
260,436,0,12792,4834337,16.76923076923077
200,282,0,12793,4834619,14.1
60,71,0,12794,4834690,11.833333333333334
250,324,0,12795,4835014,12.96
100,143,0,12796,4835157,14.3
210,241,0,12797,4835398,11.476190476190476
230,333,0,12798,4835731,14.478260869565217
210,294,0,12799,4836025,14.0
140,173,0,12800,4836198,12.357142857142858
280,463,0,12801,4836661,16.535714285714285
230,356,0,12802,4837017,15.478260869565217
310,435,0,12803,4837452,14.03225806451613
280,396,0,12804,4837848,14.142857142857142
230,311,0,12805,4838159,13.521739130434783
130,183,0,12806,4838342,14.076923076923077
220,301,0,12807,4838643,13.681818181818182
210,296,0,12808,4838939,14.095238095238095
180,301,0,12809,4839240,16.72222222222222
360,533,0,12810,4839773,14.805555555555555
170,258,0,12811,4840031,15.176470588235293
350,568,0,12812,4840599,16.228571428571428
130,167,0,12813,4840766,12.846153846153847
130,172,0,12814,4840938,13.23076923076923
150,222,0,12815,4841160,14.8
200,290,0,12816,4841450,14.5
230,301,0,12817,4841751,13.08695652173913
280,383,0,12818,4842134,13.678571428571429
370,568,0,12819,4842702,15.35135135135135
180,210,0,12820,4842912,11.666666666666666
290,437,0,12821,4843349,15.068965517241379
220,298,0,12822,4843647,13.545454545454545
420,573,0,12823,4844220,13.642857142857142
140,152,0,12824,4844372,10.857142857142858
360,599,0,12825,4844971,16.63888888888889
130,220,0,12826,4845191,16.923076923076923
160,229,0,12827,4845420,14.3125
230,343,0,12828,4845763,14.91304347826087
380,604,0,12829,4846367,15.894736842105264
100,99,0,12830,4846466,9.9
230,220,0,12831,4846686,9.565217391304348
300,422,0,12832,4847108,14.066666666666666
280,444,0,12833,4847552,15.857142857142858
320,465,0,12834,4848017,14.53125
120,158,0,12835,4848175,13.166666666666666
150,178,0,12836,4848353,11.866666666666667
170,252,0,12837,4848605,14.823529411764707
180,189,0,12838,4848794,10.5
350,547,0,12839,4849341,15.628571428571428
250,394,0,12840,4849735,15.76
230,329,0,12841,4850064,14.304347826086957
250,354,0,12842,4850418,14.16
270,378,0,12843,4850796,14.0
150,214,0,12844,4851010,14.266666666666667
160,234,0,12845,4851244,14.625
390,604,0,12846,4851848,15.487179487179487
130,179,0,12847,4852027,13.76923076923077
200,276,0,12848,4852303,13.8
150,222,0,12849,4852525,14.8
320,504,0,12850,4853029,15.75
250,270,0,12851,4853299,10.8
330,490,0,12852,4853789,14.848484848484848
160,196,0,12853,4853985,12.25
150,197,0,12854,4854182,13.133333333333333
330,501,0,12855,4854683,15.181818181818182
210,350,0,12856,4855033,16.666666666666668
190,255,0,12857,4855288,13.421052631578947
410,746,0,12858,4856034,18.195121951219512
320,526,0,12859,4856560,16.4375
120,146,0,12860,4856706,12.166666666666666
170,257,0,12861,4856963,15.117647058823529
390,559,0,12862,4857522,14.333333333333334
210,315,0,12863,4857837,15.0
210,256,0,12864,4858093,12.19047619047619
180,268,0,12865,4858361,14.88888888888889
350,550,0,12866,4858911,15.714285714285714
340,462,0,12867,4859373,13.588235294117647
190,287,0,12868,4859660,15.105263157894736
210,339,0,12869,4859999,16.142857142857142
230,352,0,12870,4860351,15.304347826086957
180,310,0,12871,4860661,17.22222222222222
220,296,0,12872,4860957,13.454545454545455
110,150,0,12873,4861107,13.636363636363637
170,205,0,12874,4861312,12.058823529411764
290,441,0,12875,4861753,15.206896551724139
260,362,0,12876,4862115,13.923076923076923
180,323,0,12877,4862438,17.944444444444443
400,592,0,12878,4863030,14.8
180,249,0,12879,4863279,13.833333333333334
200,274,0,12880,4863553,13.7
320,503,0,12881,4864056,15.71875
60,71,0,12882,4864127,11.833333333333334
130,177,0,12883,4864304,13.615384615384615
320,483,0,12884,4864787,15.09375
390,587,0,12885,4865374,15.051282051282051
260,497,0,12886,4865871,19.115384615384617
170,282,0,12887,4866153,16.58823529411765
70,87,0,12888,4866240,12.428571428571429
210,328,0,12889,4866568,15.619047619047619
420,657,0,12890,4867225,15.642857142857142
340,534,0,12891,4867759,15.705882352941176
260,339,0,12892,4868098,13.038461538461538
310,414,0,12893,4868512,13.35483870967742
250,382,0,12894,4868894,15.28
290,371,0,12895,4869265,12.793103448275861
200,292,0,12896,4869557,14.6
230,325,0,12897,4869882,14.130434782608695
180,277,0,12898,4870159,15.38888888888889
100,131,0,12899,4870290,13.1
160,190,0,12900,4870480,11.875
180,217,0,12901,4870697,12.055555555555555
130,122,0,12902,4870819,9.384615384615385
230,344,0,12903,4871163,14.956521739130435
340,492,0,12904,4871655,14.470588235294118
200,263,0,12905,4871918,13.15
180,282,0,12906,4872200,15.666666666666666
370,553,0,12907,4872753,14.945945945945946
280,473,0,12908,4873226,16.892857142857142
500,815,0,12909,4874041,16.3
310,491,0,12910,4874532,15.838709677419354
130,173,0,12911,4874705,13.307692307692308
320,557,0,12912,4875262,17.40625
260,373,0,12913,4875635,14.346153846153847
260,358,0,12914,4875993,13.76923076923077
210,258,0,12915,4876251,12.285714285714286
240,392,0,12916,4876643,16.333333333333332
340,512,0,12917,4877155,15.058823529411764
50,47,0,12918,4877202,9.4
230,307,0,12919,4877509,13.347826086956522
230,328,0,12920,4877837,14.26086956521739
110,166,0,12921,4878003,15.090909090909092
310,415,0,12922,4878418,13.387096774193548
310,490,0,12923,4878908,15.806451612903226
160,221,0,12924,4879129,13.8125
340,435,0,12925,4879564,12.794117647058824
200,285,0,12926,4879849,14.25
300,454,0,12927,4880303,15.133333333333333
150,197,0,12928,4880500,13.133333333333333
180,295,0,12929,4880795,16.38888888888889
200,292,0,12930,4881087,14.6
330,482,0,12931,4881569,14.606060606060606
110,204,0,12932,4881773,18.545454545454547
240,380,0,12933,4882153,15.833333333333334
160,215,0,12934,4882368,13.4375
90,113,0,12935,4882481,12.555555555555555
200,244,0,12936,4882725,12.2
280,427,0,12937,4883152,15.25
150,176,0,12938,4883328,11.733333333333333
200,314,0,12939,4883642,15.7
110,137,0,12940,4883779,12.454545454545455
400,646,0,12941,4884425,16.15
190,218,0,12942,4884643,11.473684210526315
330,415,0,12943,4885058,12.575757575757576
190,231,0,12944,4885289,12.157894736842104
160,258,0,12945,4885547,16.125
310,510,0,12946,4886057,16.451612903225808
220,280,0,12947,4886337,12.727272727272727
210,307,0,12948,4886644,14.619047619047619
330,421,0,12949,4887065,12.757575757575758
260,375,0,12950,4887440,14.423076923076923
260,388,0,12951,4887828,14.923076923076923
170,240,0,12952,4888068,14.117647058823529
270,473,0,12953,4888541,17.51851851851852
370,510,0,12954,4889051,13.783783783783784
400,593,0,12955,4889644,14.825
330,569,0,12956,4890213,17.242424242424242
280,396,0,12957,4890609,14.142857142857142
330,517,0,12958,4891126,15.666666666666666
250,381,0,12959,4891507,15.24
370,726,0,12960,4892233,19.62162162162162
300,506,0,12961,4892739,16.866666666666667
290,466,0,12962,4893205,16.06896551724138
270,325,0,12963,4893530,12.037037037037036
380,644,0,12964,4894174,16.94736842105263
160,222,0,12965,4894396,13.875
270,346,0,12966,4894742,12.814814814814815
480,752,0,12967,4895494,15.666666666666666
300,443,0,12968,4895937,14.766666666666667
220,325,0,12969,4896262,14.772727272727273
270,361,0,12970,4896623,13.37037037037037
220,394,0,12971,4897017,17.90909090909091
290,361,0,12972,4897378,12.448275862068966
230,292,0,12973,4897670,12.695652173913043
290,414,0,12974,4898084,14.275862068965518
200,275,0,12975,4898359,13.75
370,658,0,12976,4899017,17.783783783783782
160,255,0,12977,4899272,15.9375
420,687,0,12978,4899959,16.357142857142858
240,385,0,12979,4900344,16.041666666666668
140,190,0,12980,4900534,13.571428571428571
200,307,0,12981,4900841,15.35
280,385,0,12982,4901226,13.75
170,215,0,12983,4901441,12.647058823529411
200,240,0,12984,4901681,12.0
150,193,0,12985,4901874,12.866666666666667
240,352,0,12986,4902226,14.666666666666666
240,396,0,12987,4902622,16.5
130,146,0,12988,4902768,11.23076923076923
300,365,0,12989,4903133,12.166666666666666
200,302,0,12990,4903435,15.1
240,328,0,12991,4903763,13.666666666666666
280,383,0,12992,4904146,13.678571428571429
310,396,0,12993,4904542,12.774193548387096
90,132,0,12994,4904674,14.666666666666666
280,385,0,12995,4905059,13.75
370,474,0,12996,4905533,12.81081081081081
180,212,0,12997,4905745,11.777777777777779
160,233,0,12998,4905978,14.5625
210,277,0,12999,4906255,13.19047619047619
130,167,0,13000,4906422,12.846153846153847
340,561,0,13001,4906983,16.5
260,438,0,13002,4907421,16.846153846153847
230,350,0,13003,4907771,15.217391304347826
150,190,0,13004,4907961,12.666666666666666
260,417,0,13005,4908378,16.03846153846154
140,230,0,13006,4908608,16.428571428571427
310,512,0,13007,4909120,16.516129032258064
190,303,0,13008,4909423,15.947368421052632
530,939,0,13009,4910362,17.71698113207547
420,746,0,13010,4911108,17.761904761904763
240,362,0,13011,4911470,15.083333333333334
430,552,0,13012,4912022,12.837209302325581
350,557,0,13013,4912579,15.914285714285715
300,466,0,13014,4913045,15.533333333333333
330,483,0,13015,4913528,14.636363636363637
350,563,0,13016,4914091,16.085714285714285
260,395,0,13017,4914486,15.192307692307692
280,382,0,13018,4914868,13.642857142857142
370,545,0,13019,4915413,14.72972972972973
210,274,0,13020,4915687,13.047619047619047
160,226,0,13021,4915913,14.125
240,333,0,13022,4916246,13.875
90,104,0,13023,4916350,11.555555555555555
210,320,0,13024,4916670,15.238095238095237
390,622,0,13025,4917292,15.948717948717949
250,311,0,13026,4917603,12.44
170,256,0,13027,4917859,15.058823529411764
280,410,0,13028,4918269,14.642857142857142
170,178,0,13029,4918447,10.470588235294118
230,305,0,13030,4918752,13.26086956521739
360,527,0,13031,4919279,14.63888888888889
360,533,0,13032,4919812,14.805555555555555
260,383,0,13033,4920195,14.73076923076923
230,368,0,13034,4920563,16.0
190,256,0,13035,4920819,13.473684210526315
270,360,0,13036,4921179,13.333333333333334
440,749,0,13037,4921928,17.022727272727273
400,657,0,13038,4922585,16.425
400,718,0,13039,4923303,17.95
100,121,0,13040,4923424,12.1
120,196,0,13041,4923620,16.333333333333332
140,226,0,13042,4923846,16.142857142857142
360,618,0,13043,4924464,17.166666666666668
250,379,0,13044,4924843,15.16
230,358,0,13045,4925201,15.565217391304348
170,233,0,13046,4925434,13.705882352941176
190,259,0,13047,4925693,13.631578947368421
130,207,0,13048,4925900,15.923076923076923
430,796,0,13049,4926696,18.511627906976745
250,331,0,13050,4927027,13.24
330,434,0,13051,4927461,13.151515151515152
400,575,0,13052,4928036,14.375
140,219,0,13053,4928255,15.642857142857142
470,816,0,13054,4929071,17.361702127659573
320,439,0,13055,4929510,13.71875
340,529,0,13056,4930039,15.558823529411764
160,183,0,13057,4930222,11.4375
190,307,0,13058,4930529,16.157894736842106
350,514,0,13059,4931043,14.685714285714285
280,445,0,13060,4931488,15.892857142857142
210,408,0,13061,4931896,19.428571428571427
240,431,0,13062,4932327,17.958333333333332
330,550,0,13063,4932877,16.666666666666668
340,506,0,13064,4933383,14.882352941176471
370,580,0,13065,4933963,15.675675675675675
140,194,0,13066,4934157,13.857142857142858
300,422,0,13067,4934579,14.066666666666666
480,746,0,13068,4935325,15.541666666666666
280,368,0,13069,4935693,13.142857142857142
240,396,0,13070,4936089,16.5
190,272,0,13071,4936361,14.31578947368421
50,80,0,13072,4936441,16.0
220,241,0,13073,4936682,10.954545454545455
280,419,0,13074,4937101,14.964285714285714
180,252,0,13075,4937353,14.0
250,341,0,13076,4937694,13.64
220,300,0,13077,4937994,13.636363636363637
130,158,0,13078,4938152,12.153846153846153
170,211,0,13079,4938363,12.411764705882353
190,302,0,13080,4938665,15.894736842105264
430,767,0,13081,4939432,17.837209302325583
160,229,0,13082,4939661,14.3125
260,350,0,13083,4940011,13.461538461538462
460,766,0,13084,4940777,16.652173913043477
190,260,0,13085,4941037,13.68421052631579
410,596,0,13086,4941633,14.536585365853659
310,458,0,13087,4942091,14.774193548387096
350,531,0,13088,4942622,15.17142857142857
230,306,0,13089,4942928,13.304347826086957
330,474,0,13090,4943402,14.363636363636363
290,465,0,13091,4943867,16.03448275862069
130,205,0,13092,4944072,15.76923076923077
120,151,0,13093,4944223,12.583333333333334
290,432,0,13094,4944655,14.89655172413793
200,275,0,13095,4944930,13.75
140,183,0,13096,4945113,13.071428571428571
130,171,0,13097,4945284,13.153846153846153
280,386,0,13098,4945670,13.785714285714286
180,278,0,13099,4945948,15.444444444444445
250,377,0,13100,4946325,15.08
70,106,0,13101,4946431,15.142857142857142
100,136,0,13102,4946567,13.6
140,200,0,13103,4946767,14.285714285714286
160,220,0,13104,4946987,13.75
330,538,0,13105,4947525,16.303030303030305
140,207,0,13106,4947732,14.785714285714286
130,224,0,13107,4947956,17.23076923076923
250,411,0,13108,4948367,16.44
210,240,0,13109,4948607,11.428571428571429
200,261,0,13110,4948868,13.05
360,608,0,13111,4949476,16.88888888888889
190,284,0,13112,4949760,14.947368421052632
150,259,0,13113,4950019,17.266666666666666
350,615,0,13114,4950634,17.571428571428573
240,356,0,13115,4950990,14.833333333333334
130,140,0,13116,4951130,10.76923076923077
100,129,0,13117,4951259,12.9
100,109,0,13118,4951368,10.9
100,167,0,13119,4951535,16.7
260,319,0,13120,4951854,12.26923076923077
210,355,0,13121,4952209,16.904761904761905
410,700,0,13122,4952909,17.073170731707318
260,385,0,13123,4953294,14.807692307692308
110,125,0,13124,4953419,11.363636363636363
300,432,0,13125,4953851,14.4
270,389,0,13126,4954240,14.407407407407407
120,205,0,13127,4954445,17.083333333333332
100,166,0,13128,4954611,16.6
210,289,0,13129,4954900,13.761904761904763
240,377,0,13130,4955277,15.708333333333334
260,388,0,13131,4955665,14.923076923076923
220,317,0,13132,4955982,14.409090909090908
140,193,0,13133,4956175,13.785714285714286
220,276,0,13134,4956451,12.545454545454545
290,450,0,13135,4956901,15.517241379310345
460,767,0,13136,4957668,16.67391304347826
320,530,0,13137,4958198,16.5625
90,92,0,13138,4958290,10.222222222222221
330,448,0,13139,4958738,13.575757575757576
80,98,0,13140,4958836,12.25
230,327,0,13141,4959163,14.217391304347826
180,232,0,13142,4959395,12.88888888888889
330,560,0,13143,4959955,16.96969696969697
120,155,0,13144,4960110,12.916666666666666
240,378,0,13145,4960488,15.75
150,188,0,13146,4960676,12.533333333333333
190,229,0,13147,4960905,12.052631578947368
320,449,0,13148,4961354,14.03125
320,491,0,13149,4961845,15.34375
210,265,0,13150,4962110,12.619047619047619
80,106,0,13151,4962216,13.25
60,41,0,13152,4962257,6.833333333333333
280,393,0,13153,4962650,14.035714285714286
280,340,0,13154,4962990,12.142857142857142
70,71,0,13155,4963061,10.142857142857142
320,489,0,13156,4963550,15.28125
230,359,0,13157,4963909,15.608695652173912
220,263,0,13158,4964172,11.954545454545455
320,480,0,13159,4964652,15.0
280,359,0,13160,4965011,12.821428571428571
520,853,0,13161,4965864,16.403846153846153
180,223,0,13162,4966087,12.38888888888889
240,363,0,13163,4966450,15.125
200,256,0,13164,4966706,12.8
240,377,0,13165,4967083,15.708333333333334
250,444,0,13166,4967527,17.76
360,597,0,13167,4968124,16.583333333333332
100,104,0,13168,4968228,10.4
620,1199,0,13169,4969427,19.338709677419356
230,303,0,13170,4969730,13.173913043478262
150,206,0,13171,4969936,13.733333333333333
280,465,0,13172,4970401,16.607142857142858
190,271,0,13173,4970672,14.263157894736842
420,764,0,13174,4971436,18.19047619047619
160,247,0,13175,4971683,15.4375
240,347,0,13176,4972030,14.458333333333334
220,344,0,13177,4972374,15.636363636363637
230,331,0,13178,4972705,14.391304347826088
250,297,0,13179,4973002,11.88
240,399,0,13180,4973401,16.625
300,470,0,13181,4973871,15.666666666666666
330,413,0,13182,4974284,12.515151515151516
120,128,0,13183,4974412,10.666666666666666
170,181,0,13184,4974593,10.647058823529411
220,388,0,13185,4974981,17.636363636363637
100,118,0,13186,4975099,11.8
330,498,0,13187,4975597,15.090909090909092
260,391,0,13188,4975988,15.038461538461538
170,275,0,13189,4976263,16.176470588235293
300,385,0,13190,4976648,12.833333333333334
210,292,0,13191,4976940,13.904761904761905
490,731,0,13192,4977671,14.918367346938776
140,200,0,13193,4977871,14.285714285714286
190,258,0,13194,4978129,13.578947368421053
220,338,0,13195,4978467,15.363636363636363
60,85,0,13196,4978552,14.166666666666666
110,174,0,13197,4978726,15.818181818181818
170,197,0,13198,4978923,11.588235294117647
180,257,0,13199,4979180,14.277777777777779
190,273,0,13200,4979453,14.368421052631579
450,769,0,13201,4980222,17.08888888888889
100,149,0,13202,4980371,14.9
270,386,0,13203,4980757,14.296296296296296
360,529,0,13204,4981286,14.694444444444445
270,433,0,13205,4981719,16.037037037037038
220,323,0,13206,4982042,14.681818181818182
120,188,0,13207,4982230,15.666666666666666
180,232,0,13208,4982462,12.88888888888889
300,431,0,13209,4982893,14.366666666666667
250,425,0,13210,4983318,17.0
190,262,0,13211,4983580,13.789473684210526
310,431,0,13212,4984011,13.903225806451612
170,263,0,13213,4984274,15.470588235294118
260,364,0,13214,4984638,14.0
380,614,0,13215,4985252,16.157894736842106
430,609,0,13216,4985861,14.162790697674419
250,384,0,13217,4986245,15.36
270,356,0,13218,4986601,13.185185185185185
100,149,0,13219,4986750,14.9
350,595,0,13220,4987345,17.0
350,473,0,13221,4987818,13.514285714285714
140,169,0,13222,4987987,12.071428571428571
360,562,0,13223,4988549,15.61111111111111
380,602,0,13224,4989151,15.842105263157896
300,530,0,13225,4989681,17.666666666666668
220,266,0,13226,4989947,12.090909090909092
150,229,0,13227,4990176,15.266666666666667
170,177,0,13228,4990353,10.411764705882353
230,320,0,13229,4990673,13.91304347826087
150,146,0,13230,4990819,9.733333333333333
160,235,0,13231,4991054,14.6875
350,488,0,13232,4991542,13.942857142857143
340,476,0,13233,4992018,14.0
90,107,0,13234,4992125,11.88888888888889
150,178,0,13235,4992303,11.866666666666667
290,442,0,13236,4992745,15.241379310344827
370,528,0,13237,4993273,14.27027027027027
210,332,0,13238,4993605,15.80952380952381
270,420,0,13239,4994025,15.555555555555555
300,395,0,13240,4994420,13.166666666666666
210,381,0,13241,4994801,18.142857142857142
580,1060,0,13242,4995861,18.275862068965516
80,121,0,13243,4995982,15.125
180,230,0,13244,4996212,12.777777777777779
300,412,0,13245,4996624,13.733333333333333
370,514,0,13246,4997138,13.891891891891891
280,425,0,13247,4997563,15.178571428571429
260,345,0,13248,4997908,13.26923076923077
320,381,0,13249,4998289,11.90625
270,423,0,13250,4998712,15.666666666666666
240,310,0,13251,4999022,12.916666666666666
190,292,0,13252,4999314,15.368421052631579
320,528,0,13253,4999842,16.5
450,791,0,13254,5000633,17.57777777777778
100,144,0,13255,5000777,14.4
230,289,0,13256,5001066,12.565217391304348
230,366,0,13257,5001432,15.91304347826087
220,286,0,13258,5001718,13.0
280,440,0,13259,5002158,15.714285714285714
260,339,0,13260,5002497,13.038461538461538
240,372,0,13261,5002869,15.5
200,290,0,13262,5003159,14.5
530,770,0,13263,5003929,14.528301886792454
290,387,0,13264,5004316,13.344827586206897
170,253,0,13265,5004569,14.882352941176471
330,474,0,13266,5005043,14.363636363636363
250,375,0,13267,5005418,15.0
170,302,0,13268,5005720,17.764705882352942
270,369,0,13269,5006089,13.666666666666666
170,268,0,13270,5006357,15.764705882352942
420,636,0,13271,5006993,15.142857142857142
320,481,0,13272,5007474,15.03125
420,626,0,13273,5008100,14.904761904761905
150,226,0,13274,5008326,15.066666666666666
100,160,0,13275,5008486,16.0
370,607,0,13276,5009093,16.405405405405407
450,676,0,13277,5009769,15.022222222222222
240,364,0,13278,5010133,15.166666666666666
190,266,0,13279,5010399,14.0
130,183,0,13280,5010582,14.076923076923077
220,363,0,13281,5010945,16.5
300,419,0,13282,5011364,13.966666666666667
110,158,0,13283,5011522,14.363636363636363
180,261,0,13284,5011783,14.5
400,584,0,13285,5012367,14.6
250,356,0,13286,5012723,14.24
330,478,0,13287,5013201,14.484848484848484
140,149,0,13288,5013350,10.642857142857142
190,243,0,13289,5013593,12.789473684210526
90,105,0,13290,5013698,11.666666666666666
310,506,0,13291,5014204,16.322580645161292
190,219,0,13292,5014423,11.526315789473685
260,379,0,13293,5014802,14.576923076923077
140,171,0,13294,5014973,12.214285714285714
360,609,0,13295,5015582,16.916666666666668
110,171,0,13296,5015753,15.545454545454545
170,230,0,13297,5015983,13.529411764705882
250,391,0,13298,5016374,15.64
260,354,0,13299,5016728,13.615384615384615
370,521,0,13300,5017249,14.08108108108108
250,384,0,13301,5017633,15.36
210,319,0,13302,5017952,15.19047619047619
340,529,0,13303,5018481,15.558823529411764
120,165,0,13304,5018646,13.75
150,191,0,13305,5018837,12.733333333333333
310,504,0,13306,5019341,16.258064516129032
430,709,0,13307,5020050,16.488372093023255
180,249,0,13308,5020299,13.833333333333334
290,471,0,13309,5020770,16.24137931034483
240,356,0,13310,5021126,14.833333333333334
160,211,0,13311,5021337,13.1875
140,238,0,13312,5021575,17.0
260,420,0,13313,5021995,16.153846153846153
160,229,0,13314,5022224,14.3125
290,460,0,13315,5022684,15.862068965517242
250,372,0,13316,5023056,14.88
300,438,0,13317,5023494,14.6
240,391,0,13318,5023885,16.291666666666668
260,310,0,13319,5024195,11.923076923076923
220,279,0,13320,5024474,12.681818181818182
270,409,0,13321,5024883,15.148148148148149
530,940,0,13322,5025823,17.735849056603772
110,156,0,13323,5025979,14.181818181818182
300,504,0,13324,5026483,16.8
150,199,0,13325,5026682,13.266666666666667
120,151,0,13326,5026833,12.583333333333334
410,677,0,13327,5027510,16.51219512195122
180,274,0,13328,5027784,15.222222222222221
280,351,0,13329,5028135,12.535714285714286
140,160,0,13330,5028295,11.428571428571429
120,153,0,13331,5028448,12.75
280,411,0,13332,5028859,14.678571428571429
90,116,0,13333,5028975,12.88888888888889
140,196,0,13334,5029171,14.0
270,324,0,13335,5029495,12.0
320,511,0,13336,5030006,15.96875
370,524,0,13337,5030530,14.162162162162161
330,495,0,13338,5031025,15.0
430,729,0,13339,5031754,16.953488372093023
240,347,0,13340,5032101,14.458333333333334
330,585,0,13341,5032686,17.727272727272727
300,461,0,13342,5033147,15.366666666666667
280,334,0,13343,5033481,11.928571428571429
150,197,0,13344,5033678,13.133333333333333
260,462,0,13345,5034140,17.76923076923077
240,396,0,13346,5034536,16.5
410,609,0,13347,5035145,14.853658536585366
440,633,0,13348,5035778,14.386363636363637
380,519,0,13349,5036297,13.657894736842104
260,422,0,13350,5036719,16.23076923076923
340,515,0,13351,5037234,15.147058823529411
230,341,0,13352,5037575,14.826086956521738
210,329,0,13353,5037904,15.666666666666666
280,419,0,13354,5038323,14.964285714285714
390,632,0,13355,5038955,16.205128205128204
220,330,0,13356,5039285,15.0
160,215,0,13357,5039500,13.4375
290,363,0,13358,5039863,12.517241379310345
380,623,0,13359,5040486,16.394736842105264
220,347,0,13360,5040833,15.772727272727273
310,433,0,13361,5041266,13.96774193548387
90,128,0,13362,5041394,14.222222222222221
220,296,0,13363,5041690,13.454545454545455
110,113,0,13364,5041803,10.272727272727273
200,321,0,13365,5042124,16.05
300,445,0,13366,5042569,14.833333333333334
250,353,0,13367,5042922,14.12
390,602,0,13368,5043524,15.435897435897436
260,382,0,13369,5043906,14.692307692307692
60,61,0,13370,5043967,10.166666666666666
250,323,0,13371,5044290,12.92
220,310,0,13372,5044600,14.090909090909092
160,240,0,13373,5044840,15.0
130,165,0,13374,5045005,12.692307692307692
250,392,0,13375,5045397,15.68
280,420,0,13376,5045817,15.0
400,644,0,13377,5046461,16.1
300,468,0,13378,5046929,15.6
350,523,0,13379,5047452,14.942857142857143
300,462,0,13380,5047914,15.4
220,336,0,13381,5048250,15.272727272727273
110,174,0,13382,5048424,15.818181818181818
300,425,0,13383,5048849,14.166666666666666
160,155,0,13384,5049004,9.6875
200,252,0,13385,5049256,12.6
350,571,0,13386,5049827,16.314285714285713
210,286,0,13387,5050113,13.619047619047619
160,219,0,13388,5050332,13.6875
390,657,0,13389,5050989,16.846153846153847
220,294,0,13390,5051283,13.363636363636363
200,225,0,13391,5051508,11.25
250,362,0,13392,5051870,14.48
80,126,0,13393,5051996,15.75
200,220,0,13394,5052216,11.0
290,442,0,13395,5052658,15.241379310344827
280,352,0,13396,5053010,12.571428571428571
150,216,0,13397,5053226,14.4
260,393,0,13398,5053619,15.115384615384615
270,350,0,13399,5053969,12.962962962962964
180,247,0,13400,5054216,13.722222222222221
380,660,0,13401,5054876,17.36842105263158
320,477,0,13402,5055353,14.90625
210,246,0,13403,5055599,11.714285714285714
430,671,0,13404,5056270,15.604651162790697
310,498,0,13405,5056768,16.06451612903226
220,282,0,13406,5057050,12.818181818181818
210,258,0,13407,5057308,12.285714285714286
120,139,0,13408,5057447,11.583333333333334
230,358,0,13409,5057805,15.565217391304348
320,532,0,13410,5058337,16.625
180,281,0,13411,5058618,15.61111111111111
340,578,0,13412,5059196,17.0
190,220,0,13413,5059416,11.578947368421053
90,129,0,13414,5059545,14.333333333333334
220,351,0,13415,5059896,15.954545454545455
340,479,0,13416,5060375,14.088235294117647
240,341,0,13417,5060716,14.208333333333334
200,243,0,13418,5060959,12.15
310,512,0,13419,5061471,16.516129032258064
240,362,0,13420,5061833,15.083333333333334
330,407,0,13421,5062240,12.333333333333334
110,136,0,13422,5062376,12.363636363636363
270,461,0,13423,5062837,17.074074074074073
510,846,0,13424,5063683,16.58823529411765
410,600,0,13425,5064283,14.634146341463415
180,225,0,13426,5064508,12.5
290,619,0,13427,5065127,21.344827586206897
230,365,0,13428,5065492,15.869565217391305
250,368,0,13429,5065860,14.72
330,454,0,13430,5066314,13.757575757575758
210,328,0,13431,5066642,15.619047619047619
180,258,0,13432,5066900,14.333333333333334
390,660,0,13433,5067560,16.923076923076923
140,223,0,13434,5067783,15.928571428571429
380,572,0,13435,5068355,15.052631578947368
270,370,0,13436,5068725,13.703703703703704
130,143,0,13437,5068868,11.0
230,321,0,13438,5069189,13.956521739130435
300,540,0,13439,5069729,18.0
220,308,0,13440,5070037,14.0
110,123,0,13441,5070160,11.181818181818182
60,77,0,13442,5070237,12.833333333333334
340,607,0,13443,5070844,17.852941176470587
240,439,0,13444,5071283,18.291666666666668
100,128,0,13445,5071411,12.8
230,396,0,13446,5071807,17.217391304347824
220,282,0,13447,5072089,12.818181818181818
300,457,0,13448,5072546,15.233333333333333
180,256,0,13449,5072802,14.222222222222221
270,404,0,13450,5073206,14.962962962962964
210,266,0,13451,5073472,12.666666666666666
330,532,0,13452,5074004,16.12121212121212
360,563,0,13453,5074567,15.63888888888889
180,199,0,13454,5074766,11.055555555555555
270,385,0,13455,5075151,14.25925925925926
340,600,0,13456,5075751,17.647058823529413
120,162,0,13457,5075913,13.5
190,270,0,13458,5076183,14.210526315789474
160,217,0,13459,5076400,13.5625
250,346,0,13460,5076746,13.84
370,462,0,13461,5077208,12.486486486486486
310,489,0,13462,5077697,15.774193548387096
280,428,0,13463,5078125,15.285714285714286
370,603,0,13464,5078728,16.2972972972973
280,400,0,13465,5079128,14.285714285714286
280,444,0,13466,5079572,15.857142857142858
300,433,0,13467,5080005,14.433333333333334
430,630,0,13468,5080635,14.651162790697674
350,558,0,13469,5081193,15.942857142857143
190,226,0,13470,5081419,11.894736842105264
210,332,0,13471,5081751,15.80952380952381
330,509,0,13472,5082260,15.424242424242424
260,382,0,13473,5082642,14.692307692307692
430,663,0,13474,5083305,15.418604651162791
190,237,0,13475,5083542,12.473684210526315
490,747,0,13476,5084289,15.244897959183673
280,371,0,13477,5084660,13.25
510,778,0,13478,5085438,15.254901960784315
110,105,0,13479,5085543,9.545454545454545
170,236,0,13480,5085779,13.882352941176471
200,273,0,13481,5086052,13.65
170,214,0,13482,5086266,12.588235294117647
180,295,0,13483,5086561,16.38888888888889
150,233,0,13484,5086794,15.533333333333333
210,261,0,13485,5087055,12.428571428571429
100,110,0,13486,5087165,11.0
190,286,0,13487,5087451,15.052631578947368
260,405,0,13488,5087856,15.576923076923077
260,334,0,13489,5088190,12.846153846153847
300,386,0,13490,5088576,12.866666666666667
140,181,0,13491,5088757,12.928571428571429
340,483,0,13492,5089240,14.205882352941176
240,329,0,13493,5089569,13.708333333333334
300,548,0,13494,5090117,18.266666666666666
140,208,0,13495,5090325,14.857142857142858
270,367,0,13496,5090692,13.592592592592593
210,285,0,13497,5090977,13.571428571428571
400,530,0,13498,5091507,13.25
160,221,0,13499,5091728,13.8125
410,686,0,13500,5092414,16.73170731707317
530,796,0,13501,5093210,15.018867924528301
330,526,0,13502,5093736,15.93939393939394
370,543,0,13503,5094279,14.675675675675675
340,504,0,13504,5094783,14.823529411764707
420,595,0,13505,5095378,14.166666666666666
300,434,0,13506,5095812,14.466666666666667
210,293,0,13507,5096105,13.952380952380953
350,481,0,13508,5096586,13.742857142857142
270,425,0,13509,5097011,15.74074074074074
230,361,0,13510,5097372,15.695652173913043
130,149,0,13511,5097521,11.461538461538462
350,514,0,13512,5098035,14.685714285714285
190,291,0,13513,5098326,15.31578947368421
240,320,0,13514,5098646,13.333333333333334
250,395,0,13515,5099041,15.8
200,333,0,13516,5099374,16.65
350,504,0,13517,5099878,14.4
430,655,0,13518,5100533,15.232558139534884
300,489,0,13519,5101022,16.3
270,422,0,13520,5101444,15.62962962962963
320,489,0,13521,5101933,15.28125
350,555,0,13522,5102488,15.857142857142858
300,494,0,13523,5102982,16.466666666666665
200,328,0,13524,5103310,16.4
200,257,0,13525,5103567,12.85
80,92,0,13526,5103659,11.5
140,218,0,13527,5103877,15.571428571428571
410,690,0,13528,5104567,16.829268292682926
390,514,0,13529,5105081,13.179487179487179
250,340,0,13530,5105421,13.6
170,241,0,13531,5105662,14.176470588235293
230,300,0,13532,5105962,13.043478260869565
130,197,0,13533,5106159,15.153846153846153
240,452,0,13534,5106611,18.833333333333332
320,514,0,13535,5107125,16.0625
240,323,0,13536,5107448,13.458333333333334
110,142,0,13537,5107590,12.909090909090908
400,618,0,13538,5108208,15.45
280,380,0,13539,5108588,13.571428571428571
400,670,0,13540,5109258,16.75
230,314,0,13541,5109572,13.652173913043478
370,554,0,13542,5110126,14.972972972972974
200,337,0,13543,5110463,16.85
160,223,0,13544,5110686,13.9375
180,289,0,13545,5110975,16.055555555555557
240,283,0,13546,5111258,11.791666666666666
350,561,0,13547,5111819,16.02857142857143
300,397,0,13548,5112216,13.233333333333333
290,432,0,13549,5112648,14.89655172413793
200,311,0,13550,5112959,15.55
220,304,0,13551,5113263,13.818181818181818
190,299,0,13552,5113562,15.736842105263158
290,459,0,13553,5114021,15.827586206896552
490,793,0,13554,5114814,16.183673469387756
390,651,0,13555,5115465,16.692307692307693
200,240,0,13556,5115705,12.0
230,365,0,13557,5116070,15.869565217391305
70,76,0,13558,5116146,10.857142857142858
180,301,0,13559,5116447,16.72222222222222
380,622,0,13560,5117069,16.36842105263158
280,448,0,13561,5117517,16.0
240,311,0,13562,5117828,12.958333333333334
150,245,0,13563,5118073,16.333333333333332
170,199,0,13564,5118272,11.705882352941176
270,354,0,13565,5118626,13.11111111111111
380,630,0,13566,5119256,16.57894736842105
330,479,0,13567,5119735,14.515151515151516
320,433,0,13568,5120168,13.53125
110,157,0,13569,5120325,14.272727272727273
350,549,0,13570,5120874,15.685714285714285
370,656,0,13571,5121530,17.72972972972973
460,697,0,13572,5122227,15.152173913043478
390,790,0,13573,5123017,20.256410256410255
280,376,0,13574,5123393,13.428571428571429
280,438,0,13575,5123831,15.642857142857142
180,247,0,13576,5124078,13.722222222222221
150,202,0,13577,5124280,13.466666666666667
310,479,0,13578,5124759,15.451612903225806
140,205,0,13579,5124964,14.642857142857142
140,225,0,13580,5125189,16.071428571428573
230,360,0,13581,5125549,15.652173913043478
200,335,0,13582,5125884,16.75
200,284,0,13583,5126168,14.2
370,504,0,13584,5126672,13.621621621621621
160,239,0,13585,5126911,14.9375
250,337,0,13586,5127248,13.48
140,161,0,13587,5127409,11.5
120,195,0,13588,5127604,16.25
80,109,0,13589,5127713,13.625
120,188,0,13590,5127901,15.666666666666666
290,397,0,13591,5128298,13.689655172413794
240,413,0,13592,5128711,17.208333333333332
220,256,0,13593,5128967,11.636363636363637
360,555,0,13594,5129522,15.416666666666666
180,273,0,13595,5129795,15.166666666666666
350,523,0,13596,5130318,14.942857142857143
140,235,0,13597,5130553,16.785714285714285
120,133,0,13598,5130686,11.083333333333334
280,367,0,13599,5131053,13.107142857142858
260,365,0,13600,5131418,14.038461538461538
470,718,0,13601,5132136,15.27659574468085
270,430,0,13602,5132566,15.925925925925926
210,345,0,13603,5132911,16.428571428571427
280,491,0,13604,5133402,17.535714285714285
330,517,0,13605,5133919,15.666666666666666
260,383,0,13606,5134302,14.73076923076923
250,332,0,13607,5134634,13.28
180,218,0,13608,5134852,12.11111111111111
230,285,0,13609,5135137,12.391304347826088
200,288,0,13610,5135425,14.4
290,390,0,13611,5135815,13.448275862068966
160,209,0,13612,5136024,13.0625
390,586,0,13613,5136610,15.025641025641026
280,362,0,13614,5136972,12.928571428571429
360,544,0,13615,5137516,15.11111111111111
190,260,0,13616,5137776,13.68421052631579
260,417,0,13617,5138193,16.03846153846154
110,199,0,13618,5138392,18.09090909090909
320,423,0,13619,5138815,13.21875
310,514,0,13620,5139329,16.580645161290324
110,170,0,13621,5139499,15.454545454545455
400,679,0,13622,5140178,16.975
80,107,0,13623,5140285,13.375
300,472,0,13624,5140757,15.733333333333333
240,298,0,13625,5141055,12.416666666666666
250,338,0,13626,5141393,13.52
250,460,0,13627,5141853,18.4
290,447,0,13628,5142300,15.413793103448276
260,447,0,13629,5142747,17.192307692307693
220,306,0,13630,5143053,13.909090909090908
420,689,0,13631,5143742,16.404761904761905
270,487,0,13632,5144229,18.037037037037038
320,404,0,13633,5144633,12.625
220,300,0,13634,5144933,13.636363636363637
360,632,0,13635,5145565,17.555555555555557
430,595,0,13636,5146160,13.837209302325581
310,451,0,13637,5146611,14.548387096774194
320,499,0,13638,5147110,15.59375
120,147,0,13639,5147257,12.25
220,320,0,13640,5147577,14.545454545454545
300,501,0,13641,5148078,16.7
240,299,0,13642,5148377,12.458333333333334
200,259,0,13643,5148636,12.95
160,261,0,13644,5148897,16.3125
180,270,0,13645,5149167,15.0
490,706,0,13646,5149873,14.408163265306122
140,179,0,13647,5150052,12.785714285714286
130,216,0,13648,5150268,16.615384615384617
50,83,0,13649,5150351,16.6
370,601,0,13650,5150952,16.243243243243242
180,251,0,13651,5151203,13.944444444444445
210,280,0,13652,5151483,13.333333333333334
260,405,0,13653,5151888,15.576923076923077
200,260,0,13654,5152148,13.0
100,116,0,13655,5152264,11.6
280,461,0,13656,5152725,16.464285714285715
170,232,0,13657,5152957,13.647058823529411
240,345,0,13658,5153302,14.375
280,367,0,13659,5153669,13.107142857142858
390,604,0,13660,5154273,15.487179487179487
280,397,0,13661,5154670,14.178571428571429
320,430,0,13662,5155100,13.4375
150,197,0,13663,5155297,13.133333333333333
320,429,0,13664,5155726,13.40625
270,383,0,13665,5156109,14.185185185185185
120,171,0,13666,5156280,14.25
260,367,0,13667,5156647,14.115384615384615
280,466,0,13668,5157113,16.642857142857142
120,140,0,13669,5157253,11.666666666666666
110,140,0,13670,5157393,12.727272727272727
120,193,0,13671,5157586,16.083333333333332
300,496,0,13672,5158082,16.533333333333335
290,412,0,13673,5158494,14.206896551724139
280,449,0,13674,5158943,16.035714285714285
250,350,0,13675,5159293,14.0
240,313,0,13676,5159606,13.041666666666666
60,71,0,13677,5159677,11.833333333333334
290,395,0,13678,5160072,13.620689655172415
300,443,0,13679,5160515,14.766666666666667
320,434,0,13680,5160949,13.5625
300,480,0,13681,5161429,16.0
330,537,0,13682,5161966,16.272727272727273
160,206,0,13683,5162172,12.875
340,505,0,13684,5162677,14.852941176470589
120,150,0,13685,5162827,12.5
280,424,0,13686,5163251,15.142857142857142
280,450,0,13687,5163701,16.071428571428573
380,655,0,13688,5164356,17.236842105263158
210,302,0,13689,5164658,14.380952380952381
660,994,0,13690,5165652,15.06060606060606
240,387,0,13691,5166039,16.125
150,184,0,13692,5166223,12.266666666666667
310,486,0,13693,5166709,15.67741935483871
200,362,0,13694,5167071,18.1
180,323,0,13695,5167394,17.944444444444443
190,224,0,13696,5167618,11.789473684210526
260,449,0,13697,5168067,17.26923076923077
130,189,0,13698,5168256,14.538461538461538
120,180,0,13699,5168436,15.0
340,476,0,13700,5168912,14.0
330,449,0,13701,5169361,13.606060606060606
190,263,0,13702,5169624,13.842105263157896
190,306,0,13703,5169930,16.105263157894736
160,255,0,13704,5170185,15.9375
240,366,0,13705,5170551,15.25
200,301,0,13706,5170852,15.05
300,486,0,13707,5171338,16.2
290,498,0,13708,5171836,17.17241379310345
230,372,0,13709,5172208,16.17391304347826
220,298,0,13710,5172506,13.545454545454545
180,245,0,13711,5172751,13.61111111111111
220,341,0,13712,5173092,15.5
160,211,0,13713,5173303,13.1875
320,465,0,13714,5173768,14.53125
160,186,0,13715,5173954,11.625
100,111,0,13716,5174065,11.1
290,391,0,13717,5174456,13.482758620689655
280,449,0,13718,5174905,16.035714285714285
260,365,0,13719,5175270,14.038461538461538
350,531,0,13720,5175801,15.17142857142857
340,549,0,13721,5176350,16.147058823529413
210,310,0,13722,5176660,14.761904761904763
320,509,0,13723,5177169,15.90625
300,413,0,13724,5177582,13.766666666666667
180,223,0,13725,5177805,12.38888888888889
300,483,0,13726,5178288,16.1
170,211,0,13727,5178499,12.411764705882353
300,465,0,13728,5178964,15.5
210,301,0,13729,5179265,14.333333333333334
60,73,0,13730,5179338,12.166666666666666
240,377,0,13731,5179715,15.708333333333334
300,419,0,13732,5180134,13.966666666666667
120,202,0,13733,5180336,16.833333333333332
140,229,0,13734,5180565,16.357142857142858
250,368,0,13735,5180933,14.72
200,284,0,13736,5181217,14.2
180,275,0,13737,5181492,15.277777777777779
140,197,0,13738,5181689,14.071428571428571
240,343,0,13739,5182032,14.291666666666666
230,302,0,13740,5182334,13.130434782608695
250,369,0,13741,5182703,14.76
170,252,0,13742,5182955,14.823529411764707
190,253,0,13743,5183208,13.31578947368421
170,258,0,13744,5183466,15.176470588235293
190,241,0,13745,5183707,12.68421052631579
170,222,0,13746,5183929,13.058823529411764
280,379,0,13747,5184308,13.535714285714286
210,255,0,13748,5184563,12.142857142857142
260,368,0,13749,5184931,14.153846153846153
340,557,0,13750,5185488,16.38235294117647
200,310,0,13751,5185798,15.5
340,485,0,13752,5186283,14.264705882352942
150,204,0,13753,5186487,13.6
220,336,0,13754,5186823,15.272727272727273
390,513,0,13755,5187336,13.153846153846153
120,152,0,13756,5187488,12.666666666666666
330,497,0,13757,5187985,15.06060606060606
370,508,0,13758,5188493,13.72972972972973
260,372,0,13759,5188865,14.307692307692308
420,589,0,13760,5189454,14.023809523809524
470,723,0,13761,5190177,15.382978723404255
230,279,0,13762,5190456,12.130434782608695
180,240,0,13763,5190696,13.333333333333334
380,550,0,13764,5191246,14.473684210526315
260,322,0,13765,5191568,12.384615384615385
170,197,0,13766,5191765,11.588235294117647
250,362,0,13767,5192127,14.48
140,144,0,13768,5192271,10.285714285714286
260,403,0,13769,5192674,15.5
300,487,0,13770,5193161,16.233333333333334
300,478,0,13771,5193639,15.933333333333334
430,590,0,13772,5194229,13.720930232558139
280,324,0,13773,5194553,11.571428571428571
140,216,0,13774,5194769,15.428571428571429
220,306,0,13775,5195075,13.909090909090908
160,198,0,13776,5195273,12.375
170,242,0,13777,5195515,14.235294117647058
140,169,0,13778,5195684,12.071428571428571
240,277,0,13779,5195961,11.541666666666666
100,165,0,13780,5196126,16.5
310,494,0,13781,5196620,15.935483870967742
370,665,0,13782,5197285,17.972972972972972
350,492,0,13783,5197777,14.057142857142857
250,311,0,13784,5198088,12.44
160,198,0,13785,5198286,12.375
230,332,0,13786,5198618,14.434782608695652
250,453,0,13787,5199071,18.12
260,382,0,13788,5199453,14.692307692307692
220,278,0,13789,5199731,12.636363636363637
370,540,0,13790,5200271,14.594594594594595
190,259,0,13791,5200530,13.631578947368421
160,192,0,13792,5200722,12.0
160,185,0,13793,5200907,11.5625
600,942,0,13794,5201849,15.7
210,325,0,13795,5202174,15.476190476190476
200,280,0,13796,5202454,14.0
270,453,0,13797,5202907,16.77777777777778
390,662,0,13798,5203569,16.974358974358974
260,348,0,13799,5203917,13.384615384615385
180,209,0,13800,5204126,11.61111111111111
180,271,0,13801,5204397,15.055555555555555
160,155,0,13802,5204552,9.6875
290,504,0,13803,5205056,17.379310344827587
240,316,0,13804,5205372,13.166666666666666
310,457,0,13805,5205829,14.741935483870968
350,476,0,13806,5206305,13.6
300,448,0,13807,5206753,14.933333333333334
500,755,0,13808,5207508,15.1
220,326,0,13809,5207834,14.818181818181818
170,253,0,13810,5208087,14.882352941176471
370,547,0,13811,5208634,14.783783783783784
130,209,0,13812,5208843,16.076923076923077
310,448,0,13813,5209291,14.451612903225806
320,504,0,13814,5209795,15.75
220,310,0,13815,5210105,14.090909090909092
370,573,0,13816,5210678,15.486486486486486
230,411,0,13817,5211089,17.869565217391305
240,325,0,13818,5211414,13.541666666666666
310,474,0,13819,5211888,15.290322580645162
320,505,0,13820,5212393,15.78125
250,334,0,13821,5212727,13.36
60,94,0,13822,5212821,15.666666666666666
270,369,0,13823,5213190,13.666666666666666
240,327,0,13824,5213517,13.625
200,282,0,13825,5213799,14.1
160,223,0,13826,5214022,13.9375
360,593,0,13827,5214615,16.47222222222222
140,209,0,13828,5214824,14.928571428571429
150,204,0,13829,5215028,13.6
200,271,0,13830,5215299,13.55
290,426,0,13831,5215725,14.689655172413794
170,233,0,13832,5215958,13.705882352941176
220,274,0,13833,5216232,12.454545454545455
330,458,0,13834,5216690,13.878787878787879
300,428,0,13835,5217118,14.266666666666667
540,939,0,13836,5218057,17.38888888888889
460,709,0,13837,5218766,15.41304347826087
250,327,0,13838,5219093,13.08
260,417,0,13839,5219510,16.03846153846154
220,295,0,13840,5219805,13.409090909090908
350,448,0,13841,5220253,12.8
150,185,0,13842,5220438,12.333333333333334
190,312,0,13843,5220750,16.42105263157895
370,556,0,13844,5221306,15.027027027027026
170,231,0,13845,5221537,13.588235294117647
240,371,0,13846,5221908,15.458333333333334
220,344,0,13847,5222252,15.636363636363637
380,538,0,13848,5222790,14.157894736842104
140,210,0,13849,5223000,15.0
250,377,0,13850,5223377,15.08
160,206,0,13851,5223583,12.875
250,275,0,13852,5223858,11.0
220,294,0,13853,5224152,13.363636363636363
210,286,0,13854,5224438,13.619047619047619
350,539,0,13855,5224977,15.4
250,388,0,13856,5225365,15.52
330,507,0,13857,5225872,15.363636363636363
370,584,0,13858,5226456,15.783783783783784
460,882,0,13859,5227338,19.17391304347826
200,300,0,13860,5227638,15.0
240,274,0,13861,5227912,11.416666666666666
130,169,0,13862,5228081,13.0
160,222,0,13863,5228303,13.875
180,237,0,13864,5228540,13.166666666666666
180,280,0,13865,5228820,15.555555555555555
270,515,0,13866,5229335,19.074074074074073
190,297,0,13867,5229632,15.631578947368421
220,369,0,13868,5230001,16.772727272727273
200,256,0,13869,5230257,12.8
220,317,0,13870,5230574,14.409090909090908
230,353,0,13871,5230927,15.347826086956522
340,421,0,13872,5231348,12.382352941176471
320,416,0,13873,5231764,13.0
200,294,0,13874,5232058,14.7
250,403,0,13875,5232461,16.12
380,593,0,13876,5233054,15.605263157894736
600,1089,0,13877,5234143,18.15
350,544,0,13878,5234687,15.542857142857143
110,179,0,13879,5234866,16.272727272727273
240,381,0,13880,5235247,15.875
270,414,0,13881,5235661,15.333333333333334
410,565,0,13882,5236226,13.78048780487805
150,216,0,13883,5236442,14.4
160,261,0,13884,5236703,16.3125
290,447,0,13885,5237150,15.413793103448276
280,401,0,13886,5237551,14.321428571428571
290,376,0,13887,5237927,12.96551724137931
270,392,0,13888,5238319,14.518518518518519
290,389,0,13889,5238708,13.413793103448276
560,854,0,13890,5239562,15.25
410,561,0,13891,5240123,13.682926829268293
250,346,0,13892,5240469,13.84
60,68,0,13893,5240537,11.333333333333334
420,682,0,13894,5241219,16.238095238095237
290,453,0,13895,5241672,15.620689655172415
210,306,0,13896,5241978,14.571428571428571
260,376,0,13897,5242354,14.461538461538462
190,274,0,13898,5242628,14.421052631578947
170,200,0,13899,5242828,11.764705882352942
260,365,0,13900,5243193,14.038461538461538
230,367,0,13901,5243560,15.956521739130435
190,265,0,13902,5243825,13.947368421052632
220,309,0,13903,5244134,14.045454545454545
190,326,0,13904,5244460,17.157894736842106
560,1014,0,13905,5245474,18.107142857142858
140,193,0,13906,5245667,13.785714285714286
290,463,0,13907,5246130,15.96551724137931
70,96,0,13908,5246226,13.714285714285714
160,250,0,13909,5246476,15.625
100,164,0,13910,5246640,16.4
390,669,0,13911,5247309,17.153846153846153
270,431,0,13912,5247740,15.962962962962964
320,505,0,13913,5248245,15.78125
160,271,0,13914,5248516,16.9375
300,398,0,13915,5248914,13.266666666666667
320,511,0,13916,5249425,15.96875
230,346,0,13917,5249771,15.043478260869565
300,467,0,13918,5250238,15.566666666666666
160,184,0,13919,5250422,11.5
120,150,0,13920,5250572,12.5
360,638,0,13921,5251210,17.72222222222222
480,720,0,13922,5251930,15.0
360,464,0,13923,5252394,12.88888888888889
290,457,0,13924,5252851,15.758620689655173
430,712,0,13925,5253563,16.558139534883722
410,560,0,13926,5254123,13.658536585365853
280,334,0,13927,5254457,11.928571428571429
380,612,0,13928,5255069,16.105263157894736
320,470,0,13929,5255539,14.6875
220,345,0,13930,5255884,15.681818181818182
110,151,0,13931,5256035,13.727272727272727
350,538,0,13932,5256573,15.371428571428572
190,271,0,13933,5256844,14.263157894736842
230,286,0,13934,5257130,12.434782608695652
170,257,0,13935,5257387,15.117647058823529
150,188,0,13936,5257575,12.533333333333333
170,233,0,13937,5257808,13.705882352941176
160,217,0,13938,5258025,13.5625
160,221,0,13939,5258246,13.8125
260,356,0,13940,5258602,13.692307692307692
330,491,0,13941,5259093,14.878787878787879
290,415,0,13942,5259508,14.310344827586206
260,339,0,13943,5259847,13.038461538461538
360,498,0,13944,5260345,13.833333333333334
150,232,0,13945,5260577,15.466666666666667
390,568,0,13946,5261145,14.564102564102564
360,525,0,13947,5261670,14.583333333333334
150,204,0,13948,5261874,13.6
230,341,0,13949,5262215,14.826086956521738
330,509,0,13950,5262724,15.424242424242424
130,138,0,13951,5262862,10.615384615384615
220,303,0,13952,5263165,13.772727272727273
350,564,0,13953,5263729,16.114285714285714
110,153,0,13954,5263882,13.909090909090908
210,269,0,13955,5264151,12.80952380952381
190,296,0,13956,5264447,15.578947368421053
530,780,0,13957,5265227,14.716981132075471
190,226,0,13958,5265453,11.894736842105264
110,180,0,13959,5265633,16.363636363636363
110,150,0,13960,5265783,13.636363636363637
240,348,0,13961,5266131,14.5
300,454,0,13962,5266585,15.133333333333333
180,248,0,13963,5266833,13.777777777777779
220,304,0,13964,5267137,13.818181818181818
140,169,0,13965,5267306,12.071428571428571
100,124,0,13966,5267430,12.4
220,234,0,13967,5267664,10.636363636363637
230,271,0,13968,5267935,11.782608695652174
300,509,0,13969,5268444,16.966666666666665
410,607,0,13970,5269051,14.804878048780488
480,760,0,13971,5269811,15.833333333333334
340,443,0,13972,5270254,13.029411764705882
150,204,0,13973,5270458,13.6
390,780,0,13974,5271238,20.0
450,741,0,13975,5271979,16.466666666666665
280,381,0,13976,5272360,13.607142857142858
290,418,0,13977,5272778,14.413793103448276
130,220,0,13978,5272998,16.923076923076923
130,152,0,13979,5273150,11.692307692307692
160,257,0,13980,5273407,16.0625
290,477,0,13981,5273884,16.448275862068964
360,493,0,13982,5274377,13.694444444444445
360,533,0,13983,5274910,14.805555555555555
220,330,0,13984,5275240,15.0
310,472,0,13985,5275712,15.225806451612904
230,329,0,13986,5276041,14.304347826086957
340,603,0,13987,5276644,17.735294117647058
100,115,0,13988,5276759,11.5
430,624,0,13989,5277383,14.511627906976743
170,254,0,13990,5277637,14.941176470588236
270,382,0,13991,5278019,14.148148148148149
260,372,0,13992,5278391,14.307692307692308
400,590,0,13993,5278981,14.75
160,275,0,13994,5279256,17.1875
350,498,0,13995,5279754,14.228571428571428
450,822,0,13996,5280576,18.266666666666666
200,307,0,13997,5280883,15.35
190,304,0,13998,5281187,16.0
180,261,0,13999,5281448,14.5
280,333,0,14000,5281781,11.892857142857142
430,721,0,14001,5282502,16.767441860465116
120,120,0,14002,5282622,10.0
320,441,0,14003,5283063,13.78125
300,580,0,14004,5283643,19.333333333333332
360,604,0,14005,5284247,16.77777777777778
160,212,0,14006,5284459,13.25
230,275,0,14007,5284734,11.956521739130435
180,248,0,14008,5284982,13.777777777777779
250,349,0,14009,5285331,13.96
240,397,0,14010,5285728,16.541666666666668
310,512,0,14011,5286240,16.516129032258064
220,277,0,14012,5286517,12.590909090909092
280,399,0,14013,5286916,14.25
200,246,0,14014,5287162,12.3
200,300,0,14015,5287462,15.0
330,499,0,14016,5287961,15.121212121212121
160,206,0,14017,5288167,12.875
270,384,0,14018,5288551,14.222222222222221
270,438,0,14019,5288989,16.22222222222222
240,325,0,14020,5289314,13.541666666666666
340,510,0,14021,5289824,15.0
200,271,0,14022,5290095,13.55
290,405,0,14023,5290500,13.96551724137931
410,701,0,14024,5291201,17.097560975609756
300,423,0,14025,5291624,14.1
290,409,0,14026,5292033,14.10344827586207
400,465,0,14027,5292498,11.625
220,366,0,14028,5292864,16.636363636363637
250,377,0,14029,5293241,15.08
260,425,0,14030,5293666,16.346153846153847
290,511,0,14031,5294177,17.620689655172413
270,366,0,14032,5294543,13.555555555555555
230,319,0,14033,5294862,13.869565217391305
560,866,0,14034,5295728,15.464285714285714
280,472,0,14035,5296200,16.857142857142858
210,315,0,14036,5296515,15.0
430,775,0,14037,5297290,18.023255813953487
180,255,0,14038,5297545,14.166666666666666
230,316,0,14039,5297861,13.73913043478261
300,390,0,14040,5298251,13.0
190,229,0,14041,5298480,12.052631578947368
130,211,0,14042,5298691,16.23076923076923
190,290,0,14043,5298981,15.263157894736842
390,595,0,14044,5299576,15.256410256410257
150,147,0,14045,5299723,9.8
250,385,0,14046,5300108,15.4
230,352,0,14047,5300460,15.304347826086957
270,439,0,14048,5300899,16.25925925925926
150,224,0,14049,5301123,14.933333333333334
280,428,0,14050,5301551,15.285714285714286
310,468,0,14051,5302019,15.096774193548388
260,356,0,14052,5302375,13.692307692307692
240,397,0,14053,5302772,16.541666666666668
320,442,0,14054,5303214,13.8125
260,418,0,14055,5303632,16.076923076923077
220,311,0,14056,5303943,14.136363636363637
300,461,0,14057,5304404,15.366666666666667
270,401,0,14058,5304805,14.851851851851851
340,469,0,14059,5305274,13.794117647058824
120,140,0,14060,5305414,11.666666666666666
310,451,0,14061,5305865,14.548387096774194
250,401,0,14062,5306266,16.04
230,318,0,14063,5306584,13.826086956521738
300,404,0,14064,5306988,13.466666666666667
210,389,0,14065,5307377,18.523809523809526
190,252,0,14066,5307629,13.263157894736842
400,668,0,14067,5308297,16.7
170,294,0,14068,5308591,17.294117647058822
140,197,0,14069,5308788,14.071428571428571
190,292,0,14070,5309080,15.368421052631579
430,746,0,14071,5309826,17.348837209302324
300,477,0,14072,5310303,15.9
300,394,0,14073,5310697,13.133333333333333
420,709,0,14074,5311406,16.88095238095238
140,179,0,14075,5311585,12.785714285714286
400,552,0,14076,5312137,13.8
300,510,0,14077,5312647,17.0
440,677,0,14078,5313324,15.386363636363637
300,416,0,14079,5313740,13.866666666666667
140,187,0,14080,5313927,13.357142857142858
140,203,0,14081,5314130,14.5
190,265,0,14082,5314395,13.947368421052632
180,332,0,14083,5314727,18.444444444444443
130,177,0,14084,5314904,13.615384615384615
190,272,0,14085,5315176,14.31578947368421
160,247,0,14086,5315423,15.4375
120,162,0,14087,5315585,13.5
270,384,0,14088,5315969,14.222222222222221
130,205,0,14089,5316174,15.76923076923077
210,359,0,14090,5316533,17.095238095238095
300,475,0,14091,5317008,15.833333333333334
140,141,0,14092,5317149,10.071428571428571
390,655,0,14093,5317804,16.794871794871796
180,277,0,14094,5318081,15.38888888888889
240,387,0,14095,5318468,16.125
150,196,0,14096,5318664,13.066666666666666
100,154,0,14097,5318818,15.4
430,665,0,14098,5319483,15.465116279069768
240,300,0,14099,5319783,12.5
270,413,0,14100,5320196,15.296296296296296
250,371,0,14101,5320567,14.84
290,388,0,14102,5320955,13.379310344827585
200,325,0,14103,5321280,16.25
320,445,0,14104,5321725,13.90625
130,172,0,14105,5321897,13.23076923076923
190,255,0,14106,5322152,13.421052631578947
360,479,0,14107,5322631,13.305555555555555
180,234,0,14108,5322865,13.0
330,416,0,14109,5323281,12.606060606060606
250,395,0,14110,5323676,15.8
310,431,0,14111,5324107,13.903225806451612
290,440,0,14112,5324547,15.172413793103448
280,443,0,14113,5324990,15.821428571428571
240,315,0,14114,5325305,13.125
100,100,0,14115,5325405,10.0
260,368,0,14116,5325773,14.153846153846153
310,427,0,14117,5326200,13.774193548387096
200,253,0,14118,5326453,12.65
340,558,0,14119,5327011,16.41176470588235
380,500,0,14120,5327511,13.157894736842104
300,462,0,14121,5327973,15.4
190,302,0,14122,5328275,15.894736842105264
430,770,0,14123,5329045,17.906976744186046
130,171,0,14124,5329216,13.153846153846153
140,244,0,14125,5329460,17.428571428571427
110,162,0,14126,5329622,14.727272727272727
170,277,0,14127,5329899,16.294117647058822
300,458,0,14128,5330357,15.266666666666667
200,332,0,14129,5330689,16.6
210,322,0,14130,5331011,15.333333333333334
290,456,0,14131,5331467,15.724137931034482
120,182,0,14132,5331649,15.166666666666666
130,194,0,14133,5331843,14.923076923076923
220,279,0,14134,5332122,12.681818181818182
300,534,0,14135,5332656,17.8
320,454,0,14136,5333110,14.1875
210,256,0,14137,5333366,12.19047619047619
120,134,0,14138,5333500,11.166666666666666
220,339,0,14139,5333839,15.409090909090908
180,257,0,14140,5334096,14.277777777777779
320,438,0,14141,5334534,13.6875
280,444,0,14142,5334978,15.857142857142858
350,511,0,14143,5335489,14.6
290,445,0,14144,5335934,15.344827586206897
180,294,0,14145,5336228,16.333333333333332
200,290,0,14146,5336518,14.5
160,200,0,14147,5336718,12.5
100,75,0,14148,5336793,7.5
260,398,0,14149,5337191,15.307692307692308
210,326,0,14150,5337517,15.523809523809524
230,351,0,14151,5337868,15.26086956521739
460,804,0,14152,5338672,17.47826086956522
190,224,0,14153,5338896,11.789473684210526
230,391,0,14154,5339287,17.0
350,496,0,14155,5339783,14.17142857142857
190,290,0,14156,5340073,15.263157894736842
260,396,0,14157,5340469,15.23076923076923
170,224,0,14158,5340693,13.176470588235293
350,473,0,14159,5341166,13.514285714285714
480,781,0,14160,5341947,16.270833333333332
210,362,0,14161,5342309,17.238095238095237
260,382,0,14162,5342691,14.692307692307692
370,522,0,14163,5343213,14.108108108108109
200,229,0,14164,5343442,11.45
180,279,0,14165,5343721,15.5
290,412,0,14166,5344133,14.206896551724139
140,220,0,14167,5344353,15.714285714285714
320,444,0,14168,5344797,13.875
160,212,0,14169,5345009,13.25
440,597,0,14170,5345606,13.568181818181818
240,302,0,14171,5345908,12.583333333333334
170,250,0,14172,5346158,14.705882352941176
170,247,0,14173,5346405,14.529411764705882
440,749,0,14174,5347154,17.022727272727273
420,587,0,14175,5347741,13.976190476190476
60,49,0,14176,5347790,8.166666666666666
260,372,0,14177,5348162,14.307692307692308
260,363,0,14178,5348525,13.961538461538462
220,300,0,14179,5348825,13.636363636363637
250,344,0,14180,5349169,13.76
370,620,0,14181,5349789,16.756756756756758
320,501,0,14182,5350290,15.65625
200,252,0,14183,5350542,12.6
280,374,0,14184,5350916,13.357142857142858
390,566,0,14185,5351482,14.512820512820513
190,295,0,14186,5351777,15.526315789473685
180,274,0,14187,5352051,15.222222222222221
320,477,0,14188,5352528,14.90625
170,265,0,14189,5352793,15.588235294117647
290,477,0,14190,5353270,16.448275862068964
170,245,0,14191,5353515,14.411764705882353
160,200,0,14192,5353715,12.5
230,319,0,14193,5354034,13.869565217391305
260,351,0,14194,5354385,13.5
310,442,0,14195,5354827,14.258064516129032
150,220,0,14196,5355047,14.666666666666666
210,339,0,14197,5355386,16.142857142857142
210,343,0,14198,5355729,16.333333333333332
230,314,0,14199,5356043,13.652173913043478
310,488,0,14200,5356531,15.741935483870968
160,239,0,14201,5356770,14.9375
310,441,0,14202,5357211,14.225806451612904
220,327,0,14203,5357538,14.863636363636363
190,354,0,14204,5357892,18.63157894736842
160,222,0,14205,5358114,13.875
170,247,0,14206,5358361,14.529411764705882
200,230,0,14207,5358591,11.5
290,438,0,14208,5359029,15.10344827586207
240,351,0,14209,5359380,14.625
330,529,0,14210,5359909,16.03030303030303
310,474,0,14211,5360383,15.290322580645162
270,481,0,14212,5360864,17.814814814814813
370,510,0,14213,5361374,13.783783783783784
390,626,0,14214,5362000,16.05128205128205
350,564,0,14215,5362564,16.114285714285714
170,246,0,14216,5362810,14.470588235294118
140,232,0,14217,5363042,16.571428571428573
370,533,0,14218,5363575,14.405405405405405
310,478,0,14219,5364053,15.419354838709678
270,364,0,14220,5364417,13.481481481481481
210,293,0,14221,5364710,13.952380952380953
100,149,0,14222,5364859,14.9
340,597,0,14223,5365456,17.558823529411764
140,191,0,14224,5365647,13.642857142857142
230,304,0,14225,5365951,13.217391304347826
190,224,0,14226,5366175,11.789473684210526
200,313,0,14227,5366488,15.65
140,169,0,14228,5366657,12.071428571428571
110,164,0,14229,5366821,14.909090909090908
90,127,0,14230,5366948,14.11111111111111
260,354,0,14231,5367302,13.615384615384615
350,547,0,14232,5367849,15.628571428571428
300,412,0,14233,5368261,13.733333333333333
140,167,0,14234,5368428,11.928571428571429
350,488,0,14235,5368916,13.942857142857143
140,198,0,14236,5369114,14.142857142857142
400,645,0,14237,5369759,16.125
250,375,0,14238,5370134,15.0
380,568,0,14239,5370702,14.947368421052632
200,226,0,14240,5370928,11.3
440,616,0,14241,5371544,14.0
170,247,0,14242,5371791,14.529411764705882
250,378,0,14243,5372169,15.12
300,375,0,14244,5372544,12.5
90,130,0,14245,5372674,14.444444444444445
250,343,0,14246,5373017,13.72
320,498,0,14247,5373515,15.5625
320,446,0,14248,5373961,13.9375
260,370,0,14249,5374331,14.23076923076923
180,302,0,14250,5374633,16.77777777777778
220,276,0,14251,5374909,12.545454545454545
350,474,0,14252,5375383,13.542857142857143
280,368,0,14253,5375751,13.142857142857142
270,444,0,14254,5376195,16.444444444444443
260,370,0,14255,5376565,14.23076923076923
250,409,0,14256,5376974,16.36
240,342,0,14257,5377316,14.25
360,469,0,14258,5377785,13.027777777777779
220,358,0,14259,5378143,16.272727272727273
400,617,0,14260,5378760,15.425
210,282,0,14261,5379042,13.428571428571429
240,307,0,14262,5379349,12.791666666666666
230,367,0,14263,5379716,15.956521739130435
160,273,0,14264,5379989,17.0625
330,558,0,14265,5380547,16.90909090909091
310,507,0,14266,5381054,16.35483870967742
230,307,0,14267,5381361,13.347826086956522
130,196,0,14268,5381557,15.076923076923077
210,298,0,14269,5381855,14.19047619047619
150,201,0,14270,5382056,13.4
350,567,0,14271,5382623,16.2
460,672,0,14272,5383295,14.608695652173912
160,174,0,14273,5383469,10.875
160,281,0,14274,5383750,17.5625
220,322,0,14275,5384072,14.636363636363637
380,545,0,14276,5384617,14.342105263157896
270,384,0,14277,5385001,14.222222222222221
320,472,0,14278,5385473,14.75
220,292,0,14279,5385765,13.272727272727273
250,381,0,14280,5386146,15.24
190,300,0,14281,5386446,15.789473684210526
180,283,0,14282,5386729,15.722222222222221
170,201,0,14283,5386930,11.823529411764707
430,681,0,14284,5387611,15.837209302325581
270,367,0,14285,5387978,13.592592592592593
120,178,0,14286,5388156,14.833333333333334
100,124,0,14287,5388280,12.4
290,420,0,14288,5388700,14.482758620689655
80,86,0,14289,5388786,10.75
460,741,0,14290,5389527,16.108695652173914
270,395,0,14291,5389922,14.62962962962963
120,125,0,14292,5390047,10.416666666666666
140,178,0,14293,5390225,12.714285714285714
180,235,0,14294,5390460,13.055555555555555
350,616,0,14295,5391076,17.6
410,640,0,14296,5391716,15.609756097560975
110,148,0,14297,5391864,13.454545454545455
360,498,0,14298,5392362,13.833333333333334
300,417,0,14299,5392779,13.9
230,349,0,14300,5393128,15.173913043478262
390,729,0,14301,5393857,18.692307692307693
330,569,0,14302,5394426,17.242424242424242
220,332,0,14303,5394758,15.090909090909092
230,338,0,14304,5395096,14.695652173913043
210,323,0,14305,5395419,15.380952380952381
170,289,0,14306,5395708,17.0
400,668,0,14307,5396376,16.7
230,302,0,14308,5396678,13.130434782608695
330,461,0,14309,5397139,13.969696969696969
420,667,0,14310,5397806,15.880952380952381
180,238,0,14311,5398044,13.222222222222221
410,647,0,14312,5398691,15.78048780487805
270,399,0,14313,5399090,14.777777777777779
70,92,0,14314,5399182,13.142857142857142
290,418,0,14315,5399600,14.413793103448276
280,392,0,14316,5399992,14.0
190,236,0,14317,5400228,12.421052631578947
110,125,0,14318,5400353,11.363636363636363
310,438,0,14319,5400791,14.129032258064516
190,308,0,14320,5401099,16.210526315789473
240,391,0,14321,5401490,16.291666666666668
330,549,0,14322,5402039,16.636363636363637
430,682,0,14323,5402721,15.86046511627907
100,138,0,14324,5402859,13.8
320,440,0,14325,5403299,13.75
270,327,0,14326,5403626,12.11111111111111
180,291,0,14327,5403917,16.166666666666668
410,656,0,14328,5404573,16.0
220,330,0,14329,5404903,15.0
270,486,0,14330,5405389,18.0
210,290,0,14331,5405679,13.80952380952381
140,169,0,14332,5405848,12.071428571428571
170,310,0,14333,5406158,18.235294117647058
380,555,0,14334,5406713,14.605263157894736
240,300,0,14335,5407013,12.5
160,249,0,14336,5407262,15.5625
210,311,0,14337,5407573,14.80952380952381
250,355,0,14338,5407928,14.2
180,284,0,14339,5408212,15.777777777777779
350,436,0,14340,5408648,12.457142857142857
190,202,0,14341,5408850,10.631578947368421
420,688,0,14342,5409538,16.38095238095238
310,541,0,14343,5410079,17.451612903225808
360,491,0,14344,5410570,13.63888888888889
430,625,0,14345,5411195,14.534883720930232
150,219,0,14346,5411414,14.6
390,626,0,14347,5412040,16.05128205128205
200,244,0,14348,5412284,12.2
80,157,0,14349,5412441,19.625
460,775,0,14350,5413216,16.847826086956523
110,185,0,14351,5413401,16.818181818181817
290,442,0,14352,5413843,15.241379310344827
200,255,0,14353,5414098,12.75
290,405,0,14354,5414503,13.96551724137931
130,152,0,14355,5414655,11.692307692307692
90,127,0,14356,5414782,14.11111111111111
200,267,0,14357,5415049,13.35
280,365,0,14358,5415414,13.035714285714286
180,228,0,14359,5415642,12.666666666666666
120,155,0,14360,5415797,12.916666666666666
120,179,0,14361,5415976,14.916666666666666
100,174,0,14362,5416150,17.4
370,622,0,14363,5416772,16.81081081081081
170,254,0,14364,5417026,14.941176470588236
470,673,0,14365,5417699,14.319148936170214
170,231,0,14366,5417930,13.588235294117647
200,294,0,14367,5418224,14.7
210,339,0,14368,5418563,16.142857142857142
380,551,0,14369,5419114,14.5
190,242,0,14370,5419356,12.736842105263158
190,246,0,14371,5419602,12.947368421052632
250,369,0,14372,5419971,14.76
250,387,0,14373,5420358,15.48
280,437,0,14374,5420795,15.607142857142858
110,146,0,14375,5420941,13.272727272727273
340,502,0,14376,5421443,14.764705882352942
360,657,0,14377,5422100,18.25
80,98,0,14378,5422198,12.25
220,335,0,14379,5422533,15.227272727272727
90,146,0,14380,5422679,16.22222222222222
220,321,0,14381,5423000,14.590909090909092
170,217,0,14382,5423217,12.764705882352942
300,452,0,14383,5423669,15.066666666666666
350,514,0,14384,5424183,14.685714285714285
300,463,0,14385,5424646,15.433333333333334
220,372,0,14386,5425018,16.90909090909091
410,625,0,14387,5425643,15.24390243902439
90,139,0,14388,5425782,15.444444444444445
130,175,0,14389,5425957,13.461538461538462
290,469,0,14390,5426426,16.17241379310345
360,622,0,14391,5427048,17.27777777777778
200,301,0,14392,5427349,15.05
350,476,0,14393,5427825,13.6
360,520,0,14394,5428345,14.444444444444445
340,513,0,14395,5428858,15.088235294117647
120,140,0,14396,5428998,11.666666666666666
450,711,0,14397,5429709,15.8
270,360,0,14398,5430069,13.333333333333334
250,403,0,14399,5430472,16.12
300,475,0,14400,5430947,15.833333333333334
230,325,0,14401,5431272,14.130434782608695
160,221,0,14402,5431493,13.8125
300,427,0,14403,5431920,14.233333333333333
180,265,0,14404,5432185,14.722222222222221
130,169,0,14405,5432354,13.0
140,236,0,14406,5432590,16.857142857142858
270,355,0,14407,5432945,13.148148148148149
440,687,0,14408,5433632,15.613636363636363
310,470,0,14409,5434102,15.161290322580646
190,314,0,14410,5434416,16.526315789473685
290,516,0,14411,5434932,17.79310344827586
200,281,0,14412,5435213,14.05
290,474,0,14413,5435687,16.344827586206897
170,183,0,14414,5435870,10.764705882352942
390,569,0,14415,5436439,14.58974358974359
390,621,0,14416,5437060,15.923076923076923
460,777,0,14417,5437837,16.891304347826086
380,514,0,14418,5438351,13.526315789473685
300,446,0,14419,5438797,14.866666666666667
80,109,0,14420,5438906,13.625
210,309,0,14421,5439215,14.714285714285714
370,535,0,14422,5439750,14.45945945945946
250,379,0,14423,5440129,15.16
280,367,0,14424,5440496,13.107142857142858
290,490,0,14425,5440986,16.896551724137932
150,258,0,14426,5441244,17.2
430,636,0,14427,5441880,14.790697674418604
300,376,0,14428,5442256,12.533333333333333
490,974,0,14429,5443230,19.877551020408163
240,283,0,14430,5443513,11.791666666666666
110,126,0,14431,5443639,11.454545454545455
330,513,0,14432,5444152,15.545454545454545
400,582,0,14433,5444734,14.55
130,130,0,14434,5444864,10.0
180,222,0,14435,5445086,12.333333333333334
220,342,0,14436,5445428,15.545454545454545
210,355,0,14437,5445783,16.904761904761905
260,374,0,14438,5446157,14.384615384615385
300,435,0,14439,5446592,14.5
260,390,0,14440,5446982,15.0
170,235,0,14441,5447217,13.823529411764707
220,296,0,14442,5447513,13.454545454545455
420,633,0,14443,5448146,15.071428571428571
220,328,0,14444,5448474,14.909090909090908
180,266,0,14445,5448740,14.777777777777779
240,383,0,14446,5449123,15.958333333333334
220,338,0,14447,5449461,15.363636363636363
370,491,0,14448,5449952,13.27027027027027
190,272,0,14449,5450224,14.31578947368421
150,223,0,14450,5450447,14.866666666666667
250,392,0,14451,5450839,15.68
210,314,0,14452,5451153,14.952380952380953
270,379,0,14453,5451532,14.037037037037036
220,332,0,14454,5451864,15.090909090909092
140,170,0,14455,5452034,12.142857142857142
260,358,0,14456,5452392,13.76923076923077
230,405,0,14457,5452797,17.608695652173914
120,138,0,14458,5452935,11.5
200,246,0,14459,5453181,12.3
270,437,0,14460,5453618,16.185185185185187
170,234,0,14461,5453852,13.764705882352942
150,198,0,14462,5454050,13.2
340,499,0,14463,5454549,14.676470588235293
510,842,0,14464,5455391,16.50980392156863
310,544,0,14465,5455935,17.548387096774192
270,405,0,14466,5456340,15.0
220,319,0,14467,5456659,14.5
210,329,0,14468,5456988,15.666666666666666
230,351,0,14469,5457339,15.26086956521739
190,266,0,14470,5457605,14.0
190,301,0,14471,5457906,15.842105263157896
400,584,0,14472,5458490,14.6
300,474,0,14473,5458964,15.8
200,264,0,14474,5459228,13.2
230,341,0,14475,5459569,14.826086956521738
360,561,0,14476,5460130,15.583333333333334
300,426,0,14477,5460556,14.2
180,312,0,14478,5460868,17.333333333333332
150,243,0,14479,5461111,16.2
180,280,0,14480,5461391,15.555555555555555
240,334,0,14481,5461725,13.916666666666666
350,454,0,14482,5462179,12.971428571428572
220,255,0,14483,5462434,11.590909090909092
260,345,0,14484,5462779,13.26923076923077
330,471,0,14485,5463250,14.272727272727273
250,323,0,14486,5463573,12.92
400,685,0,14487,5464258,17.125
300,484,0,14488,5464742,16.133333333333333
230,293,0,14489,5465035,12.73913043478261
230,338,0,14490,5465373,14.695652173913043
320,494,0,14491,5465867,15.4375
130,174,0,14492,5466041,13.384615384615385
300,404,0,14493,5466445,13.466666666666667
320,518,0,14494,5466963,16.1875
160,208,0,14495,5467171,13.0
200,279,0,14496,5467450,13.95
210,293,0,14497,5467743,13.952380952380953
210,304,0,14498,5468047,14.476190476190476
300,426,0,14499,5468473,14.2
400,647,0,14500,5469120,16.175
150,233,0,14501,5469353,15.533333333333333
70,65,0,14502,5469418,9.285714285714286
120,181,0,14503,5469599,15.083333333333334
380,588,0,14504,5470187,15.473684210526315
180,312,0,14505,5470499,17.333333333333332
380,690,0,14506,5471189,18.157894736842106
290,463,0,14507,5471652,15.96551724137931
440,634,0,14508,5472286,14.409090909090908
180,179,0,14509,5472465,9.944444444444445
330,539,0,14510,5473004,16.333333333333332
340,577,0,14511,5473581,16.970588235294116
390,616,0,14512,5474197,15.794871794871796
260,452,0,14513,5474649,17.384615384615383
300,403,0,14514,5475052,13.433333333333334
220,253,0,14515,5475305,11.5
260,427,0,14516,5475732,16.423076923076923
240,351,0,14517,5476083,14.625
350,467,0,14518,5476550,13.342857142857143
340,478,0,14519,5477028,14.058823529411764
550,907,0,14520,5477935,16.490909090909092
340,522,0,14521,5478457,15.352941176470589
220,329,0,14522,5478786,14.954545454545455
60,97,0,14523,5478883,16.166666666666668
400,675,0,14524,5479558,16.875
330,567,0,14525,5480125,17.181818181818183
250,344,0,14526,5480469,13.76
440,759,0,14527,5481228,17.25
280,415,0,14528,5481643,14.821428571428571
230,308,0,14529,5481951,13.391304347826088
250,338,0,14530,5482289,13.52
140,203,0,14531,5482492,14.5
170,256,0,14532,5482748,15.058823529411764
210,334,0,14533,5483082,15.904761904761905
230,305,0,14534,5483387,13.26086956521739
160,220,0,14535,5483607,13.75
250,395,0,14536,5484002,15.8
280,366,0,14537,5484368,13.071428571428571
160,243,0,14538,5484611,15.1875
260,369,0,14539,5484980,14.192307692307692
130,150,0,14540,5485130,11.538461538461538
330,518,0,14541,5485648,15.696969696969697
230,307,0,14542,5485955,13.347826086956522
190,245,0,14543,5486200,12.894736842105264
300,454,0,14544,5486654,15.133333333333333
340,561,0,14545,5487215,16.5
220,334,0,14546,5487549,15.181818181818182
240,405,0,14547,5487954,16.875
290,460,0,14548,5488414,15.862068965517242
140,203,0,14549,5488617,14.5
150,219,0,14550,5488836,14.6
220,334,0,14551,5489170,15.181818181818182
340,581,0,14552,5489751,17.08823529411765
490,797,0,14553,5490548,16.26530612244898
490,807,0,14554,5491355,16.46938775510204
400,587,0,14555,5491942,14.675
180,242,0,14556,5492184,13.444444444444445
230,359,0,14557,5492543,15.608695652173912
240,343,0,14558,5492886,14.291666666666666
240,318,0,14559,5493204,13.25
250,370,0,14560,5493574,14.8
230,312,0,14561,5493886,13.565217391304348
260,366,0,14562,5494252,14.076923076923077
210,291,0,14563,5494543,13.857142857142858
250,362,0,14564,5494905,14.48
270,394,0,14565,5495299,14.592592592592593
250,339,0,14566,5495638,13.56
170,261,0,14567,5495899,15.352941176470589
230,262,0,14568,5496161,11.391304347826088
250,410,0,14569,5496571,16.4
160,243,0,14570,5496814,15.1875
350,513,0,14571,5497327,14.657142857142857
240,304,0,14572,5497631,12.666666666666666
170,256,0,14573,5497887,15.058823529411764
210,335,0,14574,5498222,15.952380952380953
180,256,0,14575,5498478,14.222222222222221
170,212,0,14576,5498690,12.470588235294118
480,658,0,14577,5499348,13.708333333333334
150,179,0,14578,5499527,11.933333333333334
440,726,0,14579,5500253,16.5
270,344,0,14580,5500597,12.74074074074074
270,454,0,14581,5501051,16.814814814814813
260,347,0,14582,5501398,13.346153846153847
130,168,0,14583,5501566,12.923076923076923
110,188,0,14584,5501754,17.09090909090909
310,425,0,14585,5502179,13.709677419354838
310,436,0,14586,5502615,14.064516129032258
290,466,0,14587,5503081,16.06896551724138
240,332,0,14588,5503413,13.833333333333334
190,242,0,14589,5503655,12.736842105263158
270,442,0,14590,5504097,16.37037037037037
200,338,0,14591,5504435,16.9
420,653,0,14592,5505088,15.547619047619047
280,435,0,14593,5505523,15.535714285714286
450,810,0,14594,5506333,18.0
230,287,0,14595,5506620,12.478260869565217
330,478,0,14596,5507098,14.484848484848484
270,429,0,14597,5507527,15.88888888888889
190,263,0,14598,5507790,13.842105263157896
300,390,0,14599,5508180,13.0
420,690,0,14600,5508870,16.428571428571427
350,551,0,14601,5509421,15.742857142857142
400,608,0,14602,5510029,15.2
190,251,0,14603,5510280,13.210526315789474
120,169,0,14604,5510449,14.083333333333334
390,543,0,14605,5510992,13.923076923076923
230,301,0,14606,5511293,13.08695652173913
200,269,0,14607,5511562,13.45
260,356,0,14608,5511918,13.692307692307692
180,226,0,14609,5512144,12.555555555555555
200,277,0,14610,5512421,13.85
230,344,0,14611,5512765,14.956521739130435
200,296,0,14612,5513061,14.8
160,264,0,14613,5513325,16.5
220,327,0,14614,5513652,14.863636363636363
180,246,0,14615,5513898,13.666666666666666
90,100,0,14616,5513998,11.11111111111111
140,191,0,14617,5514189,13.642857142857142
340,432,0,14618,5514621,12.705882352941176
270,410,0,14619,5515031,15.185185185185185
360,557,0,14620,5515588,15.472222222222221
310,528,0,14621,5516116,17.032258064516128
170,226,0,14622,5516342,13.294117647058824
230,351,0,14623,5516693,15.26086956521739
240,312,0,14624,5517005,13.0
260,308,0,14625,5517313,11.846153846153847
390,624,0,14626,5517937,16.0
240,329,0,14627,5518266,13.708333333333334
190,287,0,14628,5518553,15.105263157894736
210,324,0,14629,5518877,15.428571428571429
310,487,0,14630,5519364,15.709677419354838
220,309,0,14631,5519673,14.045454545454545
230,373,0,14632,5520046,16.217391304347824
130,189,0,14633,5520235,14.538461538461538
270,471,0,14634,5520706,17.444444444444443
190,259,0,14635,5520965,13.631578947368421
290,456,0,14636,5521421,15.724137931034482
170,249,0,14637,5521670,14.647058823529411
210,319,0,14638,5521989,15.19047619047619
190,237,0,14639,5522226,12.473684210526315
300,461,0,14640,5522687,15.366666666666667
190,361,0,14641,5523048,19.0
280,430,0,14642,5523478,15.357142857142858
180,239,0,14643,5523717,13.277777777777779
250,352,0,14644,5524069,14.08
140,248,0,14645,5524317,17.714285714285715
250,314,0,14646,5524631,12.56
340,467,0,14647,5525098,13.735294117647058
210,323,0,14648,5525421,15.380952380952381
200,324,0,14649,5525745,16.2
270,358,0,14650,5526103,13.25925925925926
240,358,0,14651,5526461,14.916666666666666
180,191,0,14652,5526652,10.61111111111111
170,218,0,14653,5526870,12.823529411764707
310,446,0,14654,5527316,14.387096774193548
290,434,0,14655,5527750,14.96551724137931
170,245,0,14656,5527995,14.411764705882353
140,233,0,14657,5528228,16.642857142857142
210,312,0,14658,5528540,14.857142857142858
240,337,0,14659,5528877,14.041666666666666
210,277,0,14660,5529154,13.19047619047619
220,300,0,14661,5529454,13.636363636363637
450,548,0,14662,5530002,12.177777777777777
280,428,0,14663,5530430,15.285714285714286
300,386,0,14664,5530816,12.866666666666667
230,321,0,14665,5531137,13.956521739130435
220,294,0,14666,5531431,13.363636363636363
260,410,0,14667,5531841,15.76923076923077
280,395,0,14668,5532236,14.107142857142858
200,304,0,14669,5532540,15.2
390,541,0,14670,5533081,13.871794871794872
310,445,0,14671,5533526,14.35483870967742
120,139,0,14672,5533665,11.583333333333334
190,305,0,14673,5533970,16.05263157894737
200,318,0,14674,5534288,15.9
120,166,0,14675,5534454,13.833333333333334
130,179,0,14676,5534633,13.76923076923077
220,341,0,14677,5534974,15.5
200,304,0,14678,5535278,15.2
210,286,0,14679,5535564,13.619047619047619
330,497,0,14680,5536061,15.06060606060606
100,135,0,14681,5536196,13.5
160,269,0,14682,5536465,16.8125
120,179,0,14683,5536644,14.916666666666666
190,308,0,14684,5536952,16.210526315789473
170,254,0,14685,5537206,14.941176470588236
350,543,0,14686,5537749,15.514285714285714
230,359,0,14687,5538108,15.608695652173912
450,710,0,14688,5538818,15.777777777777779
70,91,0,14689,5538909,13.0
280,393,0,14690,5539302,14.035714285714286
290,416,0,14691,5539718,14.344827586206897
210,260,0,14692,5539978,12.380952380952381
340,587,0,14693,5540565,17.264705882352942
160,204,0,14694,5540769,12.75
410,597,0,14695,5541366,14.560975609756097
190,240,0,14696,5541606,12.631578947368421
280,448,0,14697,5542054,16.0
200,278,0,14698,5542332,13.9
150,235,0,14699,5542567,15.666666666666666
230,380,0,14700,5542947,16.52173913043478
320,529,0,14701,5543476,16.53125
170,256,0,14702,5543732,15.058823529411764
220,292,0,14703,5544024,13.272727272727273
390,766,0,14704,5544790,19.641025641025642
150,167,0,14705,5544957,11.133333333333333
380,558,0,14706,5545515,14.68421052631579
230,344,0,14707,5545859,14.956521739130435
150,173,0,14708,5546032,11.533333333333333
210,342,0,14709,5546374,16.285714285714285
280,394,0,14710,5546768,14.071428571428571
200,248,0,14711,5547016,12.4
260,400,0,14712,5547416,15.384615384615385
330,558,0,14713,5547974,16.90909090909091
210,313,0,14714,5548287,14.904761904761905
270,491,0,14715,5548778,18.185185185185187
160,210,0,14716,5548988,13.125
350,614,0,14717,5549602,17.542857142857144
230,363,0,14718,5549965,15.782608695652174
150,218,0,14719,5550183,14.533333333333333
440,643,0,14720,5550826,14.613636363636363
270,413,0,14721,5551239,15.296296296296296
170,248,0,14722,5551487,14.588235294117647
180,283,0,14723,5551770,15.722222222222221
240,392,0,14724,5552162,16.333333333333332
180,290,0,14725,5552452,16.11111111111111
340,467,0,14726,5552919,13.735294117647058
230,303,0,14727,5553222,13.173913043478262
370,526,0,14728,5553748,14.216216216216216
340,494,0,14729,5554242,14.529411764705882
90,140,0,14730,5554382,15.555555555555555
200,314,0,14731,5554696,15.7
230,347,0,14732,5555043,15.08695652173913
70,68,0,14733,5555111,9.714285714285714
380,608,0,14734,5555719,16.0
330,494,0,14735,5556213,14.969696969696969
130,200,0,14736,5556413,15.384615384615385
210,269,0,14737,5556682,12.80952380952381
320,527,0,14738,5557209,16.46875
270,397,0,14739,5557606,14.703703703703704
300,449,0,14740,5558055,14.966666666666667
210,309,0,14741,5558364,14.714285714285714
170,188,0,14742,5558552,11.058823529411764
190,260,0,14743,5558812,13.68421052631579
340,469,0,14744,5559281,13.794117647058824
220,259,0,14745,5559540,11.772727272727273
430,673,0,14746,5560213,15.651162790697674
190,242,0,14747,5560455,12.736842105263158
110,109,0,14748,5560564,9.909090909090908
320,478,0,14749,5561042,14.9375
180,229,0,14750,5561271,12.722222222222221
190,251,0,14751,5561522,13.210526315789474
190,281,0,14752,5561803,14.789473684210526
310,471,0,14753,5562274,15.193548387096774
280,397,0,14754,5562671,14.178571428571429
190,226,0,14755,5562897,11.894736842105264
180,211,0,14756,5563108,11.722222222222221
230,359,0,14757,5563467,15.608695652173912
250,393,0,14758,5563860,15.72
170,198,0,14759,5564058,11.647058823529411
200,253,0,14760,5564311,12.65
110,160,0,14761,5564471,14.545454545454545
340,476,0,14762,5564947,14.0
490,972,0,14763,5565919,19.836734693877553
220,305,0,14764,5566224,13.863636363636363
320,495,0,14765,5566719,15.46875
430,732,0,14766,5567451,17.023255813953487
420,583,0,14767,5568034,13.880952380952381
210,333,0,14768,5568367,15.857142857142858
130,160,0,14769,5568527,12.307692307692308
260,402,0,14770,5568929,15.461538461538462
230,339,0,14771,5569268,14.73913043478261
140,205,0,14772,5569473,14.642857142857142
110,134,0,14773,5569607,12.181818181818182
130,210,0,14774,5569817,16.153846153846153
90,114,0,14775,5569931,12.666666666666666
480,714,0,14776,5570645,14.875
140,179,0,14777,5570824,12.785714285714286
410,619,0,14778,5571443,15.097560975609756
140,165,0,14779,5571608,11.785714285714286
280,451,0,14780,5572059,16.107142857142858
130,158,0,14781,5572217,12.153846153846153
240,276,0,14782,5572493,11.5
320,471,0,14783,5572964,14.71875
230,308,0,14784,5573272,13.391304347826088
360,554,0,14785,5573826,15.38888888888889
290,356,0,14786,5574182,12.275862068965518
460,816,0,14787,5574998,17.73913043478261
270,404,0,14788,5575402,14.962962962962964
210,283,0,14789,5575685,13.476190476190476
230,291,0,14790,5575976,12.652173913043478
260,335,0,14791,5576311,12.884615384615385
90,109,0,14792,5576420,12.11111111111111
170,263,0,14793,5576683,15.470588235294118
240,279,0,14794,5576962,11.625
190,273,0,14795,5577235,14.368421052631579
370,668,0,14796,5577903,18.054054054054053
360,520,0,14797,5578423,14.444444444444445
300,398,0,14798,5578821,13.266666666666667
370,568,0,14799,5579389,15.35135135135135
280,376,0,14800,5579765,13.428571428571429
430,627,0,14801,5580392,14.581395348837209
100,115,0,14802,5580507,11.5
420,732,0,14803,5581239,17.428571428571427
110,191,0,14804,5581430,17.363636363636363
300,540,0,14805,5581970,18.0
250,362,0,14806,5582332,14.48
400,588,0,14807,5582920,14.7
130,181,0,14808,5583101,13.923076923076923
170,196,0,14809,5583297,11.529411764705882
310,448,0,14810,5583745,14.451612903225806
270,351,0,14811,5584096,13.0
150,203,0,14812,5584299,13.533333333333333
290,494,0,14813,5584793,17.03448275862069
250,341,0,14814,5585134,13.64
300,452,0,14815,5585586,15.066666666666666
190,237,0,14816,5585823,12.473684210526315
130,197,0,14817,5586020,15.153846153846153
320,442,0,14818,5586462,13.8125
210,255,0,14819,5586717,12.142857142857142
100,131,0,14820,5586848,13.1
230,322,0,14821,5587170,14.0
340,581,0,14822,5587751,17.08823529411765
250,386,0,14823,5588137,15.44
260,345,0,14824,5588482,13.26923076923077
90,151,0,14825,5588633,16.77777777777778
370,581,0,14826,5589214,15.702702702702704
120,124,0,14827,5589338,10.333333333333334
190,244,0,14828,5589582,12.842105263157896
220,334,0,14829,5589916,15.181818181818182
330,515,0,14830,5590431,15.606060606060606
490,931,0,14831,5591362,19.0
320,428,0,14832,5591790,13.375
440,655,0,14833,5592445,14.886363636363637
330,538,0,14834,5592983,16.303030303030305
220,293,0,14835,5593276,13.318181818181818
110,167,0,14836,5593443,15.181818181818182
320,458,0,14837,5593901,14.3125
90,136,0,14838,5594037,15.11111111111111
330,475,0,14839,5594512,14.393939393939394
210,271,0,14840,5594783,12.904761904761905
140,169,0,14841,5594952,12.071428571428571
410,572,0,14842,5595524,13.951219512195122
220,329,0,14843,5595853,14.954545454545455
360,465,0,14844,5596318,12.916666666666666
260,376,0,14845,5596694,14.461538461538462
190,302,0,14846,5596996,15.894736842105264
130,186,0,14847,5597182,14.307692307692308
220,350,0,14848,5597532,15.909090909090908
150,235,0,14849,5597767,15.666666666666666
140,167,0,14850,5597934,11.928571428571429
340,455,0,14851,5598389,13.382352941176471
190,287,0,14852,5598676,15.105263157894736
310,435,0,14853,5599111,14.03225806451613
270,393,0,14854,5599504,14.555555555555555
240,355,0,14855,5599859,14.791666666666666
400,562,0,14856,5600421,14.05
500,837,0,14857,5601258,16.74
370,573,0,14858,5601831,15.486486486486486
240,387,0,14859,5602218,16.125
360,581,0,14860,5602799,16.13888888888889
180,273,0,14861,5603072,15.166666666666666
220,333,0,14862,5603405,15.136363636363637
50,43,0,14863,5603448,8.6
300,412,0,14864,5603860,13.733333333333333
160,235,0,14865,5604095,14.6875
250,348,0,14866,5604443,13.92
220,285,0,14867,5604728,12.954545454545455
140,231,0,14868,5604959,16.5
270,398,0,14869,5605357,14.74074074074074
170,302,0,14870,5605659,17.764705882352942
180,285,0,14871,5605944,15.833333333333334
300,490,0,14872,5606434,16.333333333333332
280,399,0,14873,5606833,14.25
310,384,0,14874,5607217,12.387096774193548
260,361,0,14875,5607578,13.884615384615385
320,511,0,14876,5608089,15.96875
280,423,0,14877,5608512,15.107142857142858
340,516,0,14878,5609028,15.176470588235293
330,441,0,14879,5609469,13.363636363636363
330,508,0,14880,5609977,15.393939393939394
330,529,0,14881,5610506,16.03030303030303
230,501,0,14882,5611007,21.782608695652176
240,378,0,14883,5611385,15.75
60,52,0,14884,5611437,8.666666666666666
270,355,0,14885,5611792,13.148148148148149
240,399,0,14886,5612191,16.625
180,273,0,14887,5612464,15.166666666666666
130,154,0,14888,5612618,11.846153846153847
210,315,0,14889,5612933,15.0
310,409,0,14890,5613342,13.193548387096774
280,433,0,14891,5613775,15.464285714285714
280,346,0,14892,5614121,12.357142857142858
340,501,0,14893,5614622,14.735294117647058
310,483,0,14894,5615105,15.580645161290322
100,109,0,14895,5615214,10.9
120,200,0,14896,5615414,16.666666666666668
330,439,0,14897,5615853,13.303030303030303
210,307,0,14898,5616160,14.619047619047619
230,338,0,14899,5616498,14.695652173913043
150,191,0,14900,5616689,12.733333333333333
220,364,0,14901,5617053,16.545454545454547
270,397,0,14902,5617450,14.703703703703704
360,516,0,14903,5617966,14.333333333333334
110,140,0,14904,5618106,12.727272727272727
230,388,0,14905,5618494,16.869565217391305
190,307,0,14906,5618801,16.157894736842106
360,502,0,14907,5619303,13.944444444444445
320,456,0,14908,5619759,14.25
160,192,0,14909,5619951,12.0
240,360,0,14910,5620311,15.0
230,366,0,14911,5620677,15.91304347826087
220,310,0,14912,5620987,14.090909090909092
310,448,0,14913,5621435,14.451612903225806
480,880,0,14914,5622315,18.333333333333332
170,242,0,14915,5622557,14.235294117647058
220,344,0,14916,5622901,15.636363636363637
280,428,0,14917,5623329,15.285714285714286
310,456,0,14918,5623785,14.709677419354838
280,378,0,14919,5624163,13.5
260,355,0,14920,5624518,13.653846153846153
160,199,0,14921,5624717,12.4375
290,361,0,14922,5625078,12.448275862068966
430,596,0,14923,5625674,13.86046511627907
410,676,0,14924,5626350,16.48780487804878
220,286,0,14925,5626636,13.0
330,579,0,14926,5627215,17.545454545454547
200,300,0,14927,5627515,15.0
210,286,0,14928,5627801,13.619047619047619
230,367,0,14929,5628168,15.956521739130435
130,169,0,14930,5628337,13.0
210,283,0,14931,5628620,13.476190476190476
280,403,0,14932,5629023,14.392857142857142
170,218,0,14933,5629241,12.823529411764707
160,199,0,14934,5629440,12.4375
310,456,0,14935,5629896,14.709677419354838
190,272,0,14936,5630168,14.31578947368421
270,368,0,14937,5630536,13.62962962962963
270,382,0,14938,5630918,14.148148148148149
220,293,0,14939,5631211,13.318181818181818
270,339,0,14940,5631550,12.555555555555555
210,239,0,14941,5631789,11.380952380952381
60,73,0,14942,5631862,12.166666666666666
270,451,0,14943,5632313,16.703703703703702
230,321,0,14944,5632634,13.956521739130435
140,143,0,14945,5632777,10.214285714285714
210,302,0,14946,5633079,14.380952380952381
420,702,0,14947,5633781,16.714285714285715
140,143,0,14948,5633924,10.214285714285714
150,196,0,14949,5634120,13.066666666666666
190,244,0,14950,5634364,12.842105263157896
240,404,0,14951,5634768,16.833333333333332
260,376,0,14952,5635144,14.461538461538462
290,418,0,14953,5635562,14.413793103448276
370,593,0,14954,5636155,16.027027027027028
320,432,0,14955,5636587,13.5
180,275,0,14956,5636862,15.277777777777779
210,318,0,14957,5637180,15.142857142857142
180,258,0,14958,5637438,14.333333333333334
220,290,0,14959,5637728,13.181818181818182
250,395,0,14960,5638123,15.8
180,231,0,14961,5638354,12.833333333333334
110,141,0,14962,5638495,12.818181818181818
180,270,0,14963,5638765,15.0
170,235,0,14964,5639000,13.823529411764707
320,442,0,14965,5639442,13.8125
270,337,0,14966,5639779,12.481481481481481
280,475,0,14967,5640254,16.964285714285715
290,498,0,14968,5640752,17.17241379310345
280,458,0,14969,5641210,16.357142857142858
210,342,0,14970,5641552,16.285714285714285
210,343,0,14971,5641895,16.333333333333332
260,410,0,14972,5642305,15.76923076923077
410,562,0,14973,5642867,13.707317073170731
280,441,0,14974,5643308,15.75
120,170,0,14975,5643478,14.166666666666666
330,476,0,14976,5643954,14.424242424242424
260,396,0,14977,5644350,15.23076923076923
200,260,0,14978,5644610,13.0
140,218,0,14979,5644828,15.571428571428571
220,319,0,14980,5645147,14.5
170,233,0,14981,5645380,13.705882352941176
250,455,0,14982,5645835,18.2
190,258,0,14983,5646093,13.578947368421053
170,225,0,14984,5646318,13.235294117647058
270,457,0,14985,5646775,16.925925925925927
220,355,0,14986,5647130,16.136363636363637
220,309,0,14987,5647439,14.045454545454545
130,174,0,14988,5647613,13.384615384615385
160,231,0,14989,5647844,14.4375
360,619,0,14990,5648463,17.194444444444443
290,420,0,14991,5648883,14.482758620689655
280,570,0,14992,5649453,20.357142857142858
210,343,0,14993,5649796,16.333333333333332
220,300,0,14994,5650096,13.636363636363637
170,247,0,14995,5650343,14.529411764705882
310,423,0,14996,5650766,13.64516129032258
70,96,0,14997,5650862,13.714285714285714
140,188,0,14998,5651050,13.428571428571429
130,198,0,14999,5651248,15.23076923076923
310,454,0,15000,5651702,14.64516129032258
330,442,0,15001,5652144,13.393939393939394
160,247,0,15002,5652391,15.4375
50,47,0,15003,5652438,9.4
260,356,0,15004,5652794,13.692307692307692
320,477,0,15005,5653271,14.90625
190,304,0,15006,5653575,16.0
270,362,0,15007,5653937,13.407407407407407
210,374,0,15008,5654311,17.80952380952381
310,441,0,15009,5654752,14.225806451612904
320,511,0,15010,5655263,15.96875
80,113,0,15011,5655376,14.125
200,361,0,15012,5655737,18.05
390,543,0,15013,5656280,13.923076923076923
200,251,0,15014,5656531,12.55
300,454,0,15015,5656985,15.133333333333333
330,465,0,15016,5657450,14.090909090909092
280,403,0,15017,5657853,14.392857142857142
100,107,0,15018,5657960,10.7
250,349,0,15019,5658309,13.96
250,391,0,15020,5658700,15.64
320,600,0,15021,5659300,18.75
240,333,0,15022,5659633,13.875
190,324,0,15023,5659957,17.05263157894737
450,745,0,15024,5660702,16.555555555555557
410,584,0,15025,5661286,14.24390243902439
110,125,0,15026,5661411,11.363636363636363
240,360,0,15027,5661771,15.0
130,173,0,15028,5661944,13.307692307692308
330,559,0,15029,5662503,16.939393939393938
320,442,0,15030,5662945,13.8125
200,300,0,15031,5663245,15.0
320,450,0,15032,5663695,14.0625
210,286,0,15033,5663981,13.619047619047619
270,339,0,15034,5664320,12.555555555555555
240,333,0,15035,5664653,13.875
320,441,0,15036,5665094,13.78125
70,97,0,15037,5665191,13.857142857142858
420,685,0,15038,5665876,16.30952380952381
340,515,0,15039,5666391,15.147058823529411
240,340,0,15040,5666731,14.166666666666666
400,605,0,15041,5667336,15.125
190,256,0,15042,5667592,13.473684210526315
150,217,0,15043,5667809,14.466666666666667
420,664,0,15044,5668473,15.80952380952381
130,169,0,15045,5668642,13.0
170,239,0,15046,5668881,14.058823529411764
360,590,0,15047,5669471,16.38888888888889
250,408,0,15048,5669879,16.32
210,341,0,15049,5670220,16.238095238095237
260,338,0,15050,5670558,13.0
280,384,0,15051,5670942,13.714285714285714
150,212,0,15052,5671154,14.133333333333333
370,600,0,15053,5671754,16.216216216216218
70,93,0,15054,5671847,13.285714285714286
280,553,0,15055,5672400,19.75
150,184,0,15056,5672584,12.266666666666667
300,438,0,15057,5673022,14.6
270,387,0,15058,5673409,14.333333333333334
400,670,0,15059,5674079,16.75
360,575,0,15060,5674654,15.972222222222221
220,346,0,15061,5675000,15.727272727272727
300,507,0,15062,5675507,16.9
350,601,0,15063,5676108,17.17142857142857
260,430,0,15064,5676538,16.53846153846154
340,530,0,15065,5677068,15.588235294117647
190,264,0,15066,5677332,13.894736842105264
390,589,0,15067,5677921,15.102564102564102
320,538,0,15068,5678459,16.8125
230,364,0,15069,5678823,15.826086956521738
280,358,0,15070,5679181,12.785714285714286
440,756,0,15071,5679937,17.181818181818183
270,379,0,15072,5680316,14.037037037037036
410,614,0,15073,5680930,14.975609756097562
170,234,0,15074,5681164,13.764705882352942
270,362,0,15075,5681526,13.407407407407407
350,482,0,15076,5682008,13.771428571428572
80,94,0,15077,5682102,11.75
280,376,0,15078,5682478,13.428571428571429
240,355,0,15079,5682833,14.791666666666666
300,471,0,15080,5683304,15.7
100,134,0,15081,5683438,13.4
240,370,0,15082,5683808,15.416666666666666
450,632,0,15083,5684440,14.044444444444444
290,452,0,15084,5684892,15.586206896551724
360,584,0,15085,5685476,16.22222222222222
340,510,0,15086,5685986,15.0
150,216,0,15087,5686202,14.4
130,141,0,15088,5686343,10.846153846153847
200,316,0,15089,5686659,15.8
280,365,0,15090,5687024,13.035714285714286
300,484,0,15091,5687508,16.133333333333333
390,582,0,15092,5688090,14.923076923076923
160,232,0,15093,5688322,14.5
200,323,0,15094,5688645,16.15
180,302,0,15095,5688947,16.77777777777778
200,283,0,15096,5689230,14.15
280,435,0,15097,5689665,15.535714285714286
160,238,0,15098,5689903,14.875
120,162,0,15099,5690065,13.5
380,666,0,15100,5690731,17.526315789473685
130,154,0,15101,5690885,11.846153846153847
310,439,0,15102,5691324,14.161290322580646
570,1070,0,15103,5692394,18.771929824561404
200,317,0,15104,5692711,15.85
220,271,0,15105,5692982,12.318181818181818
400,673,0,15106,5693655,16.825
110,149,0,15107,5693804,13.545454545454545
280,380,0,15108,5694184,13.571428571428571
420,750,0,15109,5694934,17.857142857142858
280,405,0,15110,5695339,14.464285714285714
100,133,0,15111,5695472,13.3
240,367,0,15112,5695839,15.291666666666666
140,207,0,15113,5696046,14.785714285714286
150,219,0,15114,5696265,14.6
370,536,0,15115,5696801,14.486486486486486
200,266,0,15116,5697067,13.3
180,225,0,15117,5697292,12.5
400,669,0,15118,5697961,16.725
300,445,0,15119,5698406,14.833333333333334
90,112,0,15120,5698518,12.444444444444445
450,744,0,15121,5699262,16.533333333333335
140,186,0,15122,5699448,13.285714285714286
240,366,0,15123,5699814,15.25
360,537,0,15124,5700351,14.916666666666666
240,328,0,15125,5700679,13.666666666666666
230,371,0,15126,5701050,16.130434782608695
90,144,0,15127,5701194,16.0
230,333,0,15128,5701527,14.478260869565217
370,538,0,15129,5702065,14.54054054054054
270,451,0,15130,5702516,16.703703703703702
160,225,0,15131,5702741,14.0625
230,362,0,15132,5703103,15.73913043478261
340,515,0,15133,5703618,15.147058823529411
380,601,0,15134,5704219,15.81578947368421
90,130,0,15135,5704349,14.444444444444445
340,572,0,15136,5704921,16.823529411764707
440,746,0,15137,5705667,16.954545454545453
280,441,0,15138,5706108,15.75
240,344,0,15139,5706452,14.333333333333334
140,210,0,15140,5706662,15.0
160,194,0,15141,5706856,12.125
230,401,0,15142,5707257,17.434782608695652
170,268,0,15143,5707525,15.764705882352942
140,194,0,15144,5707719,13.857142857142858
170,281,0,15145,5708000,16.529411764705884
240,352,0,15146,5708352,14.666666666666666
350,520,0,15147,5708872,14.857142857142858
470,753,0,15148,5709625,16.02127659574468
340,420,0,15149,5710045,12.352941176470589
400,775,0,15150,5710820,19.375
170,246,0,15151,5711066,14.470588235294118
300,502,0,15152,5711568,16.733333333333334
250,362,0,15153,5711930,14.48
100,115,0,15154,5712045,11.5
410,684,0,15155,5712729,16.682926829268293
250,406,0,15156,5713135,16.24
210,297,0,15157,5713432,14.142857142857142
210,277,0,15158,5713709,13.19047619047619
140,190,0,15159,5713899,13.571428571428571
170,239,0,15160,5714138,14.058823529411764
410,612,0,15161,5714750,14.926829268292684
270,378,0,15162,5715128,14.0
70,94,0,15163,5715222,13.428571428571429
250,413,0,15164,5715635,16.52
210,346,0,15165,5715981,16.476190476190474
190,277,0,15166,5716258,14.578947368421053
270,368,0,15167,5716626,13.62962962962963
370,576,0,15168,5717202,15.567567567567568
180,273,0,15169,5717475,15.166666666666666
390,661,0,15170,5718136,16.94871794871795
140,242,0,15171,5718378,17.285714285714285
110,165,0,15172,5718543,15.0
290,453,0,15173,5718996,15.620689655172415
420,608,0,15174,5719604,14.476190476190476
320,533,0,15175,5720137,16.65625
120,146,0,15176,5720283,12.166666666666666
270,387,0,15177,5720670,14.333333333333334
160,220,0,15178,5720890,13.75
80,103,0,15179,5720993,12.875
220,295,0,15180,5721288,13.409090909090908
160,266,0,15181,5721554,16.625
300,444,0,15182,5721998,14.8
390,633,0,15183,5722631,16.23076923076923
310,408,0,15184,5723039,13.161290322580646
270,522,0,15185,5723561,19.333333333333332
160,233,0,15186,5723794,14.5625
450,663,0,15187,5724457,14.733333333333333
250,387,0,15188,5724844,15.48
100,130,0,15189,5724974,13.0
450,780,0,15190,5725754,17.333333333333332
230,300,0,15191,5726054,13.043478260869565
420,688,0,15192,5726742,16.38095238095238
260,361,0,15193,5727103,13.884615384615385
530,891,0,15194,5727994,16.81132075471698
240,321,0,15195,5728315,13.375
210,260,0,15196,5728575,12.380952380952381
230,344,0,15197,5728919,14.956521739130435
300,444,0,15198,5729363,14.8
370,646,0,15199,5730009,17.45945945945946
380,636,0,15200,5730645,16.736842105263158
180,277,0,15201,5730922,15.38888888888889
270,377,0,15202,5731299,13.962962962962964
370,556,0,15203,5731855,15.027027027027026
320,438,0,15204,5732293,13.6875
160,260,0,15205,5732553,16.25
160,174,0,15206,5732727,10.875
240,380,0,15207,5733107,15.833333333333334
90,122,0,15208,5733229,13.555555555555555
200,257,0,15209,5733486,12.85
540,1064,0,15210,5734550,19.703703703703702
350,528,0,15211,5735078,15.085714285714285
100,161,0,15212,5735239,16.1
470,772,0,15213,5736011,16.425531914893618
230,336,0,15214,5736347,14.608695652173912
290,385,0,15215,5736732,13.275862068965518
280,327,0,15216,5737059,11.678571428571429
210,224,0,15217,5737283,10.666666666666666
230,316,0,15218,5737599,13.73913043478261
280,496,0,15219,5738095,17.714285714285715
440,613,0,15220,5738708,13.931818181818182
450,680,0,15221,5739388,15.11111111111111
260,344,0,15222,5739732,13.23076923076923
380,542,0,15223,5740274,14.263157894736842
250,317,0,15224,5740591,12.68
160,235,0,15225,5740826,14.6875
370,563,0,15226,5741389,15.216216216216216
150,193,0,15227,5741582,12.866666666666667
90,130,0,15228,5741712,14.444444444444445
510,966,0,15229,5742678,18.941176470588236
220,313,0,15230,5742991,14.227272727272727
140,166,0,15231,5743157,11.857142857142858
320,434,0,15232,5743591,13.5625
400,668,0,15233,5744259,16.7
180,262,0,15234,5744521,14.555555555555555
310,550,0,15235,5745071,17.741935483870968
240,398,0,15236,5745469,16.583333333333332
340,494,0,15237,5745963,14.529411764705882
150,253,0,15238,5746216,16.866666666666667
260,393,0,15239,5746609,15.115384615384615
450,670,0,15240,5747279,14.88888888888889
110,144,0,15241,5747423,13.090909090909092
310,452,0,15242,5747875,14.580645161290322
230,314,0,15243,5748189,13.652173913043478
250,358,0,15244,5748547,14.32
230,293,0,15245,5748840,12.73913043478261
80,75,0,15246,5748915,9.375
300,461,0,15247,5749376,15.366666666666667
440,751,0,15248,5750127,17.068181818181817
220,332,0,15249,5750459,15.090909090909092
220,314,0,15250,5750773,14.272727272727273
360,542,0,15251,5751315,15.055555555555555
220,326,0,15252,5751641,14.818181818181818
110,146,0,15253,5751787,13.272727272727273
480,633,0,15254,5752420,13.1875
420,656,0,15255,5753076,15.619047619047619
420,661,0,15256,5753737,15.738095238095237
350,503,0,15257,5754240,14.371428571428572
230,312,0,15258,5754552,13.565217391304348
240,329,0,15259,5754881,13.708333333333334
170,206,0,15260,5755087,12.117647058823529
110,125,0,15261,5755212,11.363636363636363
80,127,0,15262,5755339,15.875
160,206,0,15263,5755545,12.875
70,87,0,15264,5755632,12.428571428571429
330,528,0,15265,5756160,16.0
250,381,0,15266,5756541,15.24
300,457,0,15267,5756998,15.233333333333333
290,370,0,15268,5757368,12.758620689655173
210,293,0,15269,5757661,13.952380952380953
370,507,0,15270,5758168,13.702702702702704
370,577,0,15271,5758745,15.594594594594595
170,256,0,15272,5759001,15.058823529411764
490,895,0,15273,5759896,18.26530612244898
190,371,0,15274,5760267,19.526315789473685
340,511,0,15275,5760778,15.029411764705882
170,225,0,15276,5761003,13.235294117647058
170,279,0,15277,5761282,16.41176470588235
170,286,0,15278,5761568,16.823529411764707
280,425,0,15279,5761993,15.178571428571429
250,464,0,15280,5762457,18.56
360,546,0,15281,5763003,15.166666666666666
150,156,0,15282,5763159,10.4
190,271,0,15283,5763430,14.263157894736842
160,180,0,15284,5763610,11.25
220,295,0,15285,5763905,13.409090909090908
120,142,0,15286,5764047,11.833333333333334
210,308,0,15287,5764355,14.666666666666666
280,434,0,15288,5764789,15.5
180,224,0,15289,5765013,12.444444444444445
110,145,0,15290,5765158,13.181818181818182
300,439,0,15291,5765597,14.633333333333333
250,410,0,15292,5766007,16.4
190,275,0,15293,5766282,14.473684210526315
220,228,0,15294,5766510,10.363636363636363
280,463,0,15295,5766973,16.535714285714285
180,182,0,15296,5767155,10.11111111111111
260,442,0,15297,5767597,17.0
330,540,0,15298,5768137,16.363636363636363
310,444,0,15299,5768581,14.32258064516129
350,518,0,15300,5769099,14.8
220,364,0,15301,5769463,16.545454545454547
240,307,0,15302,5769770,12.791666666666666
340,528,0,15303,5770298,15.529411764705882
260,451,0,15304,5770749,17.346153846153847
290,424,0,15305,5771173,14.620689655172415
410,597,0,15306,5771770,14.560975609756097
170,240,0,15307,5772010,14.117647058823529
270,331,0,15308,5772341,12.25925925925926
240,357,0,15309,5772698,14.875
390,642,0,15310,5773340,16.46153846153846
230,400,0,15311,5773740,17.391304347826086
250,365,0,15312,5774105,14.6
230,296,0,15313,5774401,12.869565217391305
80,103,0,15314,5774504,12.875
280,473,0,15315,5774977,16.892857142857142
260,381,0,15316,5775358,14.653846153846153
460,752,0,15317,5776110,16.347826086956523
180,330,0,15318,5776440,18.333333333333332
230,380,0,15319,5776820,16.52173913043478
180,254,0,15320,5777074,14.11111111111111
190,272,0,15321,5777346,14.31578947368421
260,369,0,15322,5777715,14.192307692307692
420,576,0,15323,5778291,13.714285714285714
230,313,0,15324,5778604,13.608695652173912
280,490,0,15325,5779094,17.5
240,347,0,15326,5779441,14.458333333333334
150,193,0,15327,5779634,12.866666666666667
70,100,0,15328,5779734,14.285714285714286
200,276,0,15329,5780010,13.8
250,331,0,15330,5780341,13.24
260,411,0,15331,5780752,15.807692307692308
140,221,0,15332,5780973,15.785714285714286
330,486,0,15333,5781459,14.727272727272727
130,234,0,15334,5781693,18.0
170,241,0,15335,5781934,14.176470588235293
100,124,0,15336,5782058,12.4
290,468,0,15337,5782526,16.137931034482758
210,340,0,15338,5782866,16.19047619047619
140,146,0,15339,5783012,10.428571428571429
310,443,0,15340,5783455,14.290322580645162
310,538,0,15341,5783993,17.35483870967742
190,304,0,15342,5784297,16.0
210,330,0,15343,5784627,15.714285714285714
200,340,0,15344,5784967,17.0
250,413,0,15345,5785380,16.52
230,302,0,15346,5785682,13.130434782608695
170,245,0,15347,5785927,14.411764705882353
230,365,0,15348,5786292,15.869565217391305
110,140,0,15349,5786432,12.727272727272727
230,285,0,15350,5786717,12.391304347826088
280,490,0,15351,5787207,17.5
190,250,0,15352,5787457,13.157894736842104
250,386,0,15353,5787843,15.44
170,275,0,15354,5788118,16.176470588235293
350,563,0,15355,5788681,16.085714285714285
470,684,0,15356,5789365,14.553191489361701
140,179,0,15357,5789544,12.785714285714286
140,180,0,15358,5789724,12.857142857142858
320,406,0,15359,5790130,12.6875
120,165,0,15360,5790295,13.75
130,146,0,15361,5790441,11.23076923076923
180,219,0,15362,5790660,12.166666666666666
120,193,0,15363,5790853,16.083333333333332
370,608,0,15364,5791461,16.43243243243243
300,507,0,15365,5791968,16.9
110,134,0,15366,5792102,12.181818181818182
290,462,0,15367,5792564,15.931034482758621
340,515,0,15368,5793079,15.147058823529411
150,225,0,15369,5793304,15.0
330,620,0,15370,5793924,18.78787878787879
270,378,0,15371,5794302,14.0
330,652,0,15372,5794954,19.757575757575758
290,447,0,15373,5795401,15.413793103448276
310,422,0,15374,5795823,13.612903225806452
300,464,0,15375,5796287,15.466666666666667
280,401,0,15376,5796688,14.321428571428571
170,215,0,15377,5796903,12.647058823529411
210,271,0,15378,5797174,12.904761904761905
450,751,0,15379,5797925,16.68888888888889
130,200,0,15380,5798125,15.384615384615385
280,422,0,15381,5798547,15.071428571428571
120,226,0,15382,5798773,18.833333333333332
290,466,0,15383,5799239,16.06896551724138
290,427,0,15384,5799666,14.724137931034482
210,298,0,15385,5799964,14.19047619047619
150,204,0,15386,5800168,13.6
130,207,0,15387,5800375,15.923076923076923
290,444,0,15388,5800819,15.310344827586206
280,467,0,15389,5801286,16.678571428571427
240,395,0,15390,5801681,16.458333333333332
330,468,0,15391,5802149,14.181818181818182
260,368,0,15392,5802517,14.153846153846153
490,808,0,15393,5803325,16.489795918367346
160,217,0,15394,5803542,13.5625
170,237,0,15395,5803779,13.941176470588236
240,370,0,15396,5804149,15.416666666666666
300,495,0,15397,5804644,16.5
360,464,0,15398,5805108,12.88888888888889
360,541,0,15399,5805649,15.027777777777779
400,659,0,15400,5806308,16.475
170,229,0,15401,5806537,13.470588235294118
190,301,0,15402,5806838,15.842105263157896
330,585,0,15403,5807423,17.727272727272727
280,425,0,15404,5807848,15.178571428571429
300,370,0,15405,5808218,12.333333333333334
320,523,0,15406,5808741,16.34375
420,761,0,15407,5809502,18.11904761904762
70,68,0,15408,5809570,9.714285714285714
250,356,0,15409,5809926,14.24
360,597,0,15410,5810523,16.583333333333332
310,467,0,15411,5810990,15.064516129032258
270,462,0,15412,5811452,17.11111111111111
390,664,0,15413,5812116,17.025641025641026
210,315,0,15414,5812431,15.0
110,164,0,15415,5812595,14.909090909090908
300,490,0,15416,5813085,16.333333333333332
180,243,0,15417,5813328,13.5
170,202,0,15418,5813530,11.882352941176471
250,399,0,15419,5813929,15.96
330,527,0,15420,5814456,15.969696969696969
210,274,0,15421,5814730,13.047619047619047
410,666,0,15422,5815396,16.24390243902439
390,552,0,15423,5815948,14.153846153846153
270,395,0,15424,5816343,14.62962962962963
350,564,0,15425,5816907,16.114285714285714
430,718,0,15426,5817625,16.697674418604652
280,447,0,15427,5818072,15.964285714285714
410,614,0,15428,5818686,14.975609756097562
160,240,0,15429,5818926,15.0
210,357,0,15430,5819283,17.0
260,396,0,15431,5819679,15.23076923076923
240,334,0,15432,5820013,13.916666666666666
100,119,0,15433,5820132,11.9
290,417,0,15434,5820549,14.379310344827585
490,909,0,15435,5821458,18.551020408163264
230,381,0,15436,5821839,16.565217391304348
100,145,0,15437,5821984,14.5
300,422,0,15438,5822406,14.066666666666666
70,79,0,15439,5822485,11.285714285714286
180,270,0,15440,5822755,15.0
370,637,0,15441,5823392,17.216216216216218
280,407,0,15442,5823799,14.535714285714286
210,216,0,15443,5824015,10.285714285714286
270,391,0,15444,5824406,14.481481481481481
330,535,0,15445,5824941,16.21212121212121
230,338,0,15446,5825279,14.695652173913043
240,333,0,15447,5825612,13.875
390,600,0,15448,5826212,15.384615384615385
200,381,0,15449,5826593,19.05
300,397,0,15450,5826990,13.233333333333333
160,241,0,15451,5827231,15.0625
180,220,0,15452,5827451,12.222222222222221
230,332,0,15453,5827783,14.434782608695652
260,446,0,15454,5828229,17.153846153846153
230,323,0,15455,5828552,14.043478260869565
250,397,0,15456,5828949,15.88
420,699,0,15457,5829648,16.642857142857142
220,307,0,15458,5829955,13.954545454545455
210,267,0,15459,5830222,12.714285714285714
120,158,0,15460,5830380,13.166666666666666
180,283,0,15461,5830663,15.722222222222221
120,164,0,15462,5830827,13.666666666666666
300,498,0,15463,5831325,16.6
160,202,0,15464,5831527,12.625
90,147,0,15465,5831674,16.333333333333332
350,500,0,15466,5832174,14.285714285714286
170,236,0,15467,5832410,13.882352941176471
390,540,0,15468,5832950,13.846153846153847
260,381,0,15469,5833331,14.653846153846153
140,203,0,15470,5833534,14.5
160,236,0,15471,5833770,14.75
290,421,0,15472,5834191,14.517241379310345
360,578,0,15473,5834769,16.055555555555557
200,280,0,15474,5835049,14.0
190,338,0,15475,5835387,17.789473684210527
160,241,0,15476,5835628,15.0625
270,348,0,15477,5835976,12.88888888888889
270,461,0,15478,5836437,17.074074074074073
380,651,0,15479,5837088,17.13157894736842
80,131,0,15480,5837219,16.375
80,110,0,15481,5837329,13.75
440,703,0,15482,5838032,15.977272727272727
320,429,0,15483,5838461,13.40625
370,596,0,15484,5839057,16.10810810810811
280,400,0,15485,5839457,14.285714285714286
210,291,0,15486,5839748,13.857142857142858
330,483,0,15487,5840231,14.636363636363637
280,433,0,15488,5840664,15.464285714285714
200,260,0,15489,5840924,13.0
270,465,0,15490,5841389,17.22222222222222
100,135,0,15491,5841524,13.5
200,279,0,15492,5841803,13.95
230,295,0,15493,5842098,12.826086956521738
130,194,0,15494,5842292,14.923076923076923
200,275,0,15495,5842567,13.75
330,483,0,15496,5843050,14.636363636363637
350,463,0,15497,5843513,13.228571428571428
210,316,0,15498,5843829,15.047619047619047
210,271,0,15499,5844100,12.904761904761905
420,700,0,15500,5844800,16.666666666666668
320,503,0,15501,5845303,15.71875
200,258,0,15502,5845561,12.9
290,435,0,15503,5845996,15.0
490,750,0,15504,5846746,15.306122448979592
90,77,0,15505,5846823,8.555555555555555
390,803,0,15506,5847626,20.58974358974359
160,206,0,15507,5847832,12.875
110,147,0,15508,5847979,13.363636363636363
130,134,0,15509,5848113,10.307692307692308
160,262,0,15510,5848375,16.375
370,505,0,15511,5848880,13.64864864864865
180,234,0,15512,5849114,13.0
250,329,0,15513,5849443,13.16
360,503,0,15514,5849946,13.972222222222221
300,512,0,15515,5850458,17.066666666666666
80,103,0,15516,5850561,12.875
420,624,0,15517,5851185,14.857142857142858
140,196,0,15518,5851381,14.0
340,480,0,15519,5851861,14.117647058823529
130,178,0,15520,5852039,13.692307692307692
320,454,0,15521,5852493,14.1875
250,416,0,15522,5852909,16.64
130,185,0,15523,5853094,14.23076923076923
440,646,0,15524,5853740,14.681818181818182
210,253,0,15525,5853993,12.047619047619047
340,466,0,15526,5854459,13.705882352941176
220,303,0,15527,5854762,13.772727272727273
320,539,0,15528,5855301,16.84375
430,607,0,15529,5855908,14.116279069767442
300,431,0,15530,5856339,14.366666666666667
220,301,0,15531,5856640,13.681818181818182
310,435,0,15532,5857075,14.03225806451613
130,206,0,15533,5857281,15.846153846153847
190,257,0,15534,5857538,13.526315789473685
350,572,0,15535,5858110,16.34285714285714
40,67,0,15536,5858177,16.75
100,187,0,15537,5858364,18.7
220,304,0,15538,5858668,13.818181818181818
290,482,0,15539,5859150,16.620689655172413
300,468,0,15540,5859618,15.6
270,379,0,15541,5859997,14.037037037037036
310,465,0,15542,5860462,15.0
230,319,0,15543,5860781,13.869565217391305
130,162,0,15544,5860943,12.461538461538462
200,285,0,15545,5861228,14.25
260,395,0,15546,5861623,15.192307692307692
240,344,0,15547,5861967,14.333333333333334
260,348,0,15548,5862315,13.384615384615385
240,326,0,15549,5862641,13.583333333333334
200,264,0,15550,5862905,13.2
100,110,0,15551,5863015,11.0
310,432,0,15552,5863447,13.935483870967742
200,269,0,15553,5863716,13.45
350,531,0,15554,5864247,15.17142857142857
120,138,0,15555,5864385,11.5
250,351,0,15556,5864736,14.04
180,213,0,15557,5864949,11.833333333333334
160,237,0,15558,5865186,14.8125
240,340,0,15559,5865526,14.166666666666666
260,380,0,15560,5865906,14.615384615384615
150,172,0,15561,5866078,11.466666666666667
210,323,0,15562,5866401,15.380952380952381
140,199,0,15563,5866600,14.214285714285714
290,429,0,15564,5867029,14.793103448275861
300,451,0,15565,5867480,15.033333333333333
330,596,0,15566,5868076,18.060606060606062
630,1239,0,15567,5869315,19.666666666666668
210,255,0,15568,5869570,12.142857142857142
310,487,0,15569,5870057,15.709677419354838
250,388,0,15570,5870445,15.52
220,323,0,15571,5870768,14.681818181818182
120,189,0,15572,5870957,15.75
220,303,0,15573,5871260,13.772727272727273
270,398,0,15574,5871658,14.74074074074074
420,628,0,15575,5872286,14.952380952380953
280,454,0,15576,5872740,16.214285714285715
130,172,0,15577,5872912,13.23076923076923
140,204,0,15578,5873116,14.571428571428571
330,419,0,15579,5873535,12.696969696969697
160,195,0,15580,5873730,12.1875
190,222,0,15581,5873952,11.68421052631579
280,409,0,15582,5874361,14.607142857142858
330,552,0,15583,5874913,16.727272727272727
170,200,0,15584,5875113,11.764705882352942
210,318,0,15585,5875431,15.142857142857142
240,354,0,15586,5875785,14.75
320,537,0,15587,5876322,16.78125
140,209,0,15588,5876531,14.928571428571429
120,206,0,15589,5876737,17.166666666666668
250,334,0,15590,5877071,13.36
270,363,0,15591,5877434,13.444444444444445
220,252,0,15592,5877686,11.454545454545455
320,463,0,15593,5878149,14.46875
190,321,0,15594,5878470,16.894736842105264
320,511,0,15595,5878981,15.96875
70,98,0,15596,5879079,14.0
180,264,0,15597,5879343,14.666666666666666
80,113,0,15598,5879456,14.125
200,298,0,15599,5879754,14.9
300,405,0,15600,5880159,13.5
210,298,0,15601,5880457,14.19047619047619
90,98,0,15602,5880555,10.88888888888889
240,282,0,15603,5880837,11.75
230,324,0,15604,5881161,14.08695652173913
260,416,0,15605,5881577,16.0
360,636,0,15606,5882213,17.666666666666668
390,616,0,15607,5882829,15.794871794871796
250,376,0,15608,5883205,15.04
160,215,0,15609,5883420,13.4375
230,369,0,15610,5883789,16.043478260869566
160,235,0,15611,5884024,14.6875
120,216,0,15612,5884240,18.0
140,243,0,15613,5884483,17.357142857142858
260,374,0,15614,5884857,14.384615384615385
120,169,0,15615,5885026,14.083333333333334
320,510,0,15616,5885536,15.9375
500,780,0,15617,5886316,15.6
250,401,0,15618,5886717,16.04
450,540,0,15619,5887257,12.0
220,372,0,15620,5887629,16.90909090909091
180,248,0,15621,5887877,13.777777777777779
190,301,0,15622,5888178,15.842105263157896
70,50,0,15623,5888228,7.142857142857143
450,753,0,15624,5888981,16.733333333333334
200,279,0,15625,5889260,13.95
70,58,0,15626,5889318,8.285714285714286
400,618,0,15627,5889936,15.45
190,334,0,15628,5890270,17.57894736842105
50,67,0,15629,5890337,13.4
360,551,0,15630,5890888,15.305555555555555
140,194,0,15631,5891082,13.857142857142858
290,384,0,15632,5891466,13.241379310344827
250,385,0,15633,5891851,15.4
220,307,0,15634,5892158,13.954545454545455
280,383,0,15635,5892541,13.678571428571429
260,370,0,15636,5892911,14.23076923076923
380,498,0,15637,5893409,13.105263157894736
200,252,0,15638,5893661,12.6
200,312,0,15639,5893973,15.6
330,421,0,15640,5894394,12.757575757575758
380,615,0,15641,5895009,16.18421052631579
270,467,0,15642,5895476,17.296296296296298
400,599,0,15643,5896075,14.975
340,570,0,15644,5896645,16.764705882352942
340,475,0,15645,5897120,13.970588235294118
460,660,0,15646,5897780,14.347826086956522
240,347,0,15647,5898127,14.458333333333334
340,538,0,15648,5898665,15.823529411764707
110,122,0,15649,5898787,11.090909090909092
260,416,0,15650,5899203,16.0
240,377,0,15651,5899580,15.708333333333334
350,454,0,15652,5900034,12.971428571428572
420,683,0,15653,5900717,16.261904761904763
130,152,0,15654,5900869,11.692307692307692
220,316,0,15655,5901185,14.363636363636363
380,637,0,15656,5901822,16.763157894736842
130,190,0,15657,5902012,14.615384615384615
270,436,0,15658,5902448,16.14814814814815
220,318,0,15659,5902766,14.454545454545455
300,456,0,15660,5903222,15.2
150,240,0,15661,5903462,16.0
240,345,0,15662,5903807,14.375
260,373,0,15663,5904180,14.346153846153847
290,489,0,15664,5904669,16.862068965517242
220,360,0,15665,5905029,16.363636363636363
260,354,0,15666,5905383,13.615384615384615
160,251,0,15667,5905634,15.6875
150,174,0,15668,5905808,11.6
230,289,0,15669,5906097,12.565217391304348
150,210,0,15670,5906307,14.0
240,341,0,15671,5906648,14.208333333333334
180,319,0,15672,5906967,17.72222222222222
420,682,0,15673,5907649,16.238095238095237
220,369,0,15674,5908018,16.772727272727273
180,260,0,15675,5908278,14.444444444444445
280,380,0,15676,5908658,13.571428571428571
170,165,0,15677,5908823,9.705882352941176
220,367,0,15678,5909190,16.681818181818183
290,408,0,15679,5909598,14.068965517241379
130,181,0,15680,5909779,13.923076923076923
280,486,0,15681,5910265,17.357142857142858
240,329,0,15682,5910594,13.708333333333334
240,451,0,15683,5911045,18.791666666666668
320,578,0,15684,5911623,18.0625
250,386,0,15685,5912009,15.44
220,304,0,15686,5912313,13.818181818181818
200,236,0,15687,5912549,11.8
460,726,0,15688,5913275,15.782608695652174
60,84,0,15689,5913359,14.0
190,259,0,15690,5913618,13.631578947368421
340,484,0,15691,5914102,14.235294117647058
390,590,0,15692,5914692,15.128205128205128
460,708,0,15693,5915400,15.391304347826088
140,166,0,15694,5915566,11.857142857142858
110,113,0,15695,5915679,10.272727272727273
290,435,0,15696,5916114,15.0
200,276,0,15697,5916390,13.8
200,369,0,15698,5916759,18.45
320,452,0,15699,5917211,14.125
170,195,0,15700,5917406,11.470588235294118
230,320,0,15701,5917726,13.91304347826087
350,526,0,15702,5918252,15.028571428571428
290,355,0,15703,5918607,12.241379310344827
290,436,0,15704,5919043,15.03448275862069
120,170,0,15705,5919213,14.166666666666666
340,550,0,15706,5919763,16.176470588235293
280,352,0,15707,5920115,12.571428571428571
250,348,0,15708,5920463,13.92
250,343,0,15709,5920806,13.72
180,261,0,15710,5921067,14.5
360,580,0,15711,5921647,16.11111111111111
330,508,0,15712,5922155,15.393939393939394
250,403,0,15713,5922558,16.12
260,353,0,15714,5922911,13.576923076923077
260,459,0,15715,5923370,17.653846153846153
350,477,0,15716,5923847,13.628571428571428
140,188,0,15717,5924035,13.428571428571429
240,398,0,15718,5924433,16.583333333333332
350,539,0,15719,5924972,15.4
130,192,0,15720,5925164,14.76923076923077
140,193,0,15721,5925357,13.785714285714286
240,377,0,15722,5925734,15.708333333333334
310,474,0,15723,5926208,15.290322580645162
340,442,0,15724,5926650,13.0
470,757,0,15725,5927407,16.106382978723403
170,242,0,15726,5927649,14.235294117647058
390,579,0,15727,5928228,14.846153846153847
230,346,0,15728,5928574,15.043478260869565
400,598,0,15729,5929172,14.95
160,199,0,15730,5929371,12.4375
220,321,0,15731,5929692,14.590909090909092
290,506,0,15732,5930198,17.448275862068964
260,356,0,15733,5930554,13.692307692307692
340,513,0,15734,5931067,15.088235294117647
250,339,0,15735,5931406,13.56
150,206,0,15736,5931612,13.733333333333333
250,412,0,15737,5932024,16.48
230,347,0,15738,5932371,15.08695652173913
150,188,0,15739,5932559,12.533333333333333
140,192,0,15740,5932751,13.714285714285714
150,243,0,15741,5932994,16.2
240,329,0,15742,5933323,13.708333333333334
300,455,0,15743,5933778,15.166666666666666
380,522,0,15744,5934300,13.736842105263158
440,624,0,15745,5934924,14.181818181818182
220,271,0,15746,5935195,12.318181818181818
330,524,0,15747,5935719,15.878787878787879
330,443,0,15748,5936162,13.424242424242424
290,427,0,15749,5936589,14.724137931034482
240,294,0,15750,5936883,12.25
170,232,0,15751,5937115,13.647058823529411
250,340,0,15752,5937455,13.6
320,490,0,15753,5937945,15.3125
450,747,0,15754,5938692,16.6
100,120,0,15755,5938812,12.0
300,376,0,15756,5939188,12.533333333333333
230,289,0,15757,5939477,12.565217391304348
120,186,0,15758,5939663,15.5
300,481,0,15759,5940144,16.033333333333335
450,771,0,15760,5940915,17.133333333333333
210,299,0,15761,5941214,14.238095238095237
350,435,0,15762,5941649,12.428571428571429
410,649,0,15763,5942298,15.829268292682928
260,380,0,15764,5942678,14.615384615384615
180,207,0,15765,5942885,11.5
350,466,0,15766,5943351,13.314285714285715
190,272,0,15767,5943623,14.31578947368421
150,242,0,15768,5943865,16.133333333333333
180,304,0,15769,5944169,16.88888888888889
210,352,0,15770,5944521,16.761904761904763
230,474,0,15771,5944995,20.608695652173914
150,193,0,15772,5945188,12.866666666666667
300,522,0,15773,5945710,17.4
260,374,0,15774,5946084,14.384615384615385
240,354,0,15775,5946438,14.75
230,294,0,15776,5946732,12.782608695652174
250,348,0,15777,5947080,13.92
320,504,0,15778,5947584,15.75
140,222,0,15779,5947806,15.857142857142858
300,471,0,15780,5948277,15.7
380,687,0,15781,5948964,18.07894736842105
470,849,0,15782,5949813,18.06382978723404
250,341,0,15783,5950154,13.64
210,242,0,15784,5950396,11.523809523809524
290,443,0,15785,5950839,15.275862068965518
280,479,0,15786,5951318,17.107142857142858
270,392,0,15787,5951710,14.518518518518519
260,392,0,15788,5952102,15.076923076923077
300,471,0,15789,5952573,15.7
440,583,0,15790,5953156,13.25
200,304,0,15791,5953460,15.2
300,492,0,15792,5953952,16.4
400,586,0,15793,5954538,14.65
370,474,0,15794,5955012,12.81081081081081
200,284,0,15795,5955296,14.2
230,398,0,15796,5955694,17.304347826086957
190,271,0,15797,5955965,14.263157894736842
350,578,0,15798,5956543,16.514285714285716
500,768,0,15799,5957311,15.36
210,360,0,15800,5957671,17.142857142857142
250,380,0,15801,5958051,15.2
240,395,0,15802,5958446,16.458333333333332
300,451,0,15803,5958897,15.033333333333333
140,167,0,15804,5959064,11.928571428571429
200,246,0,15805,5959310,12.3
130,164,0,15806,5959474,12.615384615384615
260,313,0,15807,5959787,12.038461538461538
250,333,0,15808,5960120,13.32
320,514,0,15809,5960634,16.0625
420,640,0,15810,5961274,15.238095238095237
260,403,0,15811,5961677,15.5
180,248,0,15812,5961925,13.777777777777779
170,312,0,15813,5962237,18.352941176470587
250,343,0,15814,5962580,13.72
360,543,0,15815,5963123,15.083333333333334
200,345,0,15816,5963468,17.25
260,408,0,15817,5963876,15.692307692307692
390,646,0,15818,5964522,16.564102564102566
160,265,0,15819,5964787,16.5625
250,386,0,15820,5965173,15.44
170,245,0,15821,5965418,14.411764705882353
330,573,0,15822,5965991,17.363636363636363
320,459,0,15823,5966450,14.34375
330,475,0,15824,5966925,14.393939393939394
280,361,0,15825,5967286,12.892857142857142
280,412,0,15826,5967698,14.714285714285714
330,496,0,15827,5968194,15.030303030303031
160,195,0,15828,5968389,12.1875
120,176,0,15829,5968565,14.666666666666666
250,316,0,15830,5968881,12.64
440,679,0,15831,5969560,15.431818181818182
230,375,0,15832,5969935,16.304347826086957
370,613,0,15833,5970548,16.56756756756757
390,563,0,15834,5971111,14.435897435897436
200,217,0,15835,5971328,10.85
400,670,0,15836,5971998,16.75
500,725,0,15837,5972723,14.5
230,327,0,15838,5973050,14.217391304347826
210,354,0,15839,5973404,16.857142857142858
180,237,0,15840,5973641,13.166666666666666
230,339,0,15841,5973980,14.73913043478261
150,220,0,15842,5974200,14.666666666666666
150,213,0,15843,5974413,14.2
220,329,0,15844,5974742,14.954545454545455
320,475,0,15845,5975217,14.84375
210,260,0,15846,5975477,12.380952380952381
140,246,0,15847,5975723,17.571428571428573
240,284,0,15848,5976007,11.833333333333334
220,306,0,15849,5976313,13.909090909090908
150,319,0,15850,5976632,21.266666666666666
180,265,0,15851,5976897,14.722222222222221
320,513,0,15852,5977410,16.03125
200,303,0,15853,5977713,15.15
450,641,0,15854,5978354,14.244444444444444
260,361,0,15855,5978715,13.884615384615385
230,357,0,15856,5979072,15.521739130434783
420,651,0,15857,5979723,15.5
270,409,0,15858,5980132,15.148148148148149
170,227,0,15859,5980359,13.352941176470589
260,365,0,15860,5980724,14.038461538461538
390,569,0,15861,5981293,14.58974358974359
400,645,0,15862,5981938,16.125
260,443,0,15863,5982381,17.03846153846154
200,268,0,15864,5982649,13.4
380,544,0,15865,5983193,14.31578947368421
230,373,0,15866,5983566,16.217391304347824
290,499,0,15867,5984065,17.20689655172414
200,258,0,15868,5984323,12.9
270,411,0,15869,5984734,15.222222222222221
300,436,0,15870,5985170,14.533333333333333
370,612,0,15871,5985782,16.54054054054054
480,678,0,15872,5986460,14.125
170,239,0,15873,5986699,14.058823529411764
170,234,0,15874,5986933,13.764705882352942
370,526,0,15875,5987459,14.216216216216216
90,146,0,15876,5987605,16.22222222222222
570,1029,0,15877,5988634,18.05263157894737
370,499,0,15878,5989133,13.486486486486486
270,461,0,15879,5989594,17.074074074074073
210,304,0,15880,5989898,14.476190476190476
180,217,0,15881,5990115,12.055555555555555
140,186,0,15882,5990301,13.285714285714286
120,140,0,15883,5990441,11.666666666666666
290,406,0,15884,5990847,14.0
340,508,0,15885,5991355,14.941176470588236
260,338,0,15886,5991693,13.0
150,241,0,15887,5991934,16.066666666666666
210,332,0,15888,5992266,15.80952380952381
310,439,0,15889,5992705,14.161290322580646
400,794,0,15890,5993499,19.85
450,768,0,15891,5994267,17.066666666666666
280,313,0,15892,5994580,11.178571428571429
230,351,0,15893,5994931,15.26086956521739
270,370,0,15894,5995301,13.703703703703704
290,379,0,15895,5995680,13.068965517241379
500,758,0,15896,5996438,15.16
260,387,0,15897,5996825,14.884615384615385
260,473,0,15898,5997298,18.192307692307693
180,305,0,15899,5997603,16.944444444444443
200,286,0,15900,5997889,14.3
220,303,0,15901,5998192,13.772727272727273
210,312,0,15902,5998504,14.857142857142858
310,428,0,15903,5998932,13.806451612903226
370,521,0,15904,5999453,14.08108108108108
190,253,0,15905,5999706,13.31578947368421
340,479,0,15906,6000185,14.088235294117647
420,756,0,15907,6000941,18.0
330,540,0,15908,6001481,16.363636363636363
80,88,0,15909,6001569,11.0
280,408,0,15910,6001977,14.571428571428571
150,186,0,15911,6002163,12.4
420,781,0,15912,6002944,18.595238095238095
370,573,0,15913,6003517,15.486486486486486
350,512,0,15914,6004029,14.628571428571428
140,190,0,15915,6004219,13.571428571428571
400,592,0,15916,6004811,14.8
180,268,0,15917,6005079,14.88888888888889
370,575,0,15918,6005654,15.54054054054054
120,223,0,15919,6005877,18.583333333333332
190,284,0,15920,6006161,14.947368421052632
320,443,0,15921,6006604,13.84375
110,139,0,15922,6006743,12.636363636363637
260,371,0,15923,6007114,14.26923076923077
230,353,0,15924,6007467,15.347826086956522
190,282,0,15925,6007749,14.842105263157896
360,634,0,15926,6008383,17.61111111111111
330,409,0,15927,6008792,12.393939393939394
350,477,0,15928,6009269,13.628571428571428
90,112,0,15929,6009381,12.444444444444445
300,434,0,15930,6009815,14.466666666666667
210,350,0,15931,6010165,16.666666666666668
280,453,0,15932,6010618,16.178571428571427
280,388,0,15933,6011006,13.857142857142858
240,333,0,15934,6011339,13.875
300,511,0,15935,6011850,17.033333333333335
160,259,0,15936,6012109,16.1875
300,423,0,15937,6012532,14.1
330,567,0,15938,6013099,17.181818181818183
270,383,0,15939,6013482,14.185185185185185
210,281,0,15940,6013763,13.380952380952381
200,250,0,15941,6014013,12.5
250,362,0,15942,6014375,14.48
200,283,0,15943,6014658,14.15
330,458,0,15944,6015116,13.878787878787879
580,856,0,15945,6015972,14.758620689655173
550,1019,0,15946,6016991,18.527272727272727
190,256,0,15947,6017247,13.473684210526315
440,722,0,15948,6017969,16.40909090909091
90,129,0,15949,6018098,14.333333333333334
70,120,0,15950,6018218,17.142857142857142
150,174,0,15951,6018392,11.6
360,505,0,15952,6018897,14.027777777777779
140,203,0,15953,6019100,14.5
300,421,0,15954,6019521,14.033333333333333
260,376,0,15955,6019897,14.461538461538462
450,599,0,15956,6020496,13.311111111111112
180,186,0,15957,6020682,10.333333333333334
260,381,0,15958,6021063,14.653846153846153
390,557,0,15959,6021620,14.282051282051283
440,655,0,15960,6022275,14.886363636363637
400,610,0,15961,6022885,15.25
270,398,0,15962,6023283,14.74074074074074
280,487,0,15963,6023770,17.392857142857142
290,531,0,15964,6024301,18.310344827586206
230,321,0,15965,6024622,13.956521739130435
220,334,0,15966,6024956,15.181818181818182
270,398,0,15967,6025354,14.74074074074074
560,878,0,15968,6026232,15.678571428571429
220,240,0,15969,6026472,10.909090909090908
280,338,0,15970,6026810,12.071428571428571
360,588,0,15971,6027398,16.333333333333332
250,360,0,15972,6027758,14.4
110,159,0,15973,6027917,14.454545454545455
400,585,0,15974,6028502,14.625
260,355,0,15975,6028857,13.653846153846153
200,301,0,15976,6029158,15.05
350,501,0,15977,6029659,14.314285714285715
300,512,0,15978,6030171,17.066666666666666
280,456,0,15979,6030627,16.285714285714285
170,277,0,15980,6030904,16.294117647058822
260,423,0,15981,6031327,16.26923076923077
300,481,0,15982,6031808,16.033333333333335
120,165,0,15983,6031973,13.75
130,155,0,15984,6032128,11.923076923076923
430,751,0,15985,6032879,17.46511627906977
170,234,0,15986,6033113,13.764705882352942
270,359,0,15987,6033472,13.296296296296296
280,401,0,15988,6033873,14.321428571428571
360,534,0,15989,6034407,14.833333333333334
340,514,0,15990,6034921,15.117647058823529
200,307,0,15991,6035228,15.35
370,627,0,15992,6035855,16.945945945945947
320,433,0,15993,6036288,13.53125
160,227,0,15994,6036515,14.1875
290,411,0,15995,6036926,14.172413793103448
230,311,0,15996,6037237,13.521739130434783
210,341,0,15997,6037578,16.238095238095237
240,261,0,15998,6037839,10.875
270,357,0,15999,6038196,13.222222222222221
260,447,0,16000,6038643,17.192307692307693
330,434,0,16001,6039077,13.151515151515152
340,467,0,16002,6039544,13.735294117647058
160,216,0,16003,6039760,13.5
400,639,0,16004,6040399,15.975
220,361,0,16005,6040760,16.40909090909091
180,267,0,16006,6041027,14.833333333333334
470,804,0,16007,6041831,17.106382978723403
210,272,0,16008,6042103,12.952380952380953
240,322,0,16009,6042425,13.416666666666666
310,450,0,16010,6042875,14.516129032258064
310,477,0,16011,6043352,15.387096774193548
220,296,0,16012,6043648,13.454545454545455
310,405,0,16013,6044053,13.064516129032258
330,419,0,16014,6044472,12.696969696969697
280,406,0,16015,6044878,14.5
190,256,0,16016,6045134,13.473684210526315
340,540,0,16017,6045674,15.882352941176471
200,307,0,16018,6045981,15.35
250,327,0,16019,6046308,13.08
200,238,0,16020,6046546,11.9
200,241,0,16021,6046787,12.05
200,269,0,16022,6047056,13.45
370,578,0,16023,6047634,15.621621621621621
180,250,0,16024,6047884,13.88888888888889
210,312,0,16025,6048196,14.857142857142858
340,538,0,16026,6048734,15.823529411764707
400,634,0,16027,6049368,15.85
200,227,0,16028,6049595,11.35
210,291,0,16029,6049886,13.857142857142858
240,417,0,16030,6050303,17.375
420,634,0,16031,6050937,15.095238095238095
470,792,0,16032,6051729,16.851063829787233
240,368,0,16033,6052097,15.333333333333334
330,531,0,16034,6052628,16.09090909090909
110,96,0,16035,6052724,8.727272727272727
270,439,0,16036,6053163,16.25925925925926
300,406,0,16037,6053569,13.533333333333333
290,385,0,16038,6053954,13.275862068965518
230,309,0,16039,6054263,13.434782608695652
280,369,0,16040,6054632,13.178571428571429
330,476,0,16041,6055108,14.424242424242424
270,338,0,16042,6055446,12.518518518518519
400,603,0,16043,6056049,15.075
360,518,0,16044,6056567,14.38888888888889
120,186,0,16045,6056753,15.5
360,542,0,16046,6057295,15.055555555555555
380,642,0,16047,6057937,16.894736842105264
160,210,0,16048,6058147,13.125
150,240,0,16049,6058387,16.0
330,470,0,16050,6058857,14.242424242424242
270,355,0,16051,6059212,13.148148148148149
430,727,0,16052,6059939,16.906976744186046
280,400,0,16053,6060339,14.285714285714286
190,253,0,16054,6060592,13.31578947368421
270,432,0,16055,6061024,16.0
210,292,0,16056,6061316,13.904761904761905
220,374,0,16057,6061690,17.0
270,378,0,16058,6062068,14.0
260,356,0,16059,6062424,13.692307692307692
240,323,0,16060,6062747,13.458333333333334
460,696,0,16061,6063443,15.130434782608695
310,466,0,16062,6063909,15.03225806451613
330,481,0,16063,6064390,14.575757575757576
260,391,0,16064,6064781,15.038461538461538
260,411,0,16065,6065192,15.807692307692308
400,591,0,16066,6065783,14.775
230,328,0,16067,6066111,14.26086956521739
250,383,0,16068,6066494,15.32
410,712,0,16069,6067206,17.365853658536587
270,394,0,16070,6067600,14.592592592592593
120,181,0,16071,6067781,15.083333333333334
190,267,0,16072,6068048,14.052631578947368
190,249,0,16073,6068297,13.105263157894736
160,181,0,16074,6068478,11.3125
220,337,0,16075,6068815,15.318181818181818
170,217,0,16076,6069032,12.764705882352942
320,557,0,16077,6069589,17.40625
230,313,0,16078,6069902,13.608695652173912
380,634,0,16079,6070536,16.68421052631579
340,470,0,16080,6071006,13.823529411764707
320,484,0,16081,6071490,15.125
270,356,0,16082,6071846,13.185185185185185
170,272,0,16083,6072118,16.0
230,371,0,16084,6072489,16.130434782608695
280,421,0,16085,6072910,15.035714285714286
320,489,0,16086,6073399,15.28125
260,293,0,16087,6073692,11.26923076923077
170,179,0,16088,6073871,10.529411764705882
380,595,0,16089,6074466,15.657894736842104
330,571,0,16090,6075037,17.303030303030305
200,277,0,16091,6075314,13.85
430,641,0,16092,6075955,14.906976744186046
320,542,0,16093,6076497,16.9375
210,315,0,16094,6076812,15.0
280,493,0,16095,6077305,17.607142857142858
280,429,0,16096,6077734,15.321428571428571
210,307,0,16097,6078041,14.619047619047619
380,585,0,16098,6078626,15.394736842105264
270,432,0,16099,6079058,16.0
170,210,0,16100,6079268,12.352941176470589
280,436,0,16101,6079704,15.571428571428571
490,728,0,16102,6080432,14.857142857142858
210,261,0,16103,6080693,12.428571428571429
240,317,0,16104,6081010,13.208333333333334
280,457,0,16105,6081467,16.321428571428573
260,369,0,16106,6081836,14.192307692307692
260,343,0,16107,6082179,13.192307692307692
230,349,0,16108,6082528,15.173913043478262
280,464,0,16109,6082992,16.571428571428573
250,422,0,16110,6083414,16.88
200,321,0,16111,6083735,16.05
380,563,0,16112,6084298,14.81578947368421
200,334,0,16113,6084632,16.7
230,328,0,16114,6084960,14.26086956521739
290,446,0,16115,6085406,15.379310344827585
120,172,0,16116,6085578,14.333333333333334
160,221,0,16117,6085799,13.8125
260,422,0,16118,6086221,16.23076923076923
130,183,0,16119,6086404,14.076923076923077
240,291,0,16120,6086695,12.125
170,221,0,16121,6086916,13.0
350,518,0,16122,6087434,14.8
270,436,0,16123,6087870,16.14814814814815
280,362,0,16124,6088232,12.928571428571429
210,235,0,16125,6088467,11.19047619047619
350,580,0,16126,6089047,16.571428571428573
260,415,0,16127,6089462,15.961538461538462
180,256,0,16128,6089718,14.222222222222221
230,317,0,16129,6090035,13.782608695652174
140,178,0,16130,6090213,12.714285714285714
210,293,0,16131,6090506,13.952380952380953
360,507,0,16132,6091013,14.083333333333334
380,626,0,16133,6091639,16.473684210526315
180,250,0,16134,6091889,13.88888888888889
310,479,0,16135,6092368,15.451612903225806
260,360,0,16136,6092728,13.846153846153847
230,365,0,16137,6093093,15.869565217391305
120,182,0,16138,6093275,15.166666666666666
200,313,0,16139,6093588,15.65
250,356,0,16140,6093944,14.24
190,255,0,16141,6094199,13.421052631578947
290,385,0,16142,6094584,13.275862068965518
360,580,0,16143,6095164,16.11111111111111
340,528,0,16144,6095692,15.529411764705882
160,201,0,16145,6095893,12.5625
230,380,0,16146,6096273,16.52173913043478
130,188,0,16147,6096461,14.461538461538462
430,759,0,16148,6097220,17.651162790697676
140,172,0,16149,6097392,12.285714285714286
220,272,0,16150,6097664,12.363636363636363
180,224,0,16151,6097888,12.444444444444445
340,532,0,16152,6098420,15.647058823529411
300,388,0,16153,6098808,12.933333333333334
260,365,0,16154,6099173,14.038461538461538
90,121,0,16155,6099294,13.444444444444445
190,229,0,16156,6099523,12.052631578947368
140,200,0,16157,6099723,14.285714285714286
320,479,0,16158,6100202,14.96875
260,312,0,16159,6100514,12.0
290,415,0,16160,6100929,14.310344827586206
240,343,0,16161,6101272,14.291666666666666
240,366,0,16162,6101638,15.25
280,365,0,16163,6102003,13.035714285714286
160,229,0,16164,6102232,14.3125
270,382,0,16165,6102614,14.148148148148149
290,442,0,16166,6103056,15.241379310344827
190,240,0,16167,6103296,12.631578947368421
220,281,0,16168,6103577,12.772727272727273
360,574,0,16169,6104151,15.944444444444445
140,155,0,16170,6104306,11.071428571428571
160,259,0,16171,6104565,16.1875
260,371,0,16172,6104936,14.26923076923077
220,298,0,16173,6105234,13.545454545454545
270,417,0,16174,6105651,15.444444444444445
210,273,0,16175,6105924,13.0
240,311,0,16176,6106235,12.958333333333334
290,503,0,16177,6106738,17.344827586206897
350,452,0,16178,6107190,12.914285714285715
110,185,0,16179,6107375,16.818181818181817
230,308,0,16180,6107683,13.391304347826088
370,471,0,16181,6108154,12.72972972972973
200,298,0,16182,6108452,14.9
260,362,0,16183,6108814,13.923076923076923
190,253,0,16184,6109067,13.31578947368421
190,298,0,16185,6109365,15.68421052631579
200,317,0,16186,6109682,15.85
110,201,0,16187,6109883,18.272727272727273
310,419,0,16188,6110302,13.516129032258064
250,341,0,16189,6110643,13.64
400,658,0,16190,6111301,16.45
420,742,0,16191,6112043,17.666666666666668
200,300,0,16192,6112343,15.0
350,519,0,16193,6112862,14.82857142857143
140,178,0,16194,6113040,12.714285714285714
260,346,0,16195,6113386,13.307692307692308
160,254,0,16196,6113640,15.875
300,422,0,16197,6114062,14.066666666666666
90,114,0,16198,6114176,12.666666666666666
110,218,0,16199,6114394,19.818181818181817
140,187,0,16200,6114581,13.357142857142858
330,444,0,16201,6115025,13.454545454545455
290,561,0,16202,6115586,19.344827586206897
170,214,0,16203,6115800,12.588235294117647
290,319,0,16204,6116119,11.0
150,248,0,16205,6116367,16.533333333333335
330,441,0,16206,6116808,13.363636363636363
300,438,0,16207,6117246,14.6
140,206,0,16208,6117452,14.714285714285714
180,245,0,16209,6117697,13.61111111111111
230,337,0,16210,6118034,14.652173913043478
170,219,0,16211,6118253,12.882352941176471
280,370,0,16212,6118623,13.214285714285714
210,268,0,16213,6118891,12.761904761904763
130,226,0,16214,6119117,17.384615384615383
230,345,0,16215,6119462,15.0
340,502,0,16216,6119964,14.764705882352942
270,382,0,16217,6120346,14.148148148148149
80,134,0,16218,6120480,16.75
280,425,0,16219,6120905,15.178571428571429
320,539,0,16220,6121444,16.84375
130,207,0,16221,6121651,15.923076923076923
250,366,0,16222,6122017,14.64
140,200,0,16223,6122217,14.285714285714286
280,410,0,16224,6122627,14.642857142857142
200,293,0,16225,6122920,14.65
220,326,0,16226,6123246,14.818181818181818
320,486,0,16227,6123732,15.1875
290,414,0,16228,6124146,14.275862068965518
150,189,0,16229,6124335,12.6
260,373,0,16230,6124708,14.346153846153847
180,231,0,16231,6124939,12.833333333333334
140,208,0,16232,6125147,14.857142857142858
220,252,0,16233,6125399,11.454545454545455
420,726,0,16234,6126125,17.285714285714285
200,290,0,16235,6126415,14.5
310,446,0,16236,6126861,14.387096774193548
420,672,0,16237,6127533,16.0
310,502,0,16238,6128035,16.193548387096776
160,220,0,16239,6128255,13.75
420,623,0,16240,6128878,14.833333333333334
230,396,0,16241,6129274,17.217391304347824
180,258,0,16242,6129532,14.333333333333334
370,606,0,16243,6130138,16.37837837837838
170,228,0,16244,6130366,13.411764705882353
280,384,0,16245,6130750,13.714285714285714
280,435,0,16246,6131185,15.535714285714286
230,356,0,16247,6131541,15.478260869565217
360,551,0,16248,6132092,15.305555555555555
330,500,0,16249,6132592,15.151515151515152
310,580,0,16250,6133172,18.70967741935484
350,495,0,16251,6133667,14.142857142857142
270,356,0,16252,6134023,13.185185185185185
180,256,0,16253,6134279,14.222222222222221
220,291,0,16254,6134570,13.227272727272727
80,83,0,16255,6134653,10.375
240,323,0,16256,6134976,13.458333333333334
120,193,0,16257,6135169,16.083333333333332
170,253,0,16258,6135422,14.882352941176471
230,348,0,16259,6135770,15.130434782608695
350,557,0,16260,6136327,15.914285714285715
190,293,0,16261,6136620,15.421052631578947
370,539,0,16262,6137159,14.567567567567568
220,289,0,16263,6137448,13.136363636363637
210,326,0,16264,6137774,15.523809523809524
180,224,0,16265,6137998,12.444444444444445
450,673,0,16266,6138671,14.955555555555556
330,443,0,16267,6139114,13.424242424242424
190,287,0,16268,6139401,15.105263157894736
220,317,0,16269,6139718,14.409090909090908
200,318,0,16270,6140036,15.9
250,338,0,16271,6140374,13.52
320,467,0,16272,6140841,14.59375
70,99,0,16273,6140940,14.142857142857142
320,438,0,16274,6141378,13.6875
310,475,0,16275,6141853,15.32258064516129
180,253,0,16276,6142106,14.055555555555555
270,425,0,16277,6142531,15.74074074074074
330,495,0,16278,6143026,15.0
240,318,0,16279,6143344,13.25
300,480,0,16280,6143824,16.0
120,151,0,16281,6143975,12.583333333333334
240,392,0,16282,6144367,16.333333333333332
150,210,0,16283,6144577,14.0
150,208,0,16284,6144785,13.866666666666667
230,333,0,16285,6145118,14.478260869565217
190,278,0,16286,6145396,14.631578947368421
350,542,0,16287,6145938,15.485714285714286
150,172,0,16288,6146110,11.466666666666667
240,322,0,16289,6146432,13.416666666666666
370,537,0,16290,6146969,14.513513513513514
210,242,0,16291,6147211,11.523809523809524
520,891,0,16292,6148102,17.134615384615383
460,768,0,16293,6148870,16.695652173913043
200,256,0,16294,6149126,12.8
110,118,0,16295,6149244,10.727272727272727
230,322,0,16296,6149566,14.0
160,229,0,16297,6149795,14.3125
230,371,0,16298,6150166,16.130434782608695
250,353,0,16299,6150519,14.12
130,195,0,16300,6150714,15.0
170,220,0,16301,6150934,12.941176470588236
340,459,0,16302,6151393,13.5
210,347,0,16303,6151740,16.523809523809526
360,521,0,16304,6152261,14.472222222222221
310,415,0,16305,6152676,13.387096774193548
170,250,0,16306,6152926,14.705882352941176
250,368,0,16307,6153294,14.72
390,575,0,16308,6153869,14.743589743589743
370,598,0,16309,6154467,16.16216216216216
250,386,0,16310,6154853,15.44
290,467,0,16311,6155320,16.103448275862068
190,278,0,16312,6155598,14.631578947368421
390,579,0,16313,6156177,14.846153846153847
220,328,0,16314,6156505,14.909090909090908
180,240,0,16315,6156745,13.333333333333334
140,161,0,16316,6156906,11.5
230,363,0,16317,6157269,15.782608695652174
210,274,0,16318,6157543,13.047619047619047
100,163,0,16319,6157706,16.3
160,222,0,16320,6157928,13.875
300,471,0,16321,6158399,15.7
60,65,0,16322,6158464,10.833333333333334
270,351,0,16323,6158815,13.0
220,354,0,16324,6159169,16.09090909090909
260,436,0,16325,6159605,16.76923076923077
350,448,0,16326,6160053,12.8
310,479,0,16327,6160532,15.451612903225806
170,212,0,16328,6160744,12.470588235294118
400,636,0,16329,6161380,15.9
470,759,0,16330,6162139,16.148936170212767
310,471,0,16331,6162610,15.193548387096774
300,471,0,16332,6163081,15.7
120,124,0,16333,6163205,10.333333333333334
200,325,0,16334,6163530,16.25
240,369,0,16335,6163899,15.375
110,183,0,16336,6164082,16.636363636363637
260,345,0,16337,6164427,13.26923076923077
400,612,0,16338,6165039,15.3
310,474,0,16339,6165513,15.290322580645162
390,662,0,16340,6166175,16.974358974358974
100,136,0,16341,6166311,13.6
110,191,0,16342,6166502,17.363636363636363
190,281,0,16343,6166783,14.789473684210526
130,264,0,16344,6167047,20.307692307692307
240,369,0,16345,6167416,15.375
340,519,0,16346,6167935,15.264705882352942
120,205,0,16347,6168140,17.083333333333332
110,136,0,16348,6168276,12.363636363636363
200,281,0,16349,6168557,14.05
580,1056,0,16350,6169613,18.20689655172414
250,363,0,16351,6169976,14.52
170,218,0,16352,6170194,12.823529411764707
340,587,0,16353,6170781,17.264705882352942
170,250,0,16354,6171031,14.705882352941176
150,186,0,16355,6171217,12.4
190,294,0,16356,6171511,15.473684210526315
190,321,0,16357,6171832,16.894736842105264
180,281,0,16358,6172113,15.61111111111111
110,163,0,16359,6172276,14.818181818181818
210,354,0,16360,6172630,16.857142857142858
140,199,0,16361,6172829,14.214285714285714
370,579,0,16362,6173408,15.64864864864865
320,464,0,16363,6173872,14.5
90,129,0,16364,6174001,14.333333333333334
220,238,0,16365,6174239,10.818181818181818
230,302,0,16366,6174541,13.130434782608695
270,391,0,16367,6174932,14.481481481481481
240,351,0,16368,6175283,14.625
290,475,0,16369,6175758,16.379310344827587
300,548,0,16370,6176306,18.266666666666666
410,641,0,16371,6176947,15.634146341463415
310,406,0,16372,6177353,13.096774193548388
250,362,0,16373,6177715,14.48
260,348,0,16374,6178063,13.384615384615385
140,218,0,16375,6178281,15.571428571428571
220,276,0,16376,6178557,12.545454545454545
230,373,0,16377,6178930,16.217391304347824
140,190,0,16378,6179120,13.571428571428571
160,228,0,16379,6179348,14.25
250,409,0,16380,6179757,16.36
230,348,0,16381,6180105,15.130434782608695
200,287,0,16382,6180392,14.35
300,437,0,16383,6180829,14.566666666666666
60,81,0,16384,6180910,13.5
140,188,0,16385,6181098,13.428571428571429
230,364,0,16386,6181462,15.826086956521738
190,229,0,16387,6181691,12.052631578947368
340,484,0,16388,6182175,14.235294117647058
210,282,0,16389,6182457,13.428571428571429
170,232,0,16390,6182689,13.647058823529411
250,386,0,16391,6183075,15.44
330,468,0,16392,6183543,14.181818181818182
290,351,0,16393,6183894,12.10344827586207
250,369,0,16394,6184263,14.76
370,635,0,16395,6184898,17.16216216216216
150,200,0,16396,6185098,13.333333333333334
340,620,0,16397,6185718,18.235294117647058
430,668,0,16398,6186386,15.534883720930232
190,287,0,16399,6186673,15.105263157894736
290,465,0,16400,6187138,16.03448275862069
250,334,0,16401,6187472,13.36
220,353,0,16402,6187825,16.045454545454547
200,328,0,16403,6188153,16.4
190,309,0,16404,6188462,16.263157894736842
350,507,0,16405,6188969,14.485714285714286
210,304,0,16406,6189273,14.476190476190476
160,237,0,16407,6189510,14.8125
110,166,0,16408,6189676,15.090909090909092
540,759,0,16409,6190435,14.055555555555555
250,344,0,16410,6190779,13.76
400,646,0,16411,6191425,16.15
410,546,0,16412,6191971,13.317073170731707
280,377,0,16413,6192348,13.464285714285714
360,530,0,16414,6192878,14.722222222222221
280,432,0,16415,6193310,15.428571428571429
240,360,0,16416,6193670,15.0
220,307,0,16417,6193977,13.954545454545455
190,261,0,16418,6194238,13.736842105263158
110,127,0,16419,6194365,11.545454545454545
190,291,0,16420,6194656,15.31578947368421
300,564,0,16421,6195220,18.8
190,236,0,16422,6195456,12.421052631578947
380,581,0,16423,6196037,15.289473684210526
100,174,0,16424,6196211,17.4
250,371,0,16425,6196582,14.84
210,288,0,16426,6196870,13.714285714285714
220,348,0,16427,6197218,15.818181818181818
300,391,0,16428,6197609,13.033333333333333
260,343,0,16429,6197952,13.192307692307692
240,323,0,16430,6198275,13.458333333333334
380,646,0,16431,6198921,17.0
250,396,0,16432,6199317,15.84
290,380,0,16433,6199697,13.10344827586207
90,139,0,16434,6199836,15.444444444444445
240,401,0,16435,6200237,16.708333333333332
360,412,0,16436,6200649,11.444444444444445
190,248,0,16437,6200897,13.052631578947368
320,450,0,16438,6201347,14.0625
140,171,0,16439,6201518,12.214285714285714
180,228,0,16440,6201746,12.666666666666666
340,608,0,16441,6202354,17.88235294117647
420,706,0,16442,6203060,16.80952380952381
240,384,0,16443,6203444,16.0
200,258,0,16444,6203702,12.9
250,394,0,16445,6204096,15.76
350,541,0,16446,6204637,15.457142857142857
240,342,0,16447,6204979,14.25
290,441,0,16448,6205420,15.206896551724139
240,295,0,16449,6205715,12.291666666666666
290,368,0,16450,6206083,12.689655172413794
160,249,0,16451,6206332,15.5625
370,623,0,16452,6206955,16.83783783783784
170,204,0,16453,6207159,12.0
280,397,0,16454,6207556,14.178571428571429
340,527,0,16455,6208083,15.5
320,548,0,16456,6208631,17.125
340,509,0,16457,6209140,14.970588235294118
190,289,0,16458,6209429,15.210526315789474
170,188,0,16459,6209617,11.058823529411764
390,676,0,16460,6210293,17.333333333333332
280,416,0,16461,6210709,14.857142857142858
210,319,0,16462,6211028,15.19047619047619
230,279,0,16463,6211307,12.130434782608695
140,237,0,16464,6211544,16.928571428571427
210,288,0,16465,6211832,13.714285714285714
100,119,0,16466,6211951,11.9
310,453,0,16467,6212404,14.612903225806452
450,710,0,16468,6213114,15.777777777777779
180,249,0,16469,6213363,13.833333333333334
380,607,0,16470,6213970,15.973684210526315
250,375,0,16471,6214345,15.0
260,385,0,16472,6214730,14.807692307692308
280,329,0,16473,6215059,11.75
120,120,0,16474,6215179,10.0
370,604,0,16475,6215783,16.324324324324323
220,342,0,16476,6216125,15.545454545454545
140,218,0,16477,6216343,15.571428571428571
110,141,0,16478,6216484,12.818181818181818
70,123,0,16479,6216607,17.571428571428573
190,249,0,16480,6216856,13.105263157894736
170,186,0,16481,6217042,10.941176470588236
160,198,0,16482,6217240,12.375
250,328,0,16483,6217568,13.12
380,611,0,16484,6218179,16.07894736842105
510,892,0,16485,6219071,17.49019607843137
290,351,0,16486,6219422,12.10344827586207
180,261,0,16487,6219683,14.5
150,208,0,16488,6219891,13.866666666666667
130,212,0,16489,6220103,16.307692307692307
90,90,0,16490,6220193,10.0
280,371,0,16491,6220564,13.25
300,424,0,16492,6220988,14.133333333333333
280,427,0,16493,6221415,15.25
410,648,0,16494,6222063,15.804878048780488
280,414,0,16495,6222477,14.785714285714286
340,497,0,16496,6222974,14.617647058823529
360,619,0,16497,6223593,17.194444444444443
400,675,0,16498,6224268,16.875
540,933,0,16499,6225201,17.27777777777778
240,390,0,16500,6225591,16.25
170,246,0,16501,6225837,14.470588235294118
160,288,0,16502,6226125,18.0
280,450,0,16503,6226575,16.071428571428573
290,415,0,16504,6226990,14.310344827586206
290,462,0,16505,6227452,15.931034482758621
350,487,0,16506,6227939,13.914285714285715
280,385,0,16507,6228324,13.75
240,319,0,16508,6228643,13.291666666666666
130,178,0,16509,6228821,13.692307692307692
240,319,0,16510,6229140,13.291666666666666
290,449,0,16511,6229589,15.482758620689655
140,167,0,16512,6229756,11.928571428571429
290,446,0,16513,6230202,15.379310344827585
160,233,0,16514,6230435,14.5625
250,400,0,16515,6230835,16.0
300,450,0,16516,6231285,15.0
140,194,0,16517,6231479,13.857142857142858
420,604,0,16518,6232083,14.380952380952381
360,543,0,16519,6232626,15.083333333333334
100,205,0,16520,6232831,20.5
250,382,0,16521,6233213,15.28
420,691,0,16522,6233904,16.452380952380953
280,389,0,16523,6234293,13.892857142857142
320,473,0,16524,6234766,14.78125
340,512,0,16525,6235278,15.058823529411764
330,538,0,16526,6235816,16.303030303030305
180,306,0,16527,6236122,17.0
440,680,0,16528,6236802,15.454545454545455
390,621,0,16529,6237423,15.923076923076923
180,231,0,16530,6237654,12.833333333333334
230,327,0,16531,6237981,14.217391304347826
320,505,0,16532,6238486,15.78125
150,178,0,16533,6238664,11.866666666666667
130,190,0,16534,6238854,14.615384615384615
360,516,0,16535,6239370,14.333333333333334
300,436,0,16536,6239806,14.533333333333333
190,326,0,16537,6240132,17.157894736842106
220,372,0,16538,6240504,16.90909090909091
280,455,0,16539,6240959,16.25
170,211,0,16540,6241170,12.411764705882353
350,568,0,16541,6241738,16.228571428571428
180,273,0,16542,6242011,15.166666666666666
230,288,0,16543,6242299,12.521739130434783
240,356,0,16544,6242655,14.833333333333334
200,272,0,16545,6242927,13.6
380,598,0,16546,6243525,15.736842105263158
180,254,0,16547,6243779,14.11111111111111
400,589,0,16548,6244368,14.725
340,440,0,16549,6244808,12.941176470588236
230,312,0,16550,6245120,13.565217391304348
310,482,0,16551,6245602,15.548387096774194
280,389,0,16552,6245991,13.892857142857142
420,664,0,16553,6246655,15.80952380952381
450,636,0,16554,6247291,14.133333333333333
310,393,0,16555,6247684,12.67741935483871
330,527,0,16556,6248211,15.969696969696969
170,267,0,16557,6248478,15.705882352941176
220,353,0,16558,6248831,16.045454545454547
90,106,0,16559,6248937,11.777777777777779
370,524,0,16560,6249461,14.162162162162161
130,190,0,16561,6249651,14.615384615384615
250,357,0,16562,6250008,14.28
130,142,0,16563,6250150,10.923076923076923
320,484,0,16564,6250634,15.125
60,62,0,16565,6250696,10.333333333333334
360,613,0,16566,6251309,17.02777777777778
170,265,0,16567,6251574,15.588235294117647
340,545,0,16568,6252119,16.029411764705884
300,456,0,16569,6252575,15.2
140,172,0,16570,6252747,12.285714285714286
160,207,0,16571,6252954,12.9375
270,368,0,16572,6253322,13.62962962962963
120,179,0,16573,6253501,14.916666666666666
170,223,0,16574,6253724,13.117647058823529
350,521,0,16575,6254245,14.885714285714286
140,191,0,16576,6254436,13.642857142857142
270,347,0,16577,6254783,12.851851851851851
240,310,0,16578,6255093,12.916666666666666
370,681,0,16579,6255774,18.405405405405407
160,179,0,16580,6255953,11.1875
250,324,0,16581,6256277,12.96
150,248,0,16582,6256525,16.533333333333335
230,322,0,16583,6256847,14.0
270,324,0,16584,6257171,12.0
190,312,0,16585,6257483,16.42105263157895
250,408,0,16586,6257891,16.32
310,491,0,16587,6258382,15.838709677419354
210,285,0,16588,6258667,13.571428571428571
290,425,0,16589,6259092,14.655172413793103
190,230,0,16590,6259322,12.105263157894736
160,239,0,16591,6259561,14.9375
230,330,0,16592,6259891,14.347826086956522
210,301,0,16593,6260192,14.333333333333334
250,347,0,16594,6260539,13.88
250,386,0,16595,6260925,15.44
100,138,0,16596,6261063,13.8
340,498,0,16597,6261561,14.647058823529411
360,501,0,16598,6262062,13.916666666666666
250,330,0,16599,6262392,13.2
320,526,0,16600,6262918,16.4375
270,472,0,16601,6263390,17.48148148148148
150,190,0,16602,6263580,12.666666666666666
250,375,0,16603,6263955,15.0
170,224,0,16604,6264179,13.176470588235293
440,679,0,16605,6264858,15.431818181818182
190,251,0,16606,6265109,13.210526315789474
140,181,0,16607,6265290,12.928571428571429
210,256,0,16608,6265546,12.19047619047619
280,404,0,16609,6265950,14.428571428571429
250,387,0,16610,6266337,15.48
240,394,0,16611,6266731,16.416666666666668
280,393,0,16612,6267124,14.035714285714286
310,497,0,16613,6267621,16.032258064516128
110,145,0,16614,6267766,13.181818181818182
310,473,0,16615,6268239,15.258064516129032
200,312,0,16616,6268551,15.6
220,357,0,16617,6268908,16.227272727272727
290,422,0,16618,6269330,14.551724137931034
190,282,0,16619,6269612,14.842105263157896
240,350,0,16620,6269962,14.583333333333334
280,489,0,16621,6270451,17.464285714285715
80,60,0,16622,6270511,7.5
210,295,0,16623,6270806,14.047619047619047
260,377,0,16624,6271183,14.5
230,324,0,16625,6271507,14.08695652173913
120,134,0,16626,6271641,11.166666666666666
520,877,0,16627,6272518,16.865384615384617
370,593,0,16628,6273111,16.027027027027028
220,335,0,16629,6273446,15.227272727272727
220,279,0,16630,6273725,12.681818181818182
210,339,0,16631,6274064,16.142857142857142
140,182,0,16632,6274246,13.0
300,407,0,16633,6274653,13.566666666666666
160,213,0,16634,6274866,13.3125
310,397,0,16635,6275263,12.806451612903226
310,474,0,16636,6275737,15.290322580645162
210,319,0,16637,6276056,15.19047619047619
210,286,0,16638,6276342,13.619047619047619
370,470,0,16639,6276812,12.702702702702704
40,58,0,16640,6276870,14.5
170,244,0,16641,6277114,14.352941176470589
340,471,0,16642,6277585,13.852941176470589
240,327,0,16643,6277912,13.625
220,313,0,16644,6278225,14.227272727272727
230,384,0,16645,6278609,16.695652173913043
260,443,0,16646,6279052,17.03846153846154
320,497,0,16647,6279549,15.53125
360,559,0,16648,6280108,15.527777777777779
400,603,0,16649,6280711,15.075
490,817,0,16650,6281528,16.6734693877551
420,653,0,16651,6282181,15.547619047619047
120,181,0,16652,6282362,15.083333333333334
160,184,0,16653,6282546,11.5
190,208,0,16654,6282754,10.947368421052632
260,443,0,16655,6283197,17.03846153846154
220,403,0,16656,6283600,18.318181818181817
150,198,0,16657,6283798,13.2
170,254,0,16658,6284052,14.941176470588236
280,403,0,16659,6284455,14.392857142857142
190,301,0,16660,6284756,15.842105263157896
180,227,0,16661,6284983,12.61111111111111
130,139,0,16662,6285122,10.692307692307692
130,158,0,16663,6285280,12.153846153846153
160,246,0,16664,6285526,15.375
180,300,0,16665,6285826,16.666666666666668
260,337,0,16666,6286163,12.961538461538462
150,211,0,16667,6286374,14.066666666666666
290,507,0,16668,6286881,17.482758620689655
270,375,0,16669,6287256,13.88888888888889
260,393,0,16670,6287649,15.115384615384615
460,758,0,16671,6288407,16.47826086956522
120,168,0,16672,6288575,14.0
280,385,0,16673,6288960,13.75
290,400,0,16674,6289360,13.793103448275861
240,293,0,16675,6289653,12.208333333333334
230,320,0,16676,6289973,13.91304347826087
340,520,0,16677,6290493,15.294117647058824
240,342,0,16678,6290835,14.25
280,422,0,16679,6291257,15.071428571428571
360,599,0,16680,6291856,16.63888888888889
210,269,0,16681,6292125,12.80952380952381
400,549,0,16682,6292674,13.725
220,298,0,16683,6292972,13.545454545454545
540,910,0,16684,6293882,16.85185185185185
150,227,0,16685,6294109,15.133333333333333
200,324,0,16686,6294433,16.2
270,386,0,16687,6294819,14.296296296296296
340,533,0,16688,6295352,15.676470588235293
280,416,0,16689,6295768,14.857142857142858
140,146,0,16690,6295914,10.428571428571429
170,231,0,16691,6296145,13.588235294117647
440,705,0,16692,6296850,16.022727272727273
210,314,0,16693,6297164,14.952380952380953
260,353,0,16694,6297517,13.576923076923077
270,376,0,16695,6297893,13.925925925925926
200,253,0,16696,6298146,12.65
290,445,0,16697,6298591,15.344827586206897
190,198,0,16698,6298789,10.421052631578947
220,335,0,16699,6299124,15.227272727272727
360,544,0,16700,6299668,15.11111111111111
190,278,0,16701,6299946,14.631578947368421
290,417,0,16702,6300363,14.379310344827585
50,64,0,16703,6300427,12.8
230,346,0,16704,6300773,15.043478260869565
100,178,0,16705,6300951,17.8
350,545,0,16706,6301496,15.571428571428571
260,329,0,16707,6301825,12.653846153846153
270,397,0,16708,6302222,14.703703703703704
320,452,0,16709,6302674,14.125
190,246,0,16710,6302920,12.947368421052632
150,205,0,16711,6303125,13.666666666666666
430,662,0,16712,6303787,15.395348837209303
250,340,0,16713,6304127,13.6
260,357,0,16714,6304484,13.73076923076923
90,122,0,16715,6304606,13.555555555555555
350,541,0,16716,6305147,15.457142857142857
380,581,0,16717,6305728,15.289473684210526
200,284,0,16718,6306012,14.2
310,410,0,16719,6306422,13.225806451612904
250,385,0,16720,6306807,15.4
200,316,0,16721,6307123,15.8
150,227,0,16722,6307350,15.133333333333333
350,595,0,16723,6307945,17.0
260,395,0,16724,6308340,15.192307692307692
190,279,0,16725,6308619,14.68421052631579
210,370,0,16726,6308989,17.61904761904762
480,723,0,16727,6309712,15.0625
210,316,0,16728,6310028,15.047619047619047
310,443,0,16729,6310471,14.290322580645162
100,138,0,16730,6310609,13.8
260,322,0,16731,6310931,12.384615384615385
210,304,0,16732,6311235,14.476190476190476
300,445,0,16733,6311680,14.833333333333334
280,420,0,16734,6312100,15.0
240,366,0,16735,6312466,15.25
420,630,0,16736,6313096,15.0
340,516,0,16737,6313612,15.176470588235293
400,623,0,16738,6314235,15.575
270,479,0,16739,6314714,17.74074074074074
280,426,0,16740,6315140,15.214285714285714
240,301,0,16741,6315441,12.541666666666666
360,560,0,16742,6316001,15.555555555555555
190,238,0,16743,6316239,12.526315789473685
330,498,0,16744,6316737,15.090909090909092
310,473,0,16745,6317210,15.258064516129032
310,444,0,16746,6317654,14.32258064516129
200,286,0,16747,6317940,14.3
300,463,0,16748,6318403,15.433333333333334
250,356,0,16749,6318759,14.24
260,295,0,16750,6319054,11.346153846153847
140,204,0,16751,6319258,14.571428571428571
140,160,0,16752,6319418,11.428571428571429
270,469,0,16753,6319887,17.37037037037037
190,293,0,16754,6320180,15.421052631578947
180,222,0,16755,6320402,12.333333333333334
80,92,0,16756,6320494,11.5
240,351,0,16757,6320845,14.625
440,772,0,16758,6321617,17.545454545454547
360,508,0,16759,6322125,14.11111111111111
300,471,0,16760,6322596,15.7
160,240,0,16761,6322836,15.0
200,303,0,16762,6323139,15.15
260,419,0,16763,6323558,16.115384615384617
290,429,0,16764,6323987,14.793103448275861
220,341,0,16765,6324328,15.5
110,128,0,16766,6324456,11.636363636363637
200,260,0,16767,6324716,13.0
370,605,0,16768,6325321,16.35135135135135
290,336,0,16769,6325657,11.586206896551724
240,324,0,16770,6325981,13.5
270,451,0,16771,6326432,16.703703703703702
170,244,0,16772,6326676,14.352941176470589
190,244,0,16773,6326920,12.842105263157896
420,627,0,16774,6327547,14.928571428571429
240,324,0,16775,6327871,13.5
150,221,0,16776,6328092,14.733333333333333
270,384,0,16777,6328476,14.222222222222221
210,375,0,16778,6328851,17.857142857142858
170,234,0,16779,6329085,13.764705882352942
280,472,0,16780,6329557,16.857142857142858
150,233,0,16781,6329790,15.533333333333333
440,871,0,16782,6330661,19.795454545454547
220,377,0,16783,6331038,17.136363636363637
220,385,0,16784,6331423,17.5
280,412,0,16785,6331835,14.714285714285714
280,477,0,16786,6332312,17.035714285714285
220,305,0,16787,6332617,13.863636363636363
270,349,0,16788,6332966,12.925925925925926
120,158,0,16789,6333124,13.166666666666666
90,99,0,16790,6333223,11.0
180,261,0,16791,6333484,14.5
160,214,0,16792,6333698,13.375
440,682,0,16793,6334380,15.5
380,666,0,16794,6335046,17.526315789473685
200,344,0,16795,6335390,17.2
420,784,0,16796,6336174,18.666666666666668
340,522,0,16797,6336696,15.352941176470589
320,490,0,16798,6337186,15.3125
520,999,0,16799,6338185,19.21153846153846
180,204,0,16800,6338389,11.333333333333334
180,188,0,16801,6338577,10.444444444444445
460,761,0,16802,6339338,16.543478260869566
330,470,0,16803,6339808,14.242424242424242
140,236,0,16804,6340044,16.857142857142858
240,339,0,16805,6340383,14.125
280,385,0,16806,6340768,13.75
340,596,0,16807,6341364,17.529411764705884
350,536,0,16808,6341900,15.314285714285715
370,528,0,16809,6342428,14.27027027027027
310,382,0,16810,6342810,12.32258064516129
250,390,0,16811,6343200,15.6
290,474,0,16812,6343674,16.344827586206897
360,390,0,16813,6344064,10.833333333333334
170,264,0,16814,6344328,15.529411764705882
150,241,0,16815,6344569,16.066666666666666
540,1082,0,16816,6345651,20.037037037037038
160,218,0,16817,6345869,13.625
410,669,0,16818,6346538,16.317073170731707
460,795,0,16819,6347333,17.282608695652176
310,500,0,16820,6347833,16.129032258064516
310,489,0,16821,6348322,15.774193548387096
320,477,0,16822,6348799,14.90625
140,190,0,16823,6348989,13.571428571428571
350,528,0,16824,6349517,15.085714285714285
390,648,0,16825,6350165,16.615384615384617
140,186,0,16826,6350351,13.285714285714286
230,296,0,16827,6350647,12.869565217391305
340,517,0,16828,6351164,15.205882352941176
140,153,0,16829,6351317,10.928571428571429
150,213,0,16830,6351530,14.2
260,381,0,16831,6351911,14.653846153846153
170,261,0,16832,6352172,15.352941176470589
220,310,0,16833,6352482,14.090909090909092
240,434,0,16834,6352916,18.083333333333332
260,394,0,16835,6353310,15.153846153846153
260,373,0,16836,6353683,14.346153846153847
190,304,0,16837,6353987,16.0
120,108,0,16838,6354095,9.0
320,505,0,16839,6354600,15.78125
260,454,0,16840,6355054,17.46153846153846
190,292,0,16841,6355346,15.368421052631579
370,575,0,16842,6355921,15.54054054054054
200,283,0,16843,6356204,14.15
190,227,0,16844,6356431,11.947368421052632
360,519,0,16845,6356950,14.416666666666666
130,186,0,16846,6357136,14.307692307692308
320,536,0,16847,6357672,16.75
260,346,0,16848,6358018,13.307692307692308
280,436,0,16849,6358454,15.571428571428571
350,474,0,16850,6358928,13.542857142857143
520,978,0,16851,6359906,18.807692307692307
380,690,0,16852,6360596,18.157894736842106
360,511,0,16853,6361107,14.194444444444445
480,739,0,16854,6361846,15.395833333333334
240,348,0,16855,6362194,14.5
310,470,0,16856,6362664,15.161290322580646
150,203,0,16857,6362867,13.533333333333333
70,64,0,16858,6362931,9.142857142857142
310,450,0,16859,6363381,14.516129032258064
250,399,0,16860,6363780,15.96
230,289,0,16861,6364069,12.565217391304348
140,205,0,16862,6364274,14.642857142857142
170,229,0,16863,6364503,13.470588235294118
230,340,0,16864,6364843,14.782608695652174
140,162,0,16865,6365005,11.571428571428571
150,199,0,16866,6365204,13.266666666666667
290,455,0,16867,6365659,15.689655172413794
250,363,0,16868,6366022,14.52
200,262,0,16869,6366284,13.1
340,557,0,16870,6366841,16.38235294117647
380,632,0,16871,6367473,16.63157894736842
220,325,0,16872,6367798,14.772727272727273
180,255,0,16873,6368053,14.166666666666666
270,385,0,16874,6368438,14.25925925925926
280,409,0,16875,6368847,14.607142857142858
270,447,0,16876,6369294,16.555555555555557
230,326,0,16877,6369620,14.173913043478262
150,175,0,16878,6369795,11.666666666666666
270,408,0,16879,6370203,15.11111111111111
280,432,0,16880,6370635,15.428571428571429
270,369,0,16881,6371004,13.666666666666666
160,214,0,16882,6371218,13.375
140,189,0,16883,6371407,13.5
290,439,0,16884,6371846,15.137931034482758
220,254,0,16885,6372100,11.545454545454545
150,184,0,16886,6372284,12.266666666666667
220,330,0,16887,6372614,15.0
230,394,0,16888,6373008,17.130434782608695
280,368,0,16889,6373376,13.142857142857142
220,315,0,16890,6373691,14.318181818181818
170,234,0,16891,6373925,13.764705882352942
330,513,0,16892,6374438,15.545454545454545
140,206,0,16893,6374644,14.714285714285714
110,170,0,16894,6374814,15.454545454545455
130,163,0,16895,6374977,12.538461538461538
160,233,0,16896,6375210,14.5625
350,508,0,16897,6375718,14.514285714285714
160,234,0,16898,6375952,14.625
160,217,0,16899,6376169,13.5625
230,315,0,16900,6376484,13.695652173913043
150,166,0,16901,6376650,11.066666666666666
300,430,0,16902,6377080,14.333333333333334
450,667,0,16903,6377747,14.822222222222223
200,284,0,16904,6378031,14.2
190,244,0,16905,6378275,12.842105263157896
210,273,0,16906,6378548,13.0
430,722,0,16907,6379270,16.790697674418606
320,525,0,16908,6379795,16.40625
370,516,0,16909,6380311,13.945945945945946
180,307,0,16910,6380618,17.055555555555557
150,239,0,16911,6380857,15.933333333333334
300,672,0,16912,6381529,22.4
70,99,0,16913,6381628,14.142857142857142
120,167,0,16914,6381795,13.916666666666666
340,497,0,16915,6382292,14.617647058823529
250,371,0,16916,6382663,14.84
190,285,0,16917,6382948,15.0
320,439,0,16918,6383387,13.71875
200,275,0,16919,6383662,13.75
320,513,0,16920,6384175,16.03125
280,408,0,16921,6384583,14.571428571428571
150,216,0,16922,6384799,14.4
270,414,0,16923,6385213,15.333333333333334
340,437,0,16924,6385650,12.852941176470589
270,372,0,16925,6386022,13.777777777777779
230,385,0,16926,6386407,16.73913043478261
150,153,0,16927,6386560,10.2
190,247,0,16928,6386807,13.0
240,306,0,16929,6387113,12.75
140,199,0,16930,6387312,14.214285714285714
220,298,0,16931,6387610,13.545454545454545
260,406,0,16932,6388016,15.615384615384615
130,161,0,16933,6388177,12.384615384615385
160,237,0,16934,6388414,14.8125
180,284,0,16935,6388698,15.777777777777779
170,214,0,16936,6388912,12.588235294117647
210,316,0,16937,6389228,15.047619047619047
270,375,0,16938,6389603,13.88888888888889
310,478,0,16939,6390081,15.419354838709678
300,528,0,16940,6390609,17.6
90,146,0,16941,6390755,16.22222222222222
260,393,0,16942,6391148,15.115384615384615
380,546,0,16943,6391694,14.368421052631579
120,135,0,16944,6391829,11.25
110,278,0,16945,6392107,25.272727272727273
260,414,0,16946,6392521,15.923076923076923
220,330,0,16947,6392851,15.0
250,343,0,16948,6393194,13.72
150,198,0,16949,6393392,13.2
270,406,0,16950,6393798,15.037037037037036
370,561,0,16951,6394359,15.162162162162161
280,423,0,16952,6394782,15.107142857142858
420,652,0,16953,6395434,15.523809523809524
300,490,0,16954,6395924,16.333333333333332
180,313,0,16955,6396237,17.38888888888889
200,301,0,16956,6396538,15.05
260,382,0,16957,6396920,14.692307692307692
340,477,0,16958,6397397,14.029411764705882
220,318,0,16959,6397715,14.454545454545455
220,315,0,16960,6398030,14.318181818181818
320,538,0,16961,6398568,16.8125
270,402,0,16962,6398970,14.88888888888889
320,483,0,16963,6399453,15.09375
80,113,0,16964,6399566,14.125
400,539,0,16965,6400105,13.475
200,253,0,16966,6400358,12.65
130,185,0,16967,6400543,14.23076923076923
210,321,0,16968,6400864,15.285714285714286
310,453,0,16969,6401317,14.612903225806452
260,416,0,16970,6401733,16.0
240,349,0,16971,6402082,14.541666666666666
160,230,0,16972,6402312,14.375
170,226,0,16973,6402538,13.294117647058824
230,332,0,16974,6402870,14.434782608695652
170,228,0,16975,6403098,13.411764705882353
330,508,0,16976,6403606,15.393939393939394
280,426,0,16977,6404032,15.214285714285714
300,410,0,16978,6404442,13.666666666666666
280,387,0,16979,6404829,13.821428571428571
330,545,0,16980,6405374,16.515151515151516
230,296,0,16981,6405670,12.869565217391305
190,291,0,16982,6405961,15.31578947368421
200,303,0,16983,6406264,15.15
210,368,0,16984,6406632,17.523809523809526
320,525,0,16985,6407157,16.40625
230,360,0,16986,6407517,15.652173913043478
240,359,0,16987,6407876,14.958333333333334
270,419,0,16988,6408295,15.518518518518519
90,119,0,16989,6408414,13.222222222222221
350,619,0,16990,6409033,17.685714285714287
500,815,0,16991,6409848,16.3
280,376,0,16992,6410224,13.428571428571429
390,626,0,16993,6410850,16.05128205128205
140,182,0,16994,6411032,13.0
190,246,0,16995,6411278,12.947368421052632
290,454,0,16996,6411732,15.655172413793103
380,619,0,16997,6412351,16.289473684210527
90,115,0,16998,6412466,12.777777777777779
250,376,0,16999,6412842,15.04
370,565,0,17000,6413407,15.27027027027027
290,446,0,17001,6413853,15.379310344827585
120,130,0,17002,6413983,10.833333333333334
340,457,0,17003,6414440,13.441176470588236
450,709,0,17004,6415149,15.755555555555556
320,455,0,17005,6415604,14.21875
320,444,0,17006,6416048,13.875
340,477,0,17007,6416525,14.029411764705882
260,408,0,17008,6416933,15.692307692307692
340,481,0,17009,6417414,14.147058823529411
350,541,0,17010,6417955,15.457142857142857
180,274,0,17011,6418229,15.222222222222221
390,631,0,17012,6418860,16.17948717948718
220,279,0,17013,6419139,12.681818181818182
240,305,0,17014,6419444,12.708333333333334
410,660,0,17015,6420104,16.097560975609756
210,263,0,17016,6420367,12.523809523809524
90,113,0,17017,6420480,12.555555555555555
320,413,0,17018,6420893,12.90625
410,656,0,17019,6421549,16.0
330,538,0,17020,6422087,16.303030303030305
260,388,0,17021,6422475,14.923076923076923
190,261,0,17022,6422736,13.736842105263158
180,238,0,17023,6422974,13.222222222222221
220,314,0,17024,6423288,14.272727272727273
70,76,0,17025,6423364,10.857142857142858
300,391,0,17026,6423755,13.033333333333333
260,386,0,17027,6424141,14.846153846153847
320,578,0,17028,6424719,18.0625
180,273,0,17029,6424992,15.166666666666666
220,308,0,17030,6425300,14.0
290,476,0,17031,6425776,16.413793103448278
280,399,0,17032,6426175,14.25
230,317,0,17033,6426492,13.782608695652174
320,520,0,17034,6427012,16.25
100,162,0,17035,6427174,16.2
290,419,0,17036,6427593,14.448275862068966
250,366,0,17037,6427959,14.64
370,617,0,17038,6428576,16.675675675675677
350,560,0,17039,6429136,16.0
300,447,0,17040,6429583,14.9
330,589,0,17041,6430172,17.848484848484848
430,627,0,17042,6430799,14.581395348837209
180,279,0,17043,6431078,15.5
180,238,0,17044,6431316,13.222222222222221
230,314,0,17045,6431630,13.652173913043478
330,636,0,17046,6432266,19.272727272727273
420,611,0,17047,6432877,14.547619047619047
240,330,0,17048,6433207,13.75
160,201,0,17049,6433408,12.5625
190,286,0,17050,6433694,15.052631578947368
330,574,0,17051,6434268,17.393939393939394
290,448,0,17052,6434716,15.448275862068966
110,107,0,17053,6434823,9.727272727272727
250,412,0,17054,6435235,16.48
230,359,0,17055,6435594,15.608695652173912
280,408,0,17056,6436002,14.571428571428571
280,413,0,17057,6436415,14.75
210,322,0,17058,6436737,15.333333333333334
330,492,0,17059,6437229,14.909090909090908
290,487,0,17060,6437716,16.79310344827586
210,231,0,17061,6437947,11.0
250,355,0,17062,6438302,14.2
350,538,0,17063,6438840,15.371428571428572
150,213,0,17064,6439053,14.2
220,319,0,17065,6439372,14.5
220,270,0,17066,6439642,12.272727272727273
200,309,0,17067,6439951,15.45
190,265,0,17068,6440216,13.947368421052632
310,427,0,17069,6440643,13.774193548387096
100,122,0,17070,6440765,12.2
230,318,0,17071,6441083,13.826086956521738
240,272,0,17072,6441355,11.333333333333334
270,415,0,17073,6441770,15.37037037037037
250,364,0,17074,6442134,14.56
210,318,0,17075,6442452,15.142857142857142
230,262,0,17076,6442714,11.391304347826088
200,262,0,17077,6442976,13.1
190,303,0,17078,6443279,15.947368421052632
490,754,0,17079,6444033,15.387755102040817
120,159,0,17080,6444192,13.25
90,123,0,17081,6444315,13.666666666666666
170,276,0,17082,6444591,16.235294117647058
220,364,0,17083,6444955,16.545454545454547
220,328,0,17084,6445283,14.909090909090908
400,698,0,17085,6445981,17.45
240,325,0,17086,6446306,13.541666666666666
270,423,0,17087,6446729,15.666666666666666
320,497,0,17088,6447226,15.53125
110,129,0,17089,6447355,11.727272727272727
280,425,0,17090,6447780,15.178571428571429
300,453,0,17091,6448233,15.1
260,439,0,17092,6448672,16.884615384615383
310,416,0,17093,6449088,13.419354838709678
350,666,0,17094,6449754,19.02857142857143
240,317,0,17095,6450071,13.208333333333334
320,471,0,17096,6450542,14.71875
340,542,0,17097,6451084,15.941176470588236
190,372,0,17098,6451456,19.57894736842105
380,601,0,17099,6452057,15.81578947368421
210,281,0,17100,6452338,13.380952380952381
170,254,0,17101,6452592,14.941176470588236
140,188,0,17102,6452780,13.428571428571429
220,325,0,17103,6453105,14.772727272727273
140,185,0,17104,6453290,13.214285714285714
230,413,0,17105,6453703,17.956521739130434
280,425,0,17106,6454128,15.178571428571429
190,331,0,17107,6454459,17.42105263157895
300,394,0,17108,6454853,13.133333333333333
140,236,0,17109,6455089,16.857142857142858
210,313,0,17110,6455402,14.904761904761905
380,570,0,17111,6455972,15.0
230,305,0,17112,6456277,13.26086956521739
340,493,0,17113,6456770,14.5
250,418,0,17114,6457188,16.72
150,192,0,17115,6457380,12.8
400,572,0,17116,6457952,14.3
180,260,0,17117,6458212,14.444444444444445
360,543,0,17118,6458755,15.083333333333334
90,119,0,17119,6458874,13.222222222222221
260,410,0,17120,6459284,15.76923076923077
150,206,0,17121,6459490,13.733333333333333
170,214,0,17122,6459704,12.588235294117647
200,321,0,17123,6460025,16.05
220,319,0,17124,6460344,14.5
180,190,0,17125,6460534,10.555555555555555
180,245,0,17126,6460779,13.61111111111111
330,500,0,17127,6461279,15.151515151515152
320,447,0,17128,6461726,13.96875
260,379,0,17129,6462105,14.576923076923077
270,391,0,17130,6462496,14.481481481481481
230,369,0,17131,6462865,16.043478260869566
350,486,0,17132,6463351,13.885714285714286
210,315,0,17133,6463666,15.0
310,506,0,17134,6464172,16.322580645161292
230,330,0,17135,6464502,14.347826086956522
110,112,0,17136,6464614,10.181818181818182
250,351,0,17137,6464965,14.04
240,318,0,17138,6465283,13.25
270,422,0,17139,6465705,15.62962962962963
390,538,0,17140,6466243,13.794871794871796
180,199,0,17141,6466442,11.055555555555555
310,447,0,17142,6466889,14.419354838709678
320,480,0,17143,6467369,15.0
400,635,0,17144,6468004,15.875
90,123,0,17145,6468127,13.666666666666666
220,304,0,17146,6468431,13.818181818181818
300,364,0,17147,6468795,12.133333333333333
410,635,0,17148,6469430,15.487804878048781
240,406,0,17149,6469836,16.916666666666668
360,497,0,17150,6470333,13.805555555555555
140,215,0,17151,6470548,15.357142857142858
180,230,0,17152,6470778,12.777777777777779
220,250,0,17153,6471028,11.363636363636363
220,316,0,17154,6471344,14.363636363636363
290,401,0,17155,6471745,13.827586206896552
340,535,0,17156,6472280,15.735294117647058
330,571,0,17157,6472851,17.303030303030305
50,76,0,17158,6472927,15.2
230,342,0,17159,6473269,14.869565217391305
210,273,0,17160,6473542,13.0
390,572,0,17161,6474114,14.666666666666666
290,399,0,17162,6474513,13.758620689655173
80,101,0,17163,6474614,12.625
260,299,0,17164,6474913,11.5
60,45,0,17165,6474958,7.5
150,238,0,17166,6475196,15.866666666666667
150,219,0,17167,6475415,14.6
190,274,0,17168,6475689,14.421052631578947
320,481,0,17169,6476170,15.03125
180,254,0,17170,6476424,14.11111111111111
370,611,0,17171,6477035,16.513513513513512
410,615,0,17172,6477650,15.0
320,506,0,17173,6478156,15.8125
50,45,0,17174,6478201,9.0
210,294,0,17175,6478495,14.0
180,257,0,17176,6478752,14.277777777777779
280,405,0,17177,6479157,14.464285714285714
380,577,0,17178,6479734,15.18421052631579
380,608,0,17179,6480342,16.0
180,164,0,17180,6480506,9.11111111111111
240,348,0,17181,6480854,14.5
50,34,0,17182,6480888,6.8
90,139,0,17183,6481027,15.444444444444445
280,436,0,17184,6481463,15.571428571428571
280,406,0,17185,6481869,14.5
90,101,0,17186,6481970,11.222222222222221
290,414,0,17187,6482384,14.275862068965518
270,417,0,17188,6482801,15.444444444444445
190,289,0,17189,6483090,15.210526315789474
270,362,0,17190,6483452,13.407407407407407
300,455,0,17191,6483907,15.166666666666666
320,425,0,17192,6484332,13.28125
110,159,0,17193,6484491,14.454545454545455
370,494,0,17194,6484985,13.35135135135135
380,660,0,17195,6485645,17.36842105263158
360,529,0,17196,6486174,14.694444444444445
320,459,0,17197,6486633,14.34375
370,651,0,17198,6487284,17.594594594594593
220,291,0,17199,6487575,13.227272727272727
190,246,0,17200,6487821,12.947368421052632
160,231,0,17201,6488052,14.4375
160,243,0,17202,6488295,15.1875
220,313,0,17203,6488608,14.227272727272727
350,507,0,17204,6489115,14.485714285714286
320,482,0,17205,6489597,15.0625
280,424,0,17206,6490021,15.142857142857142
120,200,0,17207,6490221,16.666666666666668
370,570,0,17208,6490791,15.405405405405405
190,254,0,17209,6491045,13.368421052631579
140,199,0,17210,6491244,14.214285714285714
490,669,0,17211,6491913,13.653061224489797
160,233,0,17212,6492146,14.5625
400,723,0,17213,6492869,18.075
330,420,0,17214,6493289,12.727272727272727
270,478,0,17215,6493767,17.703703703703702
120,168,0,17216,6493935,14.0
200,256,0,17217,6494191,12.8
110,146,0,17218,6494337,13.272727272727273
380,564,0,17219,6494901,14.842105263157896
210,276,0,17220,6495177,13.142857142857142
240,351,0,17221,6495528,14.625
280,386,0,17222,6495914,13.785714285714286
110,166,0,17223,6496080,15.090909090909092
240,394,0,17224,6496474,16.416666666666668
310,487,0,17225,6496961,15.709677419354838
200,282,0,17226,6497243,14.1
310,478,0,17227,6497721,15.419354838709678
130,143,0,17228,6497864,11.0
260,405,0,17229,6498269,15.576923076923077
190,300,0,17230,6498569,15.789473684210526
210,261,0,17231,6498830,12.428571428571429
210,328,0,17232,6499158,15.619047619047619
280,393,0,17233,6499551,14.035714285714286
120,144,0,17234,6499695,12.0
140,209,0,17235,6499904,14.928571428571429
310,423,0,17236,6500327,13.64516129032258
290,484,0,17237,6500811,16.689655172413794
360,529,0,17238,6501340,14.694444444444445
310,478,0,17239,6501818,15.419354838709678
230,342,0,17240,6502160,14.869565217391305
280,469,0,17241,6502629,16.75
300,419,0,17242,6503048,13.966666666666667
140,156,0,17243,6503204,11.142857142857142
200,292,0,17244,6503496,14.6
180,220,0,17245,6503716,12.222222222222221
280,408,0,17246,6504124,14.571428571428571
220,285,0,17247,6504409,12.954545454545455
140,145,0,17248,6504554,10.357142857142858
270,378,0,17249,6504932,14.0
300,400,0,17250,6505332,13.333333333333334
270,419,0,17251,6505751,15.518518518518519
320,457,0,17252,6506208,14.28125
160,191,0,17253,6506399,11.9375
250,360,0,17254,6506759,14.4
310,508,0,17255,6507267,16.387096774193548
270,394,0,17256,6507661,14.592592592592593
230,336,0,17257,6507997,14.608695652173912
220,256,0,17258,6508253,11.636363636363637
360,542,0,17259,6508795,15.055555555555555
160,206,0,17260,6509001,12.875
400,781,0,17261,6509782,19.525
250,350,0,17262,6510132,14.0
250,325,0,17263,6510457,13.0
300,465,0,17264,6510922,15.5
350,546,0,17265,6511468,15.6
220,297,0,17266,6511765,13.5
280,499,0,17267,6512264,17.821428571428573
250,398,0,17268,6512662,15.92
180,236,0,17269,6512898,13.11111111111111
110,144,0,17270,6513042,13.090909090909092
330,450,0,17271,6513492,13.636363636363637
290,472,0,17272,6513964,16.275862068965516
240,356,0,17273,6514320,14.833333333333334
420,641,0,17274,6514961,15.261904761904763
290,367,0,17275,6515328,12.655172413793103
390,532,0,17276,6515860,13.64102564102564
190,320,0,17277,6516180,16.842105263157894
210,289,0,17278,6516469,13.761904761904763
130,176,0,17279,6516645,13.538461538461538
260,388,0,17280,6517033,14.923076923076923
220,314,0,17281,6517347,14.272727272727273
330,505,0,17282,6517852,15.303030303030303
290,376,0,17283,6518228,12.96551724137931
220,292,0,17284,6518520,13.272727272727273
260,407,0,17285,6518927,15.653846153846153
130,186,0,17286,6519113,14.307692307692308
400,733,0,17287,6519846,18.325
410,693,0,17288,6520539,16.902439024390244
90,126,0,17289,6520665,14.0
100,112,0,17290,6520777,11.2
550,1001,0,17291,6521778,18.2
280,454,0,17292,6522232,16.214285714285715
140,212,0,17293,6522444,15.142857142857142
250,360,0,17294,6522804,14.4
50,45,0,17295,6522849,9.0
250,344,0,17296,6523193,13.76
280,416,0,17297,6523609,14.857142857142858
280,402,0,17298,6524011,14.357142857142858
60,96,0,17299,6524107,16.0
350,436,0,17300,6524543,12.457142857142857
360,508,0,17301,6525051,14.11111111111111
260,341,0,17302,6525392,13.115384615384615
390,567,0,17303,6525959,14.538461538461538
370,533,0,17304,6526492,14.405405405405405
390,582,0,17305,6527074,14.923076923076923
260,359,0,17306,6527433,13.807692307692308
370,560,0,17307,6527993,15.135135135135135
160,210,0,17308,6528203,13.125
320,495,0,17309,6528698,15.46875
360,508,0,17310,6529206,14.11111111111111
160,229,0,17311,6529435,14.3125
360,569,0,17312,6530004,15.805555555555555
110,190,0,17313,6530194,17.272727272727273
230,345,0,17314,6530539,15.0
160,212,0,17315,6530751,13.25
240,304,0,17316,6531055,12.666666666666666
250,362,0,17317,6531417,14.48
550,808,0,17318,6532225,14.690909090909091
280,442,0,17319,6532667,15.785714285714286
130,184,0,17320,6532851,14.153846153846153
110,156,0,17321,6533007,14.181818181818182
410,656,0,17322,6533663,16.0
350,520,0,17323,6534183,14.857142857142858
210,296,0,17324,6534479,14.095238095238095
180,218,0,17325,6534697,12.11111111111111
220,307,0,17326,6535004,13.954545454545455
270,401,0,17327,6535405,14.851851851851851
350,495,0,17328,6535900,14.142857142857142
220,324,0,17329,6536224,14.727272727272727
280,452,0,17330,6536676,16.142857142857142
340,564,0,17331,6537240,16.58823529411765
170,241,0,17332,6537481,14.176470588235293
140,235,0,17333,6537716,16.785714285714285
390,502,0,17334,6538218,12.871794871794872
320,382,0,17335,6538600,11.9375
330,493,0,17336,6539093,14.93939393939394
350,478,0,17337,6539571,13.657142857142857
220,269,0,17338,6539840,12.227272727272727
200,300,0,17339,6540140,15.0
270,390,0,17340,6540530,14.444444444444445
240,297,0,17341,6540827,12.375
160,217,0,17342,6541044,13.5625
190,289,0,17343,6541333,15.210526315789474
150,204,0,17344,6541537,13.6
200,227,0,17345,6541764,11.35
320,477,0,17346,6542241,14.90625
500,683,0,17347,6542924,13.66
240,366,0,17348,6543290,15.25
120,201,0,17349,6543491,16.75
210,275,0,17350,6543766,13.095238095238095
290,442,0,17351,6544208,15.241379310344827
310,499,0,17352,6544707,16.096774193548388
230,344,0,17353,6545051,14.956521739130435
360,514,0,17354,6545565,14.277777777777779
290,549,0,17355,6546114,18.93103448275862
380,513,0,17356,6546627,13.5
130,126,0,17357,6546753,9.692307692307692
450,675,0,17358,6547428,15.0
320,492,0,17359,6547920,15.375
220,332,0,17360,6548252,15.090909090909092
240,391,0,17361,6548643,16.291666666666668
220,295,0,17362,6548938,13.409090909090908
160,218,0,17363,6549156,13.625
150,212,0,17364,6549368,14.133333333333333
380,636,0,17365,6550004,16.736842105263158
300,500,0,17366,6550504,16.666666666666668
330,418,0,17367,6550922,12.666666666666666
380,522,0,17368,6551444,13.736842105263158
250,364,0,17369,6551808,14.56
130,186,0,17370,6551994,14.307692307692308
320,576,0,17371,6552570,18.0
120,179,0,17372,6552749,14.916666666666666
450,599,0,17373,6553348,13.311111111111112
200,276,0,17374,6553624,13.8
280,492,0,17375,6554116,17.571428571428573
160,211,0,17376,6554327,13.1875
200,231,0,17377,6554558,11.55
340,435,0,17378,6554993,12.794117647058824
290,466,0,17379,6555459,16.06896551724138
210,278,0,17380,6555737,13.238095238095237
360,470,0,17381,6556207,13.055555555555555
140,182,0,17382,6556389,13.0
360,546,0,17383,6556935,15.166666666666666
440,701,0,17384,6557636,15.931818181818182
220,277,0,17385,6557913,12.590909090909092
340,525,0,17386,6558438,15.441176470588236
200,296,0,17387,6558734,14.8
140,186,0,17388,6558920,13.285714285714286
120,143,0,17389,6559063,11.916666666666666
340,533,0,17390,6559596,15.676470588235293
210,298,0,17391,6559894,14.19047619047619
170,214,0,17392,6560108,12.588235294117647
230,332,0,17393,6560440,14.434782608695652
310,432,0,17394,6560872,13.935483870967742
260,374,0,17395,6561246,14.384615384615385
340,475,0,17396,6561721,13.970588235294118
270,391,0,17397,6562112,14.481481481481481
220,299,0,17398,6562411,13.590909090909092
430,719,0,17399,6563130,16.72093023255814
310,476,0,17400,6563606,15.35483870967742
120,177,0,17401,6563783,14.75
210,302,0,17402,6564085,14.380952380952381
130,153,0,17403,6564238,11.76923076923077
430,598,0,17404,6564836,13.906976744186046
160,196,0,17405,6565032,12.25
330,485,0,17406,6565517,14.696969696969697
150,220,0,17407,6565737,14.666666666666666
190,296,0,17408,6566033,15.578947368421053
250,310,0,17409,6566343,12.4
250,318,0,17410,6566661,12.72
280,379,0,17411,6567040,13.535714285714286
450,650,0,17412,6567690,14.444444444444445
290,391,0,17413,6568081,13.482758620689655
280,345,0,17414,6568426,12.321428571428571
210,272,0,17415,6568698,12.952380952380953
130,198,0,17416,6568896,15.23076923076923
160,211,0,17417,6569107,13.1875
230,339,0,17418,6569446,14.73913043478261
310,446,0,17419,6569892,14.387096774193548
150,206,0,17420,6570098,13.733333333333333
130,160,0,17421,6570258,12.307692307692308
320,507,0,17422,6570765,15.84375
110,144,0,17423,6570909,13.090909090909092
240,314,0,17424,6571223,13.083333333333334
230,328,0,17425,6571551,14.26086956521739
230,320,0,17426,6571871,13.91304347826087
320,519,0,17427,6572390,16.21875
250,399,0,17428,6572789,15.96
330,485,0,17429,6573274,14.696969696969697
250,433,0,17430,6573707,17.32
230,347,0,17431,6574054,15.08695652173913
320,487,0,17432,6574541,15.21875
90,112,0,17433,6574653,12.444444444444445
400,541,0,17434,6575194,13.525
240,399,0,17435,6575593,16.625
300,408,0,17436,6576001,13.6
400,653,0,17437,6576654,16.325
230,347,0,17438,6577001,15.08695652173913
270,458,0,17439,6577459,16.962962962962962
360,552,0,17440,6578011,15.333333333333334
390,670,0,17441,6578681,17.17948717948718
180,197,0,17442,6578878,10.944444444444445
180,234,0,17443,6579112,13.0
240,329,0,17444,6579441,13.708333333333334
120,137,0,17445,6579578,11.416666666666666
180,353,0,17446,6579931,19.61111111111111
150,216,0,17447,6580147,14.4
370,489,0,17448,6580636,13.216216216216216
330,487,0,17449,6581123,14.757575757575758
290,455,0,17450,6581578,15.689655172413794
140,228,0,17451,6581806,16.285714285714285
150,246,0,17452,6582052,16.4
120,203,0,17453,6582255,16.916666666666668
250,401,0,17454,6582656,16.04
200,233,0,17455,6582889,11.65
460,693,0,17456,6583582,15.065217391304348
180,240,0,17457,6583822,13.333333333333334
300,476,0,17458,6584298,15.866666666666667
100,116,0,17459,6584414,11.6
230,333,0,17460,6584747,14.478260869565217
190,315,0,17461,6585062,16.57894736842105
280,381,0,17462,6585443,13.607142857142858
250,382,0,17463,6585825,15.28
220,300,0,17464,6586125,13.636363636363637
150,209,0,17465,6586334,13.933333333333334
420,697,0,17466,6587031,16.595238095238095
110,141,0,17467,6587172,12.818181818181818
230,356,0,17468,6587528,15.478260869565217
220,328,0,17469,6587856,14.909090909090908
140,215,0,17470,6588071,15.357142857142858
250,338,0,17471,6588409,13.52
300,457,0,17472,6588866,15.233333333333333
220,395,0,17473,6589261,17.954545454545453
340,524,0,17474,6589785,15.411764705882353
190,331,0,17475,6590116,17.42105263157895
270,416,0,17476,6590532,15.407407407407407
200,301,0,17477,6590833,15.05
80,115,0,17478,6590948,14.375
290,377,0,17479,6591325,13.0
280,366,0,17480,6591691,13.071428571428571
380,546,0,17481,6592237,14.368421052631579
380,585,0,17482,6592822,15.394736842105264
200,240,0,17483,6593062,12.0
260,387,0,17484,6593449,14.884615384615385
330,543,0,17485,6593992,16.454545454545453
90,119,0,17486,6594111,13.222222222222221
270,366,0,17487,6594477,13.555555555555555
290,417,0,17488,6594894,14.379310344827585
190,286,0,17489,6595180,15.052631578947368
240,318,0,17490,6595498,13.25
160,187,0,17491,6595685,11.6875
200,281,0,17492,6595966,14.05
350,541,0,17493,6596507,15.457142857142857
250,371,0,17494,6596878,14.84
160,248,0,17495,6597126,15.5
160,216,0,17496,6597342,13.5
180,232,0,17497,6597574,12.88888888888889
170,255,0,17498,6597829,15.0
180,270,0,17499,6598099,15.0
330,550,0,17500,6598649,16.666666666666668
160,210,0,17501,6598859,13.125
170,200,0,17502,6599059,11.764705882352942
250,375,0,17503,6599434,15.0
410,668,0,17504,6600102,16.29268292682927
230,376,0,17505,6600478,16.347826086956523
300,403,0,17506,6600881,13.433333333333334
170,250,0,17507,6601131,14.705882352941176
310,473,0,17508,6601604,15.258064516129032
360,573,0,17509,6602177,15.916666666666666
270,365,0,17510,6602542,13.518518518518519
420,647,0,17511,6603189,15.404761904761905
340,467,0,17512,6603656,13.735294117647058
290,466,0,17513,6604122,16.06896551724138
290,500,0,17514,6604622,17.24137931034483
230,317,0,17515,6604939,13.782608695652174
350,573,0,17516,6605512,16.37142857142857
180,292,0,17517,6605804,16.22222222222222
270,363,0,17518,6606167,13.444444444444445
200,250,0,17519,6606417,12.5
310,480,0,17520,6606897,15.483870967741936
150,185,0,17521,6607082,12.333333333333334
160,250,0,17522,6607332,15.625
210,337,0,17523,6607669,16.047619047619047
180,230,0,17524,6607899,12.777777777777779
370,491,0,17525,6608390,13.27027027027027
290,400,0,17526,6608790,13.793103448275861
360,598,0,17527,6609388,16.61111111111111
500,858,0,17528,6610246,17.16
130,169,0,17529,6610415,13.0
300,416,0,17530,6610831,13.866666666666667
320,397,0,17531,6611228,12.40625
280,398,0,17532,6611626,14.214285714285714
180,203,0,17533,6611829,11.277777777777779
120,165,0,17534,6611994,13.75
90,124,0,17535,6612118,13.777777777777779
230,346,0,17536,6612464,15.043478260869565
210,295,0,17537,6612759,14.047619047619047
260,473,0,17538,6613232,18.192307692307693
150,167,0,17539,6613399,11.133333333333333
360,494,0,17540,6613893,13.722222222222221
220,314,0,17541,6614207,14.272727272727273
250,415,0,17542,6614622,16.6
400,552,0,17543,6615174,13.8
360,602,0,17544,6615776,16.72222222222222
280,373,0,17545,6616149,13.321428571428571
220,282,0,17546,6616431,12.818181818181818
190,357,0,17547,6616788,18.789473684210527
110,163,0,17548,6616951,14.818181818181818
220,294,0,17549,6617245,13.363636363636363
450,851,0,17550,6618096,18.91111111111111
170,229,0,17551,6618325,13.470588235294118
270,390,0,17552,6618715,14.444444444444445
220,317,0,17553,6619032,14.409090909090908
130,186,0,17554,6619218,14.307692307692308
320,505,0,17555,6619723,15.78125
210,336,0,17556,6620059,16.0
340,524,0,17557,6620583,15.411764705882353
250,357,0,17558,6620940,14.28
230,372,0,17559,6621312,16.17391304347826
200,272,0,17560,6621584,13.6
320,545,0,17561,6622129,17.03125
280,443,0,17562,6622572,15.821428571428571
220,337,0,17563,6622909,15.318181818181818
260,420,0,17564,6623329,16.153846153846153
150,193,0,17565,6623522,12.866666666666667
220,293,0,17566,6623815,13.318181818181818
310,500,0,17567,6624315,16.129032258064516
240,320,0,17568,6624635,13.333333333333334
130,189,0,17569,6624824,14.538461538461538
120,143,0,17570,6624967,11.916666666666666
200,246,0,17571,6625213,12.3
260,415,0,17572,6625628,15.961538461538462
360,611,0,17573,6626239,16.97222222222222
170,291,0,17574,6626530,17.11764705882353
290,421,0,17575,6626951,14.517241379310345
210,300,0,17576,6627251,14.285714285714286
390,584,0,17577,6627835,14.974358974358974
160,226,0,17578,6628061,14.125
150,214,0,17579,6628275,14.266666666666667
280,330,0,17580,6628605,11.785714285714286
210,252,0,17581,6628857,12.0
140,208,0,17582,6629065,14.857142857142858
320,537,0,17583,6629602,16.78125
210,248,0,17584,6629850,11.80952380952381
400,606,0,17585,6630456,15.15
180,229,0,17586,6630685,12.722222222222221
250,364,0,17587,6631049,14.56
240,251,0,17588,6631300,10.458333333333334
190,272,0,17589,6631572,14.31578947368421
130,144,0,17590,6631716,11.076923076923077
250,369,0,17591,6632085,14.76
270,380,0,17592,6632465,14.074074074074074
160,193,0,17593,6632658,12.0625
290,413,0,17594,6633071,14.241379310344827
210,327,0,17595,6633398,15.571428571428571
220,300,0,17596,6633698,13.636363636363637
210,326,0,17597,6634024,15.523809523809524
220,268,0,17598,6634292,12.181818181818182
240,344,0,17599,6634636,14.333333333333334
370,573,0,17600,6635209,15.486486486486486
80,84,0,17601,6635293,10.5
140,184,0,17602,6635477,13.142857142857142
240,375,0,17603,6635852,15.625
140,184,0,17604,6636036,13.142857142857142
380,583,0,17605,6636619,15.342105263157896
110,95,0,17606,6636714,8.636363636363637
300,413,0,17607,6637127,13.766666666666667
350,455,0,17608,6637582,13.0
140,130,0,17609,6637712,9.285714285714286
340,424,0,17610,6638136,12.470588235294118
470,799,0,17611,6638935,17.0
380,545,0,17612,6639480,14.342105263157896
250,384,0,17613,6639864,15.36
240,339,0,17614,6640203,14.125
380,576,0,17615,6640779,15.157894736842104
340,484,0,17616,6641263,14.235294117647058
400,592,0,17617,6641855,14.8
160,174,0,17618,6642029,10.875
230,341,0,17619,6642370,14.826086956521738
410,713,0,17620,6643083,17.390243902439025
280,441,0,17621,6643524,15.75
430,832,0,17622,6644356,19.348837209302324
160,227,0,17623,6644583,14.1875
290,404,0,17624,6644987,13.931034482758621
190,282,0,17625,6645269,14.842105263157896
190,274,0,17626,6645543,14.421052631578947
310,544,0,17627,6646087,17.548387096774192
320,507,0,17628,6646594,15.84375
310,430,0,17629,6647024,13.870967741935484
320,525,0,17630,6647549,16.40625
370,562,0,17631,6648111,15.18918918918919
230,374,0,17632,6648485,16.26086956521739
480,750,0,17633,6649235,15.625
270,376,0,17634,6649611,13.925925925925926
200,285,0,17635,6649896,14.25
340,535,0,17636,6650431,15.735294117647058
270,401,0,17637,6650832,14.851851851851851
260,373,0,17638,6651205,14.346153846153847
240,358,0,17639,6651563,14.916666666666666
250,363,0,17640,6651926,14.52
90,122,0,17641,6652048,13.555555555555555
360,521,0,17642,6652569,14.472222222222221
220,301,0,17643,6652870,13.681818181818182
190,303,0,17644,6653173,15.947368421052632
190,294,0,17645,6653467,15.473684210526315
360,604,0,17646,6654071,16.77777777777778
180,236,0,17647,6654307,13.11111111111111
350,568,0,17648,6654875,16.228571428571428
360,664,0,17649,6655539,18.444444444444443
350,538,0,17650,6656077,15.371428571428572
270,403,0,17651,6656480,14.925925925925926
280,380,0,17652,6656860,13.571428571428571
240,414,0,17653,6657274,17.25
420,705,0,17654,6657979,16.785714285714285
190,313,0,17655,6658292,16.473684210526315
300,525,0,17656,6658817,17.5
370,569,0,17657,6659386,15.378378378378379
290,472,0,17658,6659858,16.275862068965516
200,307,0,17659,6660165,15.35
210,312,0,17660,6660477,14.857142857142858
520,750,0,17661,6661227,14.423076923076923
370,690,0,17662,6661917,18.64864864864865
150,281,0,17663,6662198,18.733333333333334
290,512,0,17664,6662710,17.655172413793103
160,228,0,17665,6662938,14.25
140,209,0,17666,6663147,14.928571428571429
220,261,0,17667,6663408,11.863636363636363
150,235,0,17668,6663643,15.666666666666666
280,452,0,17669,6664095,16.142857142857142
220,396,0,17670,6664491,18.0
150,270,0,17671,6664761,18.0
340,488,0,17672,6665249,14.352941176470589
160,212,0,17673,6665461,13.25
250,385,0,17674,6665846,15.4
180,275,0,17675,6666121,15.277777777777779
340,527,0,17676,6666648,15.5
320,444,0,17677,6667092,13.875
240,350,0,17678,6667442,14.583333333333334
130,161,0,17679,6667603,12.384615384615385
200,268,0,17680,6667871,13.4
240,347,0,17681,6668218,14.458333333333334
350,561,0,17682,6668779,16.02857142857143
110,177,0,17683,6668956,16.09090909090909
330,552,0,17684,6669508,16.727272727272727
300,445,0,17685,6669953,14.833333333333334
140,198,0,17686,6670151,14.142857142857142
350,601,0,17687,6670752,17.17142857142857
300,484,0,17688,6671236,16.133333333333333
370,579,0,17689,6671815,15.64864864864865
60,79,0,17690,6671894,13.166666666666666
170,283,0,17691,6672177,16.647058823529413
170,169,0,17692,6672346,9.941176470588236
130,164,0,17693,6672510,12.615384615384615
340,459,0,17694,6672969,13.5
420,666,0,17695,6673635,15.857142857142858
380,606,0,17696,6674241,15.947368421052632
380,558,0,17697,6674799,14.68421052631579
180,208,0,17698,6675007,11.555555555555555
110,163,0,17699,6675170,14.818181818181818
180,216,0,17700,6675386,12.0
320,499,0,17701,6675885,15.59375
290,427,0,17702,6676312,14.724137931034482
110,179,0,17703,6676491,16.272727272727273
200,291,0,17704,6676782,14.55
120,172,0,17705,6676954,14.333333333333334
340,491,0,17706,6677445,14.441176470588236
360,506,0,17707,6677951,14.055555555555555
170,261,0,17708,6678212,15.352941176470589
290,446,0,17709,6678658,15.379310344827585
540,937,0,17710,6679595,17.35185185185185
260,361,0,17711,6679956,13.884615384615385
190,271,0,17712,6680227,14.263157894736842
220,289,0,17713,6680516,13.136363636363637
100,117,0,17714,6680633,11.7
300,392,0,17715,6681025,13.066666666666666
180,255,0,17716,6681280,14.166666666666666
330,419,0,17717,6681699,12.696969696969697
250,435,0,17718,6682134,17.4
180,241,0,17719,6682375,13.38888888888889
260,372,0,17720,6682747,14.307692307692308
210,270,0,17721,6683017,12.857142857142858
180,246,0,17722,6683263,13.666666666666666
140,212,0,17723,6683475,15.142857142857142
240,371,0,17724,6683846,15.458333333333334
290,352,0,17725,6684198,12.137931034482758
150,182,0,17726,6684380,12.133333333333333
520,860,0,17727,6685240,16.53846153846154
100,108,0,17728,6685348,10.8
220,353,0,17729,6685701,16.045454545454547
230,355,0,17730,6686056,15.434782608695652
250,318,0,17731,6686374,12.72
210,281,0,17732,6686655,13.380952380952381
270,397,0,17733,6687052,14.703703703703704
420,643,0,17734,6687695,15.30952380952381
280,384,0,17735,6688079,13.714285714285714
340,518,0,17736,6688597,15.235294117647058
450,755,0,17737,6689352,16.77777777777778
110,131,0,17738,6689483,11.909090909090908
320,476,0,17739,6689959,14.875
140,159,0,17740,6690118,11.357142857142858
370,555,0,17741,6690673,15.0
160,195,0,17742,6690868,12.1875
360,554,0,17743,6691422,15.38888888888889
150,255,0,17744,6691677,17.0
360,551,0,17745,6692228,15.305555555555555
200,344,0,17746,6692572,17.2
360,486,0,17747,6693058,13.5
180,257,0,17748,6693315,14.277777777777779
440,583,0,17749,6693898,13.25
180,253,0,17750,6694151,14.055555555555555
160,191,0,17751,6694342,11.9375
140,217,0,17752,6694559,15.5
240,353,0,17753,6694912,14.708333333333334
510,835,0,17754,6695747,16.372549019607842
140,191,0,17755,6695938,13.642857142857142
250,344,0,17756,6696282,13.76
170,261,0,17757,6696543,15.352941176470589
170,231,0,17758,6696774,13.588235294117647
480,794,0,17759,6697568,16.541666666666668
140,207,0,17760,6697775,14.785714285714286
360,549,0,17761,6698324,15.25
160,233,0,17762,6698557,14.5625
300,479,0,17763,6699036,15.966666666666667
200,307,0,17764,6699343,15.35
310,438,0,17765,6699781,14.129032258064516
260,398,0,17766,6700179,15.307692307692308
340,489,0,17767,6700668,14.382352941176471
250,369,0,17768,6701037,14.76
460,723,0,17769,6701760,15.717391304347826
160,204,0,17770,6701964,12.75
80,140,0,17771,6702104,17.5
520,873,0,17772,6702977,16.78846153846154
320,535,0,17773,6703512,16.71875
230,299,0,17774,6703811,13.0
190,240,0,17775,6704051,12.631578947368421
510,1037,0,17776,6705088,20.333333333333332
350,566,0,17777,6705654,16.17142857142857
190,284,0,17778,6705938,14.947368421052632
320,446,0,17779,6706384,13.9375
160,212,0,17780,6706596,13.25
330,478,0,17781,6707074,14.484848484848484
380,547,0,17782,6707621,14.394736842105264
280,409,0,17783,6708030,14.607142857142858
170,219,0,17784,6708249,12.882352941176471
180,219,0,17785,6708468,12.166666666666666
520,1098,0,17786,6709566,21.115384615384617
230,298,0,17787,6709864,12.956521739130435
250,437,0,17788,6710301,17.48
190,295,0,17789,6710596,15.526315789473685
260,364,0,17790,6710960,14.0
340,559,0,17791,6711519,16.441176470588236
200,343,0,17792,6711862,17.15
230,278,0,17793,6712140,12.08695652173913
220,337,0,17794,6712477,15.318181818181818
180,299,0,17795,6712776,16.61111111111111
360,532,0,17796,6713308,14.777777777777779
140,198,0,17797,6713506,14.142857142857142
150,175,0,17798,6713681,11.666666666666666
200,296,0,17799,6713977,14.8
230,330,0,17800,6714307,14.347826086956522
250,279,0,17801,6714586,11.16
260,391,0,17802,6714977,15.038461538461538
160,250,0,17803,6715227,15.625
200,268,0,17804,6715495,13.4
400,542,0,17805,6716037,13.55
130,173,0,17806,6716210,13.307692307692308
330,578,0,17807,6716788,17.515151515151516
330,446,0,17808,6717234,13.515151515151516
180,236,0,17809,6717470,13.11111111111111
250,374,0,17810,6717844,14.96
460,774,0,17811,6718618,16.82608695652174
280,422,0,17812,6719040,15.071428571428571
180,217,0,17813,6719257,12.055555555555555
260,370,0,17814,6719627,14.23076923076923
220,308,0,17815,6719935,14.0
150,171,0,17816,6720106,11.4
220,310,0,17817,6720416,14.090909090909092
360,433,0,17818,6720849,12.027777777777779
180,247,0,17819,6721096,13.722222222222221
160,211,0,17820,6721307,13.1875
220,268,0,17821,6721575,12.181818181818182
230,309,0,17822,6721884,13.434782608695652
150,178,0,17823,6722062,11.866666666666667
260,400,0,17824,6722462,15.384615384615385
250,374,0,17825,6722836,14.96
330,468,0,17826,6723304,14.181818181818182
240,340,0,17827,6723644,14.166666666666666
310,477,0,17828,6724121,15.387096774193548
340,549,0,17829,6724670,16.147058823529413
150,211,0,17830,6724881,14.066666666666666
360,600,0,17831,6725481,16.666666666666668
340,623,0,17832,6726104,18.323529411764707
150,184,0,17833,6726288,12.266666666666667
280,456,0,17834,6726744,16.285714285714285
420,566,0,17835,6727310,13.476190476190476
230,326,0,17836,6727636,14.173913043478262
150,184,0,17837,6727820,12.266666666666667
380,547,0,17838,6728367,14.394736842105264
260,401,0,17839,6728768,15.423076923076923
280,445,0,17840,6729213,15.892857142857142
410,651,0,17841,6729864,15.878048780487806
260,366,0,17842,6730230,14.076923076923077
290,414,0,17843,6730644,14.275862068965518
280,397,0,17844,6731041,14.178571428571429
220,293,0,17845,6731334,13.318181818181818
450,670,0,17846,6732004,14.88888888888889
210,285,0,17847,6732289,13.571428571428571
330,517,0,17848,6732806,15.666666666666666
330,552,0,17849,6733358,16.727272727272727
250,387,0,17850,6733745,15.48
80,87,0,17851,6733832,10.875
200,244,0,17852,6734076,12.2
240,380,0,17853,6734456,15.833333333333334
410,642,0,17854,6735098,15.658536585365853
90,86,0,17855,6735184,9.555555555555555
150,226,0,17856,6735410,15.066666666666666
290,389,0,17857,6735799,13.413793103448276
440,739,0,17858,6736538,16.795454545454547
320,456,0,17859,6736994,14.25
160,197,0,17860,6737191,12.3125
220,297,0,17861,6737488,13.5
200,236,0,17862,6737724,11.8
380,661,0,17863,6738385,17.394736842105264
220,317,0,17864,6738702,14.409090909090908
80,88,0,17865,6738790,11.0
220,310,0,17866,6739100,14.090909090909092
340,512,0,17867,6739612,15.058823529411764
140,132,0,17868,6739744,9.428571428571429
120,128,0,17869,6739872,10.666666666666666
300,477,0,17870,6740349,15.9
300,425,0,17871,6740774,14.166666666666666
140,231,0,17872,6741005,16.5
170,197,0,17873,6741202,11.588235294117647
240,301,0,17874,6741503,12.541666666666666
290,440,0,17875,6741943,15.172413793103448
460,636,0,17876,6742579,13.826086956521738
440,655,0,17877,6743234,14.886363636363637
190,284,0,17878,6743518,14.947368421052632
180,246,0,17879,6743764,13.666666666666666
530,1025,0,17880,6744789,19.339622641509433
270,468,0,17881,6745257,17.333333333333332
400,677,0,17882,6745934,16.925
90,87,0,17883,6746021,9.666666666666666
130,241,0,17884,6746262,18.53846153846154
300,526,0,17885,6746788,17.533333333333335
290,412,0,17886,6747200,14.206896551724139
230,303,0,17887,6747503,13.173913043478262
350,538,0,17888,6748041,15.371428571428572
310,433,0,17889,6748474,13.96774193548387
260,445,0,17890,6748919,17.115384615384617
430,605,0,17891,6749524,14.069767441860465
210,285,0,17892,6749809,13.571428571428571
210,270,0,17893,6750079,12.857142857142858
240,330,0,17894,6750409,13.75
250,349,0,17895,6750758,13.96
360,509,0,17896,6751267,14.13888888888889
310,425,0,17897,6751692,13.709677419354838
120,129,0,17898,6751821,10.75
500,790,0,17899,6752611,15.8
220,332,0,17900,6752943,15.090909090909092
120,158,0,17901,6753101,13.166666666666666
390,620,0,17902,6753721,15.897435897435898
330,539,0,17903,6754260,16.333333333333332
280,371,0,17904,6754631,13.25
380,715,0,17905,6755346,18.81578947368421
140,161,0,17906,6755507,11.5
270,345,0,17907,6755852,12.777777777777779
300,468,0,17908,6756320,15.6
310,385,0,17909,6756705,12.419354838709678
210,288,0,17910,6756993,13.714285714285714
230,391,0,17911,6757384,17.0
440,530,0,17912,6757914,12.045454545454545
130,153,0,17913,6758067,11.76923076923077
240,333,0,17914,6758400,13.875
110,127,0,17915,6758527,11.545454545454545
150,209,0,17916,6758736,13.933333333333334
250,357,0,17917,6759093,14.28
380,618,0,17918,6759711,16.263157894736842
330,542,0,17919,6760253,16.424242424242426
130,165,0,17920,6760418,12.692307692307692
180,205,0,17921,6760623,11.38888888888889
160,234,0,17922,6760857,14.625
470,766,0,17923,6761623,16.29787234042553
350,531,0,17924,6762154,15.17142857142857
260,400,0,17925,6762554,15.384615384615385
120,151,0,17926,6762705,12.583333333333334
300,467,0,17927,6763172,15.566666666666666
300,418,0,17928,6763590,13.933333333333334
300,468,0,17929,6764058,15.6
200,323,0,17930,6764381,16.15
160,199,0,17931,6764580,12.4375
360,530,0,17932,6765110,14.722222222222221
240,337,0,17933,6765447,14.041666666666666
390,555,0,17934,6766002,14.23076923076923
60,63,0,17935,6766065,10.5
210,339,0,17936,6766404,16.142857142857142
180,264,0,17937,6766668,14.666666666666666
310,480,0,17938,6767148,15.483870967741936
320,499,0,17939,6767647,15.59375
300,442,0,17940,6768089,14.733333333333333
260,422,0,17941,6768511,16.23076923076923
280,397,0,17942,6768908,14.178571428571429
180,183,0,17943,6769091,10.166666666666666
300,454,0,17944,6769545,15.133333333333333
270,422,0,17945,6769967,15.62962962962963
350,491,0,17946,6770458,14.028571428571428
230,394,0,17947,6770852,17.130434782608695
110,156,0,17948,6771008,14.181818181818182
130,179,0,17949,6771187,13.76923076923077
340,488,0,17950,6771675,14.352941176470589
330,535,0,17951,6772210,16.21212121212121
170,221,0,17952,6772431,13.0
230,327,0,17953,6772758,14.217391304347826
90,114,0,17954,6772872,12.666666666666666
190,266,0,17955,6773138,14.0
220,265,0,17956,6773403,12.045454545454545
270,475,0,17957,6773878,17.59259259259259
180,284,0,17958,6774162,15.777777777777779
180,309,0,17959,6774471,17.166666666666668
300,460,0,17960,6774931,15.333333333333334
230,293,0,17961,6775224,12.73913043478261
160,233,0,17962,6775457,14.5625
200,297,0,17963,6775754,14.85
180,234,0,17964,6775988,13.0
220,300,0,17965,6776288,13.636363636363637
210,324,0,17966,6776612,15.428571428571429
540,864,0,17967,6777476,16.0
270,428,0,17968,6777904,15.851851851851851
320,476,0,17969,6778380,14.875
120,165,0,17970,6778545,13.75
210,268,0,17971,6778813,12.761904761904763
180,271,0,17972,6779084,15.055555555555555
120,159,0,17973,6779243,13.25
340,502,0,17974,6779745,14.764705882352942
250,417,0,17975,6780162,16.68
240,347,0,17976,6780509,14.458333333333334
270,380,0,17977,6780889,14.074074074074074
260,403,0,17978,6781292,15.5
300,450,0,17979,6781742,15.0
280,475,0,17980,6782217,16.964285714285715
260,348,0,17981,6782565,13.384615384615385
370,584,0,17982,6783149,15.783783783783784
170,163,0,17983,6783312,9.588235294117647
260,398,0,17984,6783710,15.307692307692308
220,309,0,17985,6784019,14.045454545454545
220,357,0,17986,6784376,16.227272727272727
260,426,0,17987,6784802,16.384615384615383
350,571,0,17988,6785373,16.314285714285713
260,395,0,17989,6785768,15.192307692307692
130,217,0,17990,6785985,16.692307692307693
290,457,0,17991,6786442,15.758620689655173
120,188,0,17992,6786630,15.666666666666666
220,333,0,17993,6786963,15.136363636363637
370,445,0,17994,6787408,12.027027027027026
140,223,0,17995,6787631,15.928571428571429
240,270,0,17996,6787901,11.25
310,466,0,17997,6788367,15.03225806451613
120,160,0,17998,6788527,13.333333333333334
270,367,0,17999,6788894,13.592592592592593
190,265,0,18000,6789159,13.947368421052632
230,356,0,18001,6789515,15.478260869565217
380,571,0,18002,6790086,15.026315789473685
290,414,0,18003,6790500,14.275862068965518
260,390,0,18004,6790890,15.0
310,586,0,18005,6791476,18.903225806451612
220,274,0,18006,6791750,12.454545454545455
210,293,0,18007,6792043,13.952380952380953
140,190,0,18008,6792233,13.571428571428571
280,381,0,18009,6792614,13.607142857142858
160,218,0,18010,6792832,13.625
280,432,0,18011,6793264,15.428571428571429
140,171,0,18012,6793435,12.214285714285714
200,318,0,18013,6793753,15.9
210,337,0,18014,6794090,16.047619047619047
330,515,0,18015,6794605,15.606060606060606
270,432,0,18016,6795037,16.0
250,349,0,18017,6795386,13.96
380,607,0,18018,6795993,15.973684210526315
370,645,0,18019,6796638,17.43243243243243
280,353,0,18020,6796991,12.607142857142858
320,423,0,18021,6797414,13.21875
170,226,0,18022,6797640,13.294117647058824
290,398,0,18023,6798038,13.724137931034482
320,535,0,18024,6798573,16.71875
250,466,0,18025,6799039,18.64
150,202,0,18026,6799241,13.466666666666667
450,739,0,18027,6799980,16.42222222222222
390,590,0,18028,6800570,15.128205128205128
120,182,0,18029,6800752,15.166666666666666
260,388,0,18030,6801140,14.923076923076923
200,233,0,18031,6801373,11.65
300,390,0,18032,6801763,13.0
170,256,0,18033,6802019,15.058823529411764
210,257,0,18034,6802276,12.238095238095237
240,346,0,18035,6802622,14.416666666666666
280,461,0,18036,6803083,16.464285714285715
370,573,0,18037,6803656,15.486486486486486
100,151,0,18038,6803807,15.1
350,515,0,18039,6804322,14.714285714285714
200,260,0,18040,6804582,13.0
290,424,0,18041,6805006,14.620689655172415
320,449,0,18042,6805455,14.03125
190,251,0,18043,6805706,13.210526315789474
390,633,0,18044,6806339,16.23076923076923
70,89,0,18045,6806428,12.714285714285714
200,255,0,18046,6806683,12.75
160,225,0,18047,6806908,14.0625
90,148,0,18048,6807056,16.444444444444443
350,543,0,18049,6807599,15.514285714285714
130,141,0,18050,6807740,10.846153846153847
220,313,0,18051,6808053,14.227272727272727
220,231,0,18052,6808284,10.5
280,446,0,18053,6808730,15.928571428571429
180,242,0,18054,6808972,13.444444444444445
490,669,0,18055,6809641,13.653061224489797
140,134,0,18056,6809775,9.571428571428571
360,535,0,18057,6810310,14.86111111111111
370,546,0,18058,6810856,14.756756756756756
350,641,0,18059,6811497,18.314285714285713
260,366,0,18060,6811863,14.076923076923077
190,292,0,18061,6812155,15.368421052631579
220,298,0,18062,6812453,13.545454545454545
370,618,0,18063,6813071,16.7027027027027
270,401,0,18064,6813472,14.851851851851851
180,275,0,18065,6813747,15.277777777777779
300,480,0,18066,6814227,16.0
370,542,0,18067,6814769,14.64864864864865
350,505,0,18068,6815274,14.428571428571429
260,367,0,18069,6815641,14.115384615384615
220,318,0,18070,6815959,14.454545454545455
190,256,0,18071,6816215,13.473684210526315
110,163,0,18072,6816378,14.818181818181818
330,617,0,18073,6816995,18.696969696969695
590,987,0,18074,6817982,16.728813559322035
250,325,0,18075,6818307,13.0
170,235,0,18076,6818542,13.823529411764707
310,489,0,18077,6819031,15.774193548387096
150,155,0,18078,6819186,10.333333333333334
190,284,0,18079,6819470,14.947368421052632
310,396,0,18080,6819866,12.774193548387096
370,559,0,18081,6820425,15.108108108108109
250,314,0,18082,6820739,12.56
120,178,0,18083,6820917,14.833333333333334
250,348,0,18084,6821265,13.92
110,134,0,18085,6821399,12.181818181818182
160,191,0,18086,6821590,11.9375
260,390,0,18087,6821980,15.0
410,593,0,18088,6822573,14.463414634146341
160,218,0,18089,6822791,13.625
270,372,0,18090,6823163,13.777777777777779
320,477,0,18091,6823640,14.90625
70,141,0,18092,6823781,20.142857142857142
410,587,0,18093,6824368,14.317073170731707
450,809,0,18094,6825177,17.977777777777778
230,261,0,18095,6825438,11.347826086956522
230,358,0,18096,6825796,15.565217391304348
140,112,0,18097,6825908,8.0
380,540,0,18098,6826448,14.210526315789474
200,275,0,18099,6826723,13.75
210,332,0,18100,6827055,15.80952380952381
100,124,0,18101,6827179,12.4
410,659,0,18102,6827838,16.073170731707318
290,388,0,18103,6828226,13.379310344827585
240,374,0,18104,6828600,15.583333333333334
310,470,0,18105,6829070,15.161290322580646
280,356,0,18106,6829426,12.714285714285714
180,249,0,18107,6829675,13.833333333333334
280,410,0,18108,6830085,14.642857142857142
270,439,0,18109,6830524,16.25925925925926
220,316,0,18110,6830840,14.363636363636363
310,457,0,18111,6831297,14.741935483870968
180,314,0,18112,6831611,17.444444444444443
210,306,0,18113,6831917,14.571428571428571
190,285,0,18114,6832202,15.0
270,378,0,18115,6832580,14.0
80,130,0,18116,6832710,16.25
190,293,0,18117,6833003,15.421052631578947
190,269,0,18118,6833272,14.157894736842104
290,476,0,18119,6833748,16.413793103448278
60,76,0,18120,6833824,12.666666666666666
410,488,0,18121,6834312,11.902439024390244
300,443,0,18122,6834755,14.766666666666667
260,382,0,18123,6835137,14.692307692307692
220,343,0,18124,6835480,15.590909090909092
230,310,0,18125,6835790,13.478260869565217
200,241,0,18126,6836031,12.05
420,625,0,18127,6836656,14.880952380952381
340,563,0,18128,6837219,16.558823529411764
260,418,0,18129,6837637,16.076923076923077
280,412,0,18130,6838049,14.714285714285714
200,308,0,18131,6838357,15.4
360,626,0,18132,6838983,17.38888888888889
150,184,0,18133,6839167,12.266666666666667
250,379,0,18134,6839546,15.16
150,230,0,18135,6839776,15.333333333333334
150,210,0,18136,6839986,14.0
180,251,0,18137,6840237,13.944444444444445
150,205,0,18138,6840442,13.666666666666666
350,504,0,18139,6840946,14.4
90,116,0,18140,6841062,12.88888888888889
130,129,0,18141,6841191,9.923076923076923
290,476,0,18142,6841667,16.413793103448278
180,276,0,18143,6841943,15.333333333333334
120,153,0,18144,6842096,12.75
110,160,0,18145,6842256,14.545454545454545
240,396,0,18146,6842652,16.5
170,222,0,18147,6842874,13.058823529411764
250,291,0,18148,6843165,11.64
250,344,0,18149,6843509,13.76
270,438,0,18150,6843947,16.22222222222222
260,362,0,18151,6844309,13.923076923076923
430,670,0,18152,6844979,15.581395348837209
110,126,0,18153,6845105,11.454545454545455
230,373,0,18154,6845478,16.217391304347824
160,207,0,18155,6845685,12.9375
280,372,0,18156,6846057,13.285714285714286
330,576,0,18157,6846633,17.454545454545453
260,381,0,18158,6847014,14.653846153846153
220,310,0,18159,6847324,14.090909090909092
340,517,0,18160,6847841,15.205882352941176
270,361,0,18161,6848202,13.37037037037037
240,324,0,18162,6848526,13.5
190,307,0,18163,6848833,16.157894736842106
380,595,0,18164,6849428,15.657894736842104
140,237,0,18165,6849665,16.928571428571427
300,530,0,18166,6850195,17.666666666666668
290,428,0,18167,6850623,14.758620689655173
260,372,0,18168,6850995,14.307692307692308
340,495,0,18169,6851490,14.558823529411764
320,455,0,18170,6851945,14.21875
190,290,0,18171,6852235,15.263157894736842
290,558,0,18172,6852793,19.24137931034483
380,616,0,18173,6853409,16.210526315789473
200,328,0,18174,6853737,16.4
190,284,0,18175,6854021,14.947368421052632
310,449,0,18176,6854470,14.483870967741936
130,175,0,18177,6854645,13.461538461538462
210,291,0,18178,6854936,13.857142857142858
70,104,0,18179,6855040,14.857142857142858
110,191,0,18180,6855231,17.363636363636363
340,463,0,18181,6855694,13.617647058823529
260,361,0,18182,6856055,13.884615384615385
350,551,0,18183,6856606,15.742857142857142
270,360,0,18184,6856966,13.333333333333334
480,709,0,18185,6857675,14.770833333333334
260,426,0,18186,6858101,16.384615384615383
430,757,0,18187,6858858,17.6046511627907
240,304,0,18188,6859162,12.666666666666666
310,469,0,18189,6859631,15.129032258064516
460,759,0,18190,6860390,16.5
310,452,0,18191,6860842,14.580645161290322
280,413,0,18192,6861255,14.75
140,180,0,18193,6861435,12.857142857142858
120,149,0,18194,6861584,12.416666666666666
400,668,0,18195,6862252,16.7
230,233,0,18196,6862485,10.130434782608695
270,397,0,18197,6862882,14.703703703703704
170,241,0,18198,6863123,14.176470588235293
100,135,0,18199,6863258,13.5
70,89,0,18200,6863347,12.714285714285714
280,422,0,18201,6863769,15.071428571428571
310,480,0,18202,6864249,15.483870967741936
220,285,0,18203,6864534,12.954545454545455
130,247,0,18204,6864781,19.0
270,378,0,18205,6865159,14.0
180,269,0,18206,6865428,14.944444444444445
40,56,0,18207,6865484,14.0
240,304,0,18208,6865788,12.666666666666666
280,409,0,18209,6866197,14.607142857142858
360,578,0,18210,6866775,16.055555555555557
200,231,0,18211,6867006,11.55
90,134,0,18212,6867140,14.88888888888889
180,279,0,18213,6867419,15.5
220,231,0,18214,6867650,10.5
300,392,0,18215,6868042,13.066666666666666
150,227,0,18216,6868269,15.133333333333333
200,279,0,18217,6868548,13.95
130,184,0,18218,6868732,14.153846153846153
290,464,0,18219,6869196,16.0
390,740,0,18220,6869936,18.974358974358974
190,252,0,18221,6870188,13.263157894736842
290,407,0,18222,6870595,14.03448275862069
210,281,0,18223,6870876,13.380952380952381
170,265,0,18224,6871141,15.588235294117647
160,203,0,18225,6871344,12.6875
300,382,0,18226,6871726,12.733333333333333
310,574,0,18227,6872300,18.516129032258064
120,141,0,18228,6872441,11.75
300,459,0,18229,6872900,15.3
150,199,0,18230,6873099,13.266666666666667
330,512,0,18231,6873611,15.515151515151516
210,301,0,18232,6873912,14.333333333333334
220,329,0,18233,6874241,14.954545454545455
410,609,0,18234,6874850,14.853658536585366
130,188,0,18235,6875038,14.461538461538462
500,769,0,18236,6875807,15.38
480,831,0,18237,6876638,17.3125
260,452,0,18238,6877090,17.384615384615383
260,391,0,18239,6877481,15.038461538461538
220,307,0,18240,6877788,13.954545454545455
260,356,0,18241,6878144,13.692307692307692
230,364,0,18242,6878508,15.826086956521738
250,372,0,18243,6878880,14.88
340,540,0,18244,6879420,15.882352941176471
200,197,0,18245,6879617,9.85
210,343,0,18246,6879960,16.333333333333332
230,357,0,18247,6880317,15.521739130434783
300,424,0,18248,6880741,14.133333333333333
310,497,0,18249,6881238,16.032258064516128
200,338,0,18250,6881576,16.9
190,239,0,18251,6881815,12.578947368421053
110,167,0,18252,6881982,15.181818181818182
310,455,0,18253,6882437,14.67741935483871
290,469,0,18254,6882906,16.17241379310345
100,126,0,18255,6883032,12.6
150,205,0,18256,6883237,13.666666666666666
400,512,0,18257,6883749,12.8
390,617,0,18258,6884366,15.820512820512821
190,277,0,18259,6884643,14.578947368421053
180,269,0,18260,6884912,14.944444444444445
470,648,0,18261,6885560,13.787234042553191
610,1115,0,18262,6886675,18.278688524590162
200,255,0,18263,6886930,12.75
260,344,0,18264,6887274,13.23076923076923
190,249,0,18265,6887523,13.105263157894736
460,833,0,18266,6888356,18.108695652173914
290,374,0,18267,6888730,12.89655172413793
220,353,0,18268,6889083,16.045454545454547
210,262,0,18269,6889345,12.476190476190476
330,525,0,18270,6889870,15.909090909090908
290,414,0,18271,6890284,14.275862068965518
190,250,0,18272,6890534,13.157894736842104
270,409,0,18273,6890943,15.148148148148149
240,365,0,18274,6891308,15.208333333333334
250,380,0,18275,6891688,15.2
170,226,0,18276,6891914,13.294117647058824
280,381,0,18277,6892295,13.607142857142858
270,415,0,18278,6892710,15.37037037037037
180,225,0,18279,6892935,12.5
200,309,0,18280,6893244,15.45
240,361,0,18281,6893605,15.041666666666666
230,305,0,18282,6893910,13.26086956521739
400,616,0,18283,6894526,15.4
80,123,0,18284,6894649,15.375
240,414,0,18285,6895063,17.25
220,353,0,18286,6895416,16.045454545454547
150,221,0,18287,6895637,14.733333333333333
250,281,0,18288,6895918,11.24
340,524,0,18289,6896442,15.411764705882353
330,512,0,18290,6896954,15.515151515151516
280,473,0,18291,6897427,16.892857142857142
160,211,0,18292,6897638,13.1875
130,129,0,18293,6897767,9.923076923076923
320,582,0,18294,6898349,18.1875
170,254,0,18295,6898603,14.941176470588236
110,129,0,18296,6898732,11.727272727272727
190,278,0,18297,6899010,14.631578947368421
220,294,0,18298,6899304,13.363636363636363
240,380,0,18299,6899684,15.833333333333334
300,417,0,18300,6900101,13.9
340,567,0,18301,6900668,16.676470588235293
130,175,0,18302,6900843,13.461538461538462
210,315,0,18303,6901158,15.0
60,99,0,18304,6901257,16.5
270,425,0,18305,6901682,15.74074074074074
300,517,0,18306,6902199,17.233333333333334
310,356,0,18307,6902555,11.483870967741936
420,656,0,18308,6903211,15.619047619047619
160,219,0,18309,6903430,13.6875
620,1101,0,18310,6904531,17.758064516129032
140,204,0,18311,6904735,14.571428571428571
240,360,0,18312,6905095,15.0
210,334,0,18313,6905429,15.904761904761905
150,218,0,18314,6905647,14.533333333333333
280,448,0,18315,6906095,16.0
190,319,0,18316,6906414,16.789473684210527
340,505,0,18317,6906919,14.852941176470589
260,317,0,18318,6907236,12.192307692307692
130,170,0,18319,6907406,13.076923076923077
370,630,0,18320,6908036,17.027027027027028
280,402,0,18321,6908438,14.357142857142858
150,214,0,18322,6908652,14.266666666666667
220,242,0,18323,6908894,11.0
470,795,0,18324,6909689,16.914893617021278
360,532,0,18325,6910221,14.777777777777779
190,246,0,18326,6910467,12.947368421052632
180,218,0,18327,6910685,12.11111111111111
280,403,0,18328,6911088,14.392857142857142
250,420,0,18329,6911508,16.8
280,476,0,18330,6911984,17.0
280,349,0,18331,6912333,12.464285714285714
240,393,0,18332,6912726,16.375
210,271,0,18333,6912997,12.904761904761905
150,179,0,18334,6913176,11.933333333333334
80,119,0,18335,6913295,14.875
160,187,0,18336,6913482,11.6875
240,303,0,18337,6913785,12.625
220,282,0,18338,6914067,12.818181818181818
380,609,0,18339,6914676,16.026315789473685
410,569,0,18340,6915245,13.878048780487806
170,214,0,18341,6915459,12.588235294117647
270,305,0,18342,6915764,11.296296296296296
270,354,0,18343,6916118,13.11111111111111
300,434,0,18344,6916552,14.466666666666667
270,485,0,18345,6917037,17.962962962962962
180,262,0,18346,6917299,14.555555555555555
260,420,0,18347,6917719,16.153846153846153
200,266,0,18348,6917985,13.3
310,400,0,18349,6918385,12.903225806451612
310,465,0,18350,6918850,15.0
410,656,0,18351,6919506,16.0
210,326,0,18352,6919832,15.523809523809524
200,227,0,18353,6920059,11.35
340,581,0,18354,6920640,17.08823529411765
180,225,0,18355,6920865,12.5
310,540,0,18356,6921405,17.419354838709676
190,274,0,18357,6921679,14.421052631578947
360,532,0,18358,6922211,14.777777777777779
290,497,0,18359,6922708,17.137931034482758
290,478,0,18360,6923186,16.482758620689655
170,344,0,18361,6923530,20.235294117647058
120,144,0,18362,6923674,12.0
150,224,0,18363,6923898,14.933333333333334
360,494,0,18364,6924392,13.722222222222221
400,624,0,18365,6925016,15.6
160,265,0,18366,6925281,16.5625
290,380,0,18367,6925661,13.10344827586207
270,426,0,18368,6926087,15.777777777777779
280,381,0,18369,6926468,13.607142857142858
350,564,0,18370,6927032,16.114285714285714
200,283,0,18371,6927315,14.15
340,647,0,18372,6927962,19.029411764705884
240,324,0,18373,6928286,13.5
370,547,0,18374,6928833,14.783783783783784
180,229,0,18375,6929062,12.722222222222221
220,328,0,18376,6929390,14.909090909090908
250,404,0,18377,6929794,16.16
410,652,0,18378,6930446,15.902439024390244
190,260,0,18379,6930706,13.68421052631579
150,169,0,18380,6930875,11.266666666666667
210,282,0,18381,6931157,13.428571428571429
180,273,0,18382,6931430,15.166666666666666
360,596,0,18383,6932026,16.555555555555557
220,277,0,18384,6932303,12.590909090909092
300,410,0,18385,6932713,13.666666666666666
390,569,0,18386,6933282,14.58974358974359
380,564,0,18387,6933846,14.842105263157896
160,258,0,18388,6934104,16.125
180,280,0,18389,6934384,15.555555555555555
400,572,0,18390,6934956,14.3
140,183,0,18391,6935139,13.071428571428571
400,650,0,18392,6935789,16.25
260,377,0,18393,6936166,14.5
160,167,0,18394,6936333,10.4375
230,320,0,18395,6936653,13.91304347826087
160,291,0,18396,6936944,18.1875
330,401,0,18397,6937345,12.151515151515152
260,330,0,18398,6937675,12.692307692307692
270,401,0,18399,6938076,14.851851851851851
220,321,0,18400,6938397,14.590909090909092
340,494,0,18401,6938891,14.529411764705882
300,412,0,18402,6939303,13.733333333333333
210,289,0,18403,6939592,13.761904761904763
410,649,0,18404,6940241,15.829268292682928
320,509,0,18405,6940750,15.90625
350,536,0,18406,6941286,15.314285714285715
200,255,0,18407,6941541,12.75
170,252,0,18408,6941793,14.823529411764707
170,207,0,18409,6942000,12.176470588235293
410,634,0,18410,6942634,15.463414634146341
370,635,0,18411,6943269,17.16216216216216
250,317,0,18412,6943586,12.68
270,396,0,18413,6943982,14.666666666666666
300,492,0,18414,6944474,16.4
160,201,0,18415,6944675,12.5625
420,664,0,18416,6945339,15.80952380952381
220,305,0,18417,6945644,13.863636363636363
210,328,0,18418,6945972,15.619047619047619
290,495,0,18419,6946467,17.06896551724138
210,266,0,18420,6946733,12.666666666666666
530,789,0,18421,6947522,14.88679245283019
270,367,0,18422,6947889,13.592592592592593
230,327,0,18423,6948216,14.217391304347826
110,135,0,18424,6948351,12.272727272727273
280,364,0,18425,6948715,13.0
90,91,0,18426,6948806,10.11111111111111
160,220,0,18427,6949026,13.75
180,264,0,18428,6949290,14.666666666666666
100,125,0,18429,6949415,12.5
150,158,0,18430,6949573,10.533333333333333
270,377,0,18431,6949950,13.962962962962964
90,93,0,18432,6950043,10.333333333333334
120,159,0,18433,6950202,13.25
330,497,0,18434,6950699,15.06060606060606
280,376,0,18435,6951075,13.428571428571429
180,220,0,18436,6951295,12.222222222222221
240,333,0,18437,6951628,13.875
140,192,0,18438,6951820,13.714285714285714
420,687,0,18439,6952507,16.357142857142858
350,602,0,18440,6953109,17.2
360,557,0,18441,6953666,15.472222222222221
260,272,0,18442,6953938,10.461538461538462
80,98,0,18443,6954036,12.25
230,314,0,18444,6954350,13.652173913043478
250,348,0,18445,6954698,13.92
260,414,0,18446,6955112,15.923076923076923
200,311,0,18447,6955423,15.55
250,413,0,18448,6955836,16.52
280,318,0,18449,6956154,11.357142857142858
130,202,0,18450,6956356,15.538461538461538
240,348,0,18451,6956704,14.5
390,615,0,18452,6957319,15.76923076923077
220,299,0,18453,6957618,13.590909090909092
320,508,0,18454,6958126,15.875
200,297,0,18455,6958423,14.85
160,169,0,18456,6958592,10.5625
390,546,0,18457,6959138,14.0
250,353,0,18458,6959491,14.12
220,310,0,18459,6959801,14.090909090909092
290,421,0,18460,6960222,14.517241379310345
210,284,0,18461,6960506,13.523809523809524
230,316,0,18462,6960822,13.73913043478261
130,172,0,18463,6960994,13.23076923076923
300,471,0,18464,6961465,15.7
260,356,0,18465,6961821,13.692307692307692
360,568,0,18466,6962389,15.777777777777779
190,281,0,18467,6962670,14.789473684210526
360,453,0,18468,6963123,12.583333333333334
130,178,0,18469,6963301,13.692307692307692
120,125,0,18470,6963426,10.416666666666666
300,402,0,18471,6963828,13.4
210,279,0,18472,6964107,13.285714285714286
260,407,0,18473,6964514,15.653846153846153
210,345,0,18474,6964859,16.428571428571427
220,314,0,18475,6965173,14.272727272727273
290,467,0,18476,6965640,16.103448275862068
200,265,0,18477,6965905,13.25
300,480,0,18478,6966385,16.0
190,220,0,18479,6966605,11.578947368421053
100,166,0,18480,6966771,16.6
200,311,0,18481,6967082,15.55
280,392,0,18482,6967474,14.0
280,388,0,18483,6967862,13.857142857142858
260,309,0,18484,6968171,11.884615384615385
290,382,0,18485,6968553,13.172413793103448
180,235,0,18486,6968788,13.055555555555555
190,293,0,18487,6969081,15.421052631578947
140,241,0,18488,6969322,17.214285714285715
230,326,0,18489,6969648,14.173913043478262
330,473,0,18490,6970121,14.333333333333334
200,350,0,18491,6970471,17.5
140,202,0,18492,6970673,14.428571428571429
220,312,0,18493,6970985,14.181818181818182
110,135,0,18494,6971120,12.272727272727273
290,404,0,18495,6971524,13.931034482758621
230,355,0,18496,6971879,15.434782608695652
410,588,0,18497,6972467,14.341463414634147
280,472,0,18498,6972939,16.857142857142858
190,289,0,18499,6973228,15.210526315789474
320,467,0,18500,6973695,14.59375
170,298,0,18501,6973993,17.529411764705884
120,180,0,18502,6974173,15.0
390,598,0,18503,6974771,15.333333333333334
250,344,0,18504,6975115,13.76
320,554,0,18505,6975669,17.3125
120,171,0,18506,6975840,14.25
230,371,0,18507,6976211,16.130434782608695
220,345,0,18508,6976556,15.681818181818182
180,271,0,18509,6976827,15.055555555555555
500,644,0,18510,6977471,12.88
150,204,0,18511,6977675,13.6
350,567,0,18512,6978242,16.2
250,374,0,18513,6978616,14.96
290,477,0,18514,6979093,16.448275862068964
240,377,0,18515,6979470,15.708333333333334
390,535,0,18516,6980005,13.717948717948717
360,576,0,18517,6980581,16.0
310,477,0,18518,6981058,15.387096774193548
260,363,0,18519,6981421,13.961538461538462
180,255,0,18520,6981676,14.166666666666666
470,768,0,18521,6982444,16.340425531914892
270,407,0,18522,6982851,15.074074074074074
620,997,0,18523,6983848,16.080645161290324
240,394,0,18524,6984242,16.416666666666668
350,523,0,18525,6984765,14.942857142857143
260,420,0,18526,6985185,16.153846153846153
140,186,0,18527,6985371,13.285714285714286
170,223,0,18528,6985594,13.117647058823529
190,223,0,18529,6985817,11.736842105263158
170,197,0,18530,6986014,11.588235294117647
270,448,0,18531,6986462,16.59259259259259
360,528,0,18532,6986990,14.666666666666666
260,388,0,18533,6987378,14.923076923076923
240,338,0,18534,6987716,14.083333333333334
210,309,0,18535,6988025,14.714285714285714
220,374,0,18536,6988399,17.0
310,437,0,18537,6988836,14.096774193548388
140,173,0,18538,6989009,12.357142857142858
200,255,0,18539,6989264,12.75
120,130,0,18540,6989394,10.833333333333334
320,466,0,18541,6989860,14.5625
440,645,0,18542,6990505,14.659090909090908
240,358,0,18543,6990863,14.916666666666666
290,461,0,18544,6991324,15.89655172413793
290,396,0,18545,6991720,13.655172413793103
260,324,0,18546,6992044,12.461538461538462
180,269,0,18547,6992313,14.944444444444445
250,326,0,18548,6992639,13.04
450,680,0,18549,6993319,15.11111111111111
140,219,0,18550,6993538,15.642857142857142
170,182,0,18551,6993720,10.705882352941176
290,434,0,18552,6994154,14.96551724137931
160,233,0,18553,6994387,14.5625
180,265,0,18554,6994652,14.722222222222221
320,538,0,18555,6995190,16.8125
60,86,0,18556,6995276,14.333333333333334
270,343,0,18557,6995619,12.703703703703704
510,900,0,18558,6996519,17.647058823529413
570,1011,0,18559,6997530,17.736842105263158
120,158,0,18560,6997688,13.166666666666666
450,729,0,18561,6998417,16.2
90,125,0,18562,6998542,13.88888888888889
260,358,0,18563,6998900,13.76923076923077
250,355,0,18564,6999255,14.2
220,360,0,18565,6999615,16.363636363636363
270,387,0,18566,7000002,14.333333333333334
220,371,0,18567,7000373,16.863636363636363
420,614,0,18568,7000987,14.619047619047619
260,332,0,18569,7001319,12.76923076923077
110,169,0,18570,7001488,15.363636363636363
280,424,0,18571,7001912,15.142857142857142
160,244,0,18572,7002156,15.25
290,445,0,18573,7002601,15.344827586206897
260,479,0,18574,7003080,18.423076923076923
240,392,0,18575,7003472,16.333333333333332
190,243,0,18576,7003715,12.789473684210526
190,288,0,18577,7004003,15.157894736842104
160,189,0,18578,7004192,11.8125
310,601,0,18579,7004793,19.387096774193548
210,267,0,18580,7005060,12.714285714285714
140,209,0,18581,7005269,14.928571428571429
390,625,0,18582,7005894,16.025641025641026
170,263,0,18583,7006157,15.470588235294118
310,458,0,18584,7006615,14.774193548387096
130,138,0,18585,7006753,10.615384615384615
190,213,0,18586,7006966,11.210526315789474
190,170,0,18587,7007136,8.947368421052632
370,671,0,18588,7007807,18.135135135135137
340,523,0,18589,7008330,15.382352941176471
180,260,0,18590,7008590,14.444444444444445
280,399,0,18591,7008989,14.25
240,319,0,18592,7009308,13.291666666666666
230,308,0,18593,7009616,13.391304347826088
250,348,0,18594,7009964,13.92
200,225,0,18595,7010189,11.25
290,507,0,18596,7010696,17.482758620689655
170,271,0,18597,7010967,15.941176470588236
280,435,0,18598,7011402,15.535714285714286
130,162,0,18599,7011564,12.461538461538462
360,531,0,18600,7012095,14.75
210,293,0,18601,7012388,13.952380952380953
190,241,0,18602,7012629,12.68421052631579
320,403,0,18603,7013032,12.59375
170,269,0,18604,7013301,15.823529411764707
200,298,0,18605,7013599,14.9
310,482,0,18606,7014081,15.548387096774194
180,248,0,18607,7014329,13.777777777777779
220,314,0,18608,7014643,14.272727272727273
210,353,0,18609,7014996,16.80952380952381
370,600,0,18610,7015596,16.216216216216218
180,267,0,18611,7015863,14.833333333333334
410,614,0,18612,7016477,14.975609756097562
290,460,0,18613,7016937,15.862068965517242
340,571,0,18614,7017508,16.794117647058822
380,561,0,18615,7018069,14.763157894736842
220,271,0,18616,7018340,12.318181818181818
70,88,0,18617,7018428,12.571428571428571
190,246,0,18618,7018674,12.947368421052632
320,473,0,18619,7019147,14.78125
140,161,0,18620,7019308,11.5
350,530,0,18621,7019838,15.142857142857142
210,376,0,18622,7020214,17.904761904761905
230,361,0,18623,7020575,15.695652173913043
200,293,0,18624,7020868,14.65
460,692,0,18625,7021560,15.043478260869565
200,310,0,18626,7021870,15.5
330,536,0,18627,7022406,16.242424242424242
290,400,0,18628,7022806,13.793103448275861
370,586,0,18629,7023392,15.837837837837839
200,309,0,18630,7023701,15.45
210,256,0,18631,7023957,12.19047619047619
250,372,0,18632,7024329,14.88
380,570,0,18633,7024899,15.0
80,93,0,18634,7024992,11.625
420,737,0,18635,7025729,17.547619047619047
120,235,0,18636,7025964,19.583333333333332
180,296,0,18637,7026260,16.444444444444443
370,462,0,18638,7026722,12.486486486486486
220,284,0,18639,7027006,12.909090909090908
90,93,0,18640,7027099,10.333333333333334
300,502,0,18641,7027601,16.733333333333334
390,672,0,18642,7028273,17.23076923076923
190,250,0,18643,7028523,13.157894736842104
190,276,0,18644,7028799,14.526315789473685
110,160,0,18645,7028959,14.545454545454545
110,185,0,18646,7029144,16.818181818181817
160,234,0,18647,7029378,14.625
150,192,0,18648,7029570,12.8
280,365,0,18649,7029935,13.035714285714286
250,372,0,18650,7030307,14.88
120,175,0,18651,7030482,14.583333333333334
400,523,0,18652,7031005,13.075
310,481,0,18653,7031486,15.516129032258064
180,316,0,18654,7031802,17.555555555555557
100,118,0,18655,7031920,11.8
310,443,0,18656,7032363,14.290322580645162
250,330,0,18657,7032693,13.2
290,439,0,18658,7033132,15.137931034482758
220,330,0,18659,7033462,15.0
390,548,0,18660,7034010,14.051282051282051
300,445,0,18661,7034455,14.833333333333334
250,314,0,18662,7034769,12.56
240,287,0,18663,7035056,11.958333333333334
80,78,0,18664,7035134,9.75
240,405,0,18665,7035539,16.875
150,245,0,18666,7035784,16.333333333333332
420,600,0,18667,7036384,14.285714285714286
170,285,0,18668,7036669,16.764705882352942
290,458,0,18669,7037127,15.793103448275861
150,216,0,18670,7037343,14.4
290,324,0,18671,7037667,11.172413793103448
310,514,0,18672,7038181,16.580645161290324
250,382,0,18673,7038563,15.28
170,237,0,18674,7038800,13.941176470588236
440,849,0,18675,7039649,19.295454545454547
180,310,0,18676,7039959,17.22222222222222
320,393,0,18677,7040352,12.28125
220,263,0,18678,7040615,11.954545454545455
320,398,0,18679,7041013,12.4375
170,209,0,18680,7041222,12.294117647058824
430,689,0,18681,7041911,16.023255813953487
200,294,0,18682,7042205,14.7
270,307,0,18683,7042512,11.37037037037037
200,300,0,18684,7042812,15.0
320,455,0,18685,7043267,14.21875
290,434,0,18686,7043701,14.96551724137931
230,321,0,18687,7044022,13.956521739130435
170,238,0,18688,7044260,14.0
550,894,0,18689,7045154,16.254545454545454
370,622,0,18690,7045776,16.81081081081081
370,621,0,18691,7046397,16.783783783783782
350,447,0,18692,7046844,12.771428571428572
240,355,0,18693,7047199,14.791666666666666
250,309,0,18694,7047508,12.36
220,373,0,18695,7047881,16.954545454545453
190,267,0,18696,7048148,14.052631578947368
400,645,0,18697,7048793,16.125
180,240,0,18698,7049033,13.333333333333334
360,531,0,18699,7049564,14.75
360,669,0,18700,7050233,18.583333333333332
400,622,0,18701,7050855,15.55
180,219,0,18702,7051074,12.166666666666666
210,303,0,18703,7051377,14.428571428571429
230,298,0,18704,7051675,12.956521739130435
320,381,0,18705,7052056,11.90625
290,495,0,18706,7052551,17.06896551724138
190,275,0,18707,7052826,14.473684210526315
290,432,0,18708,7053258,14.89655172413793
330,484,0,18709,7053742,14.666666666666666
240,344,0,18710,7054086,14.333333333333334
330,486,0,18711,7054572,14.727272727272727
240,335,0,18712,7054907,13.958333333333334
300,464,0,18713,7055371,15.466666666666667
210,334,0,18714,7055705,15.904761904761905
330,442,0,18715,7056147,13.393939393939394
400,617,0,18716,7056764,15.425
220,339,0,18717,7057103,15.409090909090908
230,279,0,18718,7057382,12.130434782608695
290,448,0,18719,7057830,15.448275862068966
170,256,0,18720,7058086,15.058823529411764
280,343,0,18721,7058429,12.25
210,293,0,18722,7058722,13.952380952380953
170,194,0,18723,7058916,11.411764705882353
330,502,0,18724,7059418,15.212121212121213
320,455,0,18725,7059873,14.21875
220,368,0,18726,7060241,16.727272727272727
250,299,0,18727,7060540,11.96
290,406,0,18728,7060946,14.0
350,476,0,18729,7061422,13.6
130,177,0,18730,7061599,13.615384615384615
380,530,0,18731,7062129,13.947368421052632
240,307,0,18732,7062436,12.791666666666666
150,209,0,18733,7062645,13.933333333333334
240,382,0,18734,7063027,15.916666666666666
350,470,0,18735,7063497,13.428571428571429
340,569,0,18736,7064066,16.735294117647058
260,422,0,18737,7064488,16.23076923076923
180,292,0,18738,7064780,16.22222222222222
410,638,0,18739,7065418,15.560975609756097
380,640,0,18740,7066058,16.842105263157894
300,442,0,18741,7066500,14.733333333333333
130,230,0,18742,7066730,17.692307692307693
230,305,0,18743,7067035,13.26086956521739
200,285,0,18744,7067320,14.25
300,496,0,18745,7067816,16.533333333333335
380,545,0,18746,7068361,14.342105263157896
130,144,0,18747,7068505,11.076923076923077
120,167,0,18748,7068672,13.916666666666666
160,243,0,18749,7068915,15.1875
370,602,0,18750,7069517,16.27027027027027
210,304,0,18751,7069821,14.476190476190476
100,109,0,18752,7069930,10.9
250,390,0,18753,7070320,15.6
270,422,0,18754,7070742,15.62962962962963
220,282,0,18755,7071024,12.818181818181818
260,362,0,18756,7071386,13.923076923076923
420,723,0,18757,7072109,17.214285714285715
350,602,0,18758,7072711,17.2
290,464,0,18759,7073175,16.0
270,412,0,18760,7073587,15.25925925925926
170,210,0,18761,7073797,12.352941176470589
260,392,0,18762,7074189,15.076923076923077
220,322,0,18763,7074511,14.636363636363637
210,314,0,18764,7074825,14.952380952380953
270,455,0,18765,7075280,16.85185185185185
310,455,0,18766,7075735,14.67741935483871
100,136,0,18767,7075871,13.6
140,200,0,18768,7076071,14.285714285714286
50,86,0,18769,7076157,17.2
250,313,0,18770,7076470,12.52
250,380,0,18771,7076850,15.2
230,324,0,18772,7077174,14.08695652173913
260,368,0,18773,7077542,14.153846153846153
290,474,0,18774,7078016,16.344827586206897
290,416,0,18775,7078432,14.344827586206897
220,332,0,18776,7078764,15.090909090909092
160,240,0,18777,7079004,15.0
360,619,0,18778,7079623,17.194444444444443
270,365,0,18779,7079988,13.518518518518519
160,162,0,18780,7080150,10.125
390,588,0,18781,7080738,15.076923076923077
230,354,0,18782,7081092,15.391304347826088
340,585,0,18783,7081677,17.205882352941178
180,302,0,18784,7081979,16.77777777777778
210,353,0,18785,7082332,16.80952380952381
150,221,0,18786,7082553,14.733333333333333
80,61,0,18787,7082614,7.625
290,397,0,18788,7083011,13.689655172413794
230,296,0,18789,7083307,12.869565217391305
180,294,0,18790,7083601,16.333333333333332
220,288,0,18791,7083889,13.090909090909092
130,128,0,18792,7084017,9.846153846153847
570,1028,0,18793,7085045,18.035087719298247
250,413,0,18794,7085458,16.52
180,265,0,18795,7085723,14.722222222222221
320,493,0,18796,7086216,15.40625
170,278,0,18797,7086494,16.352941176470587
260,394,0,18798,7086888,15.153846153846153
200,304,0,18799,7087192,15.2
350,439,0,18800,7087631,12.542857142857143
410,645,0,18801,7088276,15.731707317073171
170,209,0,18802,7088485,12.294117647058824
480,819,0,18803,7089304,17.0625
110,122,0,18804,7089426,11.090909090909092
210,251,0,18805,7089677,11.952380952380953
340,432,0,18806,7090109,12.705882352941176
270,448,0,18807,7090557,16.59259259259259
180,237,0,18808,7090794,13.166666666666666
110,118,0,18809,7090912,10.727272727272727
250,381,0,18810,7091293,15.24
350,582,0,18811,7091875,16.62857142857143
350,559,0,18812,7092434,15.971428571428572
280,451,0,18813,7092885,16.107142857142858
240,337,0,18814,7093222,14.041666666666666
330,483,0,18815,7093705,14.636363636363637
100,104,0,18816,7093809,10.4
210,311,0,18817,7094120,14.80952380952381
170,257,0,18818,7094377,15.117647058823529
190,281,0,18819,7094658,14.789473684210526
450,700,0,18820,7095358,15.555555555555555
290,451,0,18821,7095809,15.551724137931034
310,437,0,18822,7096246,14.096774193548388
130,205,0,18823,7096451,15.76923076923077
370,688,0,18824,7097139,18.594594594594593
360,467,0,18825,7097606,12.972222222222221
280,414,0,18826,7098020,14.785714285714286
230,338,0,18827,7098358,14.695652173913043
320,390,0,18828,7098748,12.1875
220,344,0,18829,7099092,15.636363636363637
170,246,0,18830,7099338,14.470588235294118
420,676,0,18831,7100014,16.095238095238095
390,610,0,18832,7100624,15.64102564102564
250,478,0,18833,7101102,19.12
350,497,0,18834,7101599,14.2
400,570,0,18835,7102169,14.25
360,609,0,18836,7102778,16.916666666666668
90,129,0,18837,7102907,14.333333333333334
110,141,0,18838,7103048,12.818181818181818
260,443,0,18839,7103491,17.03846153846154
240,315,0,18840,7103806,13.125
150,203,0,18841,7104009,13.533333333333333
380,555,0,18842,7104564,14.605263157894736
300,424,0,18843,7104988,14.133333333333333
160,207,0,18844,7105195,12.9375
130,182,0,18845,7105377,14.0
420,615,0,18846,7105992,14.642857142857142
250,397,0,18847,7106389,15.88
160,240,0,18848,7106629,15.0
360,622,0,18849,7107251,17.27777777777778
290,441,0,18850,7107692,15.206896551724139
320,456,0,18851,7108148,14.25
370,617,0,18852,7108765,16.675675675675677
280,438,0,18853,7109203,15.642857142857142
120,145,0,18854,7109348,12.083333333333334
200,225,0,18855,7109573,11.25
410,658,0,18856,7110231,16.048780487804876
290,426,0,18857,7110657,14.689655172413794
450,767,0,18858,7111424,17.044444444444444
130,204,0,18859,7111628,15.692307692307692
120,184,0,18860,7111812,15.333333333333334
220,305,0,18861,7112117,13.863636363636363
70,48,0,18862,7112165,6.857142857142857
280,428,0,18863,7112593,15.285714285714286
260,322,0,18864,7112915,12.384615384615385
340,525,0,18865,7113440,15.441176470588236
310,459,0,18866,7113899,14.806451612903226
390,599,0,18867,7114498,15.35897435897436
320,470,0,18868,7114968,14.6875
370,595,0,18869,7115563,16.08108108108108
180,287,0,18870,7115850,15.944444444444445
160,202,0,18871,7116052,12.625
250,380,0,18872,7116432,15.2
370,571,0,18873,7117003,15.432432432432432
370,762,0,18874,7117765,20.594594594594593
100,139,0,18875,7117904,13.9
330,559,0,18876,7118463,16.939393939393938
230,372,0,18877,7118835,16.17391304347826
180,275,0,18878,7119110,15.277777777777779
370,540,0,18879,7119650,14.594594594594595
360,586,0,18880,7120236,16.27777777777778
90,130,0,18881,7120366,14.444444444444445
200,281,0,18882,7120647,14.05
120,145,0,18883,7120792,12.083333333333334
340,487,0,18884,7121279,14.323529411764707
150,236,0,18885,7121515,15.733333333333333
120,201,0,18886,7121716,16.75
200,276,0,18887,7121992,13.8
210,273,0,18888,7122265,13.0
380,653,0,18889,7122918,17.18421052631579
290,430,0,18890,7123348,14.827586206896552
340,489,0,18891,7123837,14.382352941176471
50,62,0,18892,7123899,12.4
270,376,0,18893,7124275,13.925925925925926
100,131,0,18894,7124406,13.1
320,391,0,18895,7124797,12.21875
420,606,0,18896,7125403,14.428571428571429
210,320,0,18897,7125723,15.238095238095237
210,267,0,18898,7125990,12.714285714285714
270,422,0,18899,7126412,15.62962962962963
340,554,0,18900,7126966,16.294117647058822
280,420,0,18901,7127386,15.0
210,278,0,18902,7127664,13.238095238095237
360,537,0,18903,7128201,14.916666666666666
200,305,0,18904,7128506,15.25
180,256,0,18905,7128762,14.222222222222221
160,265,0,18906,7129027,16.5625
270,365,0,18907,7129392,13.518518518518519
260,419,0,18908,7129811,16.115384615384617
210,394,0,18909,7130205,18.761904761904763
140,236,0,18910,7130441,16.857142857142858
140,227,0,18911,7130668,16.214285714285715
200,271,0,18912,7130939,13.55
270,360,0,18913,7131299,13.333333333333334
200,269,0,18914,7131568,13.45
280,449,0,18915,7132017,16.035714285714285
210,291,0,18916,7132308,13.857142857142858
190,285,0,18917,7132593,15.0
370,605,0,18918,7133198,16.35135135135135
160,203,0,18919,7133401,12.6875
160,203,0,18920,7133604,12.6875
260,429,0,18921,7134033,16.5
190,266,0,18922,7134299,14.0
320,497,0,18923,7134796,15.53125
370,546,0,18924,7135342,14.756756756756756
160,211,0,18925,7135553,13.1875
210,284,0,18926,7135837,13.523809523809524
170,233,0,18927,7136070,13.705882352941176
390,627,0,18928,7136697,16.076923076923077
370,582,0,18929,7137279,15.72972972972973
410,598,0,18930,7137877,14.585365853658537
300,363,0,18931,7138240,12.1
230,375,0,18932,7138615,16.304347826086957
440,665,0,18933,7139280,15.113636363636363
210,295,0,18934,7139575,14.047619047619047
420,758,0,18935,7140333,18.047619047619047
470,835,0,18936,7141168,17.76595744680851
410,677,0,18937,7141845,16.51219512195122
270,390,0,18938,7142235,14.444444444444445
250,366,0,18939,7142601,14.64
260,392,0,18940,7142993,15.076923076923077
240,376,0,18941,7143369,15.666666666666666
210,300,0,18942,7143669,14.285714285714286
250,400,0,18943,7144069,16.0
110,160,0,18944,7144229,14.545454545454545
190,308,0,18945,7144537,16.210526315789473
530,913,0,18946,7145450,17.22641509433962
220,340,0,18947,7145790,15.454545454545455
300,402,0,18948,7146192,13.4
320,481,0,18949,7146673,15.03125
80,92,0,18950,7146765,11.5
270,412,0,18951,7147177,15.25925925925926
280,398,0,18952,7147575,14.214285714285714
170,252,0,18953,7147827,14.823529411764707
240,351,0,18954,7148178,14.625
270,374,0,18955,7148552,13.851851851851851
310,371,0,18956,7148923,11.96774193548387
340,611,0,18957,7149534,17.970588235294116
390,716,0,18958,7150250,18.358974358974358
150,173,0,18959,7150423,11.533333333333333
280,408,0,18960,7150831,14.571428571428571
290,458,0,18961,7151289,15.793103448275861
240,391,0,18962,7151680,16.291666666666668
240,348,0,18963,7152028,14.5
320,365,0,18964,7152393,11.40625
340,452,0,18965,7152845,13.294117647058824
290,381,0,18966,7153226,13.137931034482758
230,346,0,18967,7153572,15.043478260869565
410,660,0,18968,7154232,16.097560975609756
90,75,0,18969,7154307,8.333333333333334
180,255,0,18970,7154562,14.166666666666666
290,385,0,18971,7154947,13.275862068965518
190,299,0,18972,7155246,15.736842105263158
220,291,0,18973,7155537,13.227272727272727
330,537,0,18974,7156074,16.272727272727273
320,418,0,18975,7156492,13.0625
220,290,0,18976,7156782,13.181818181818182
200,270,0,18977,7157052,13.5
170,275,0,18978,7157327,16.176470588235293
180,249,0,18979,7157576,13.833333333333334
210,301,0,18980,7157877,14.333333333333334
230,287,0,18981,7158164,12.478260869565217
170,224,0,18982,7158388,13.176470588235293
140,211,0,18983,7158599,15.071428571428571
230,358,0,18984,7158957,15.565217391304348
260,404,0,18985,7159361,15.538461538461538
130,175,0,18986,7159536,13.461538461538462
380,663,0,18987,7160199,17.44736842105263
420,638,0,18988,7160837,15.19047619047619
270,338,0,18989,7161175,12.518518518518519
140,181,0,18990,7161356,12.928571428571429
160,265,0,18991,7161621,16.5625
250,372,0,18992,7161993,14.88
310,490,0,18993,7162483,15.806451612903226
220,343,0,18994,7162826,15.590909090909092
300,468,0,18995,7163294,15.6
120,192,0,18996,7163486,16.0
210,267,0,18997,7163753,12.714285714285714
270,402,0,18998,7164155,14.88888888888889
270,392,0,18999,7164547,14.518518518518519
220,288,0,19000,7164835,13.090909090909092
370,592,0,19001,7165427,16.0
270,393,0,19002,7165820,14.555555555555555
300,491,0,19003,7166311,16.366666666666667
130,139,0,19004,7166450,10.692307692307692
360,765,0,19005,7167215,21.25
210,297,0,19006,7167512,14.142857142857142
370,559,0,19007,7168071,15.108108108108109
380,544,0,19008,7168615,14.31578947368421
230,329,0,19009,7168944,14.304347826086957
220,338,0,19010,7169282,15.363636363636363
190,284,0,19011,7169566,14.947368421052632
180,269,0,19012,7169835,14.944444444444445
320,515,0,19013,7170350,16.09375
420,628,0,19014,7170978,14.952380952380953
250,310,0,19015,7171288,12.4
170,277,0,19016,7171565,16.294117647058822
280,488,0,19017,7172053,17.428571428571427
220,354,0,19018,7172407,16.09090909090909
240,370,0,19019,7172777,15.416666666666666
160,208,0,19020,7172985,13.0
100,126,0,19021,7173111,12.6
160,204,0,19022,7173315,12.75
210,312,0,19023,7173627,14.857142857142858
240,452,0,19024,7174079,18.833333333333332
320,473,0,19025,7174552,14.78125
160,225,0,19026,7174777,14.0625
90,129,0,19027,7174906,14.333333333333334
100,140,0,19028,7175046,14.0
230,365,0,19029,7175411,15.869565217391305
220,298,0,19030,7175709,13.545454545454545
240,302,0,19031,7176011,12.583333333333334
250,432,0,19032,7176443,17.28
360,491,0,19033,7176934,13.63888888888889
340,526,0,19034,7177460,15.470588235294118
320,426,0,19035,7177886,13.3125
300,408,0,19036,7178294,13.6
260,407,0,19037,7178701,15.653846153846153
220,248,0,19038,7178949,11.272727272727273
170,230,0,19039,7179179,13.529411764705882
150,255,0,19040,7179434,17.0
210,305,0,19041,7179739,14.523809523809524
200,210,0,19042,7179949,10.5
170,257,0,19043,7180206,15.117647058823529
340,558,0,19044,7180764,16.41176470588235
220,314,0,19045,7181078,14.272727272727273
230,285,0,19046,7181363,12.391304347826088
120,178,0,19047,7181541,14.833333333333334
290,420,0,19048,7181961,14.482758620689655
330,462,0,19049,7182423,14.0
210,303,0,19050,7182726,14.428571428571429
300,422,0,19051,7183148,14.066666666666666
250,392,0,19052,7183540,15.68
230,345,0,19053,7183885,15.0
300,456,0,19054,7184341,15.2
220,327,0,19055,7184668,14.863636363636363
390,561,0,19056,7185229,14.384615384615385
380,642,0,19057,7185871,16.894736842105264
180,237,0,19058,7186108,13.166666666666666
340,601,0,19059,7186709,17.676470588235293
230,315,0,19060,7187024,13.695652173913043
400,616,0,19061,7187640,15.4
260,390,0,19062,7188030,15.0
90,117,0,19063,7188147,13.0
270,386,0,19064,7188533,14.296296296296296
280,490,0,19065,7189023,17.5
150,196,0,19066,7189219,13.066666666666666
180,244,0,19067,7189463,13.555555555555555
340,483,0,19068,7189946,14.205882352941176
170,256,0,19069,7190202,15.058823529411764
310,456,0,19070,7190658,14.709677419354838
370,585,0,19071,7191243,15.81081081081081
260,316,0,19072,7191559,12.153846153846153
230,347,0,19073,7191906,15.08695652173913
340,501,0,19074,7192407,14.735294117647058
260,341,0,19075,7192748,13.115384615384615
210,311,0,19076,7193059,14.80952380952381
410,585,0,19077,7193644,14.268292682926829
380,646,0,19078,7194290,17.0
200,292,0,19079,7194582,14.6
190,258,0,19080,7194840,13.578947368421053
270,398,0,19081,7195238,14.74074074074074
130,193,0,19082,7195431,14.846153846153847
370,607,0,19083,7196038,16.405405405405407
270,375,0,19084,7196413,13.88888888888889
230,314,0,19085,7196727,13.652173913043478
190,289,0,19086,7197016,15.210526315789474
220,356,0,19087,7197372,16.181818181818183
270,420,0,19088,7197792,15.555555555555555
230,256,0,19089,7198048,11.130434782608695
220,331,0,19090,7198379,15.045454545454545
270,370,0,19091,7198749,13.703703703703704
120,175,0,19092,7198924,14.583333333333334
250,398,0,19093,7199322,15.92
270,397,0,19094,7199719,14.703703703703704
410,674,0,19095,7200393,16.4390243902439
230,326,0,19096,7200719,14.173913043478262
220,309,0,19097,7201028,14.045454545454545
220,311,0,19098,7201339,14.136363636363637
150,214,0,19099,7201553,14.266666666666667
300,427,0,19100,7201980,14.233333333333333
240,347,0,19101,7202327,14.458333333333334
230,349,0,19102,7202676,15.173913043478262
150,243,0,19103,7202919,16.2
190,247,0,19104,7203166,13.0
320,377,0,19105,7203543,11.78125
250,318,0,19106,7203861,12.72
420,623,0,19107,7204484,14.833333333333334
410,652,0,19108,7205136,15.902439024390244
300,473,0,19109,7205609,15.766666666666667
230,309,0,19110,7205918,13.434782608695652
220,372,0,19111,7206290,16.90909090909091
180,201,0,19112,7206491,11.166666666666666
350,569,0,19113,7207060,16.257142857142856
140,239,0,19114,7207299,17.071428571428573
280,398,0,19115,7207697,14.214285714285714
190,279,0,19116,7207976,14.68421052631579
180,302,0,19117,7208278,16.77777777777778
170,179,0,19118,7208457,10.529411764705882
260,389,0,19119,7208846,14.961538461538462
240,385,0,19120,7209231,16.041666666666668
160,215,0,19121,7209446,13.4375
280,426,0,19122,7209872,15.214285714285714
290,486,0,19123,7210358,16.75862068965517
150,277,0,19124,7210635,18.466666666666665
370,564,0,19125,7211199,15.243243243243244
250,370,0,19126,7211569,14.8
230,312,0,19127,7211881,13.565217391304348
220,337,0,19128,7212218,15.318181818181818
480,838,0,19129,7213056,17.458333333333332
210,324,0,19130,7213380,15.428571428571429
130,137,0,19131,7213517,10.538461538461538
190,279,0,19132,7213796,14.68421052631579
210,276,0,19133,7214072,13.142857142857142
80,88,0,19134,7214160,11.0
290,460,0,19135,7214620,15.862068965517242
140,199,0,19136,7214819,14.214285714285714
320,500,0,19137,7215319,15.625
260,378,0,19138,7215697,14.538461538461538
170,316,0,19139,7216013,18.58823529411765
120,232,0,19140,7216245,19.333333333333332
190,200,0,19141,7216445,10.526315789473685
240,363,0,19142,7216808,15.125
290,376,0,19143,7217184,12.96551724137931
200,302,0,19144,7217486,15.1
310,507,0,19145,7217993,16.35483870967742
270,387,0,19146,7218380,14.333333333333334
360,590,0,19147,7218970,16.38888888888889
290,445,0,19148,7219415,15.344827586206897
270,366,0,19149,7219781,13.555555555555555
290,368,0,19150,7220149,12.689655172413794
300,407,0,19151,7220556,13.566666666666666
370,688,0,19152,7221244,18.594594594594593
100,120,0,19153,7221364,12.0
250,327,0,19154,7221691,13.08
260,361,0,19155,7222052,13.884615384615385
270,393,0,19156,7222445,14.555555555555555
210,299,0,19157,7222744,14.238095238095237
170,168,0,19158,7222912,9.882352941176471
300,507,0,19159,7223419,16.9
110,168,0,19160,7223587,15.272727272727273
270,394,0,19161,7223981,14.592592592592593
90,111,0,19162,7224092,12.333333333333334
250,432,0,19163,7224524,17.28
340,501,0,19164,7225025,14.735294117647058
300,449,0,19165,7225474,14.966666666666667
250,284,0,19166,7225758,11.36
210,264,0,19167,7226022,12.571428571428571
330,464,0,19168,7226486,14.06060606060606
270,465,0,19169,7226951,17.22222222222222
250,317,0,19170,7227268,12.68
120,200,0,19171,7227468,16.666666666666668
140,193,0,19172,7227661,13.785714285714286
280,379,0,19173,7228040,13.535714285714286
290,416,0,19174,7228456,14.344827586206897
230,353,0,19175,7228809,15.347826086956522
310,546,0,19176,7229355,17.612903225806452
240,337,0,19177,7229692,14.041666666666666
260,365,0,19178,7230057,14.038461538461538
180,209,0,19179,7230266,11.61111111111111
190,223,0,19180,7230489,11.736842105263158
280,351,0,19181,7230840,12.535714285714286
260,355,0,19182,7231195,13.653846153846153
190,282,0,19183,7231477,14.842105263157896
150,234,0,19184,7231711,15.6
230,284,0,19185,7231995,12.347826086956522
260,354,0,19186,7232349,13.615384615384615
230,347,0,19187,7232696,15.08695652173913
190,279,0,19188,7232975,14.68421052631579
200,353,0,19189,7233328,17.65
310,468,0,19190,7233796,15.096774193548388
350,555,0,19191,7234351,15.857142857142858
320,536,0,19192,7234887,16.75
260,367,0,19193,7235254,14.115384615384615
310,465,0,19194,7235719,15.0
280,396,0,19195,7236115,14.142857142857142
220,328,0,19196,7236443,14.909090909090908
90,90,0,19197,7236533,10.0
380,551,0,19198,7237084,14.5
230,368,0,19199,7237452,16.0
170,246,0,19200,7237698,14.470588235294118
250,388,0,19201,7238086,15.52
480,778,0,19202,7238864,16.208333333333332
200,273,0,19203,7239137,13.65
420,631,0,19204,7239768,15.023809523809524
170,245,0,19205,7240013,14.411764705882353
180,287,0,19206,7240300,15.944444444444445
370,683,0,19207,7240983,18.45945945945946
390,578,0,19208,7241561,14.820512820512821
200,271,0,19209,7241832,13.55
70,76,0,19210,7241908,10.857142857142858
370,615,0,19211,7242523,16.62162162162162
190,235,0,19212,7242758,12.368421052631579
370,626,0,19213,7243384,16.91891891891892
230,325,0,19214,7243709,14.130434782608695
130,156,0,19215,7243865,12.0
340,509,0,19216,7244374,14.970588235294118
330,459,0,19217,7244833,13.909090909090908
470,884,0,19218,7245717,18.80851063829787
450,767,0,19219,7246484,17.044444444444444
190,263,0,19220,7246747,13.842105263157896
290,453,0,19221,7247200,15.620689655172415
290,437,0,19222,7247637,15.068965517241379
380,577,0,19223,7248214,15.18421052631579
290,408,0,19224,7248622,14.068965517241379
350,477,0,19225,7249099,13.628571428571428
290,446,0,19226,7249545,15.379310344827585
360,621,0,19227,7250166,17.25
380,603,0,19228,7250769,15.868421052631579
290,455,0,19229,7251224,15.689655172413794
140,223,0,19230,7251447,15.928571428571429
140,199,0,19231,7251646,14.214285714285714
270,462,0,19232,7252108,17.11111111111111
350,407,0,19233,7252515,11.628571428571428
330,443,0,19234,7252958,13.424242424242424
150,194,0,19235,7253152,12.933333333333334
150,248,0,19236,7253400,16.533333333333335
140,199,0,19237,7253599,14.214285714285714
290,401,0,19238,7254000,13.827586206896552
290,430,0,19239,7254430,14.827586206896552
400,579,0,19240,7255009,14.475
380,611,0,19241,7255620,16.07894736842105
240,297,0,19242,7255917,12.375
240,382,0,19243,7256299,15.916666666666666
210,259,0,19244,7256558,12.333333333333334
240,339,0,19245,7256897,14.125
150,150,0,19246,7257047,10.0
380,589,0,19247,7257636,15.5
180,286,0,19248,7257922,15.88888888888889
430,684,0,19249,7258606,15.906976744186046
400,654,0,19250,7259260,16.35
120,172,0,19251,7259432,14.333333333333334
160,223,0,19252,7259655,13.9375
410,636,0,19253,7260291,15.512195121951219
330,491,0,19254,7260782,14.878787878787879
260,388,0,19255,7261170,14.923076923076923
120,164,0,19256,7261334,13.666666666666666
280,362,0,19257,7261696,12.928571428571429
250,331,0,19258,7262027,13.24
270,360,0,19259,7262387,13.333333333333334
310,482,0,19260,7262869,15.548387096774194
290,436,0,19261,7263305,15.03448275862069
200,294,0,19262,7263599,14.7
90,109,0,19263,7263708,12.11111111111111
150,213,0,19264,7263921,14.2
160,263,0,19265,7264184,16.4375
360,566,0,19266,7264750,15.722222222222221
170,272,0,19267,7265022,16.0
360,639,0,19268,7265661,17.75
250,353,0,19269,7266014,14.12
220,263,0,19270,7266277,11.954545454545455
230,393,0,19271,7266670,17.08695652173913
160,165,0,19272,7266835,10.3125
210,326,0,19273,7267161,15.523809523809524
360,541,0,19274,7267702,15.027777777777779
150,207,0,19275,7267909,13.8
140,234,0,19276,7268143,16.714285714285715
150,235,0,19277,7268378,15.666666666666666
180,253,0,19278,7268631,14.055555555555555
240,346,0,19279,7268977,14.416666666666666
340,468,0,19280,7269445,13.764705882352942
220,326,0,19281,7269771,14.818181818181818
220,303,0,19282,7270074,13.772727272727273
230,337,0,19283,7270411,14.652173913043478
250,373,0,19284,7270784,14.92
70,100,0,19285,7270884,14.285714285714286
160,258,0,19286,7271142,16.125
240,402,0,19287,7271544,16.75
250,360,0,19288,7271904,14.4
430,697,0,19289,7272601,16.209302325581394
400,561,0,19290,7273162,14.025
110,190,0,19291,7273352,17.272727272727273
200,314,0,19292,7273666,15.7
400,501,0,19293,7274167,12.525
200,263,0,19294,7274430,13.15
200,283,0,19295,7274713,14.15
170,232,0,19296,7274945,13.647058823529411
280,402,0,19297,7275347,14.357142857142858
140,204,0,19298,7275551,14.571428571428571
200,276,0,19299,7275827,13.8
320,422,0,19300,7276249,13.1875
50,73,0,19301,7276322,14.6
210,302,0,19302,7276624,14.380952380952381
320,561,0,19303,7277185,17.53125
130,192,0,19304,7277377,14.76923076923077
340,575,0,19305,7277952,16.91176470588235
260,359,0,19306,7278311,13.807692307692308
230,330,0,19307,7278641,14.347826086956522
310,513,0,19308,7279154,16.548387096774192
200,277,0,19309,7279431,13.85
200,231,0,19310,7279662,11.55
110,148,0,19311,7279810,13.454545454545455
420,666,0,19312,7280476,15.857142857142858
370,655,0,19313,7281131,17.7027027027027
170,253,0,19314,7281384,14.882352941176471
140,176,0,19315,7281560,12.571428571428571
190,281,0,19316,7281841,14.789473684210526
290,446,0,19317,7282287,15.379310344827585
190,257,0,19318,7282544,13.526315789473685
370,560,0,19319,7283104,15.135135135135135
270,408,0,19320,7283512,15.11111111111111
270,473,0,19321,7283985,17.51851851851852
280,432,0,19322,7284417,15.428571428571429
160,187,0,19323,7284604,11.6875
210,319,0,19324,7284923,15.19047619047619
280,424,0,19325,7285347,15.142857142857142
300,424,0,19326,7285771,14.133333333333333
170,244,0,19327,7286015,14.352941176470589
70,79,0,19328,7286094,11.285714285714286
130,175,0,19329,7286269,13.461538461538462
260,350,0,19330,7286619,13.461538461538462
170,218,0,19331,7286837,12.823529411764707
460,777,0,19332,7287614,16.891304347826086
320,447,0,19333,7288061,13.96875
170,218,0,19334,7288279,12.823529411764707
180,286,0,19335,7288565,15.88888888888889
150,199,0,19336,7288764,13.266666666666667
250,405,0,19337,7289169,16.2
180,231,0,19338,7289400,12.833333333333334
240,393,0,19339,7289793,16.375
240,336,0,19340,7290129,14.0
280,464,0,19341,7290593,16.571428571428573
580,1000,0,19342,7291593,17.24137931034483
460,666,0,19343,7292259,14.478260869565217
280,406,0,19344,7292665,14.5
370,494,0,19345,7293159,13.35135135135135
210,299,0,19346,7293458,14.238095238095237
120,125,0,19347,7293583,10.416666666666666
250,306,0,19348,7293889,12.24
360,524,0,19349,7294413,14.555555555555555
300,420,0,19350,7294833,14.0
190,233,0,19351,7295066,12.263157894736842
230,333,0,19352,7295399,14.478260869565217
330,478,0,19353,7295877,14.484848484848484
240,350,0,19354,7296227,14.583333333333334
370,576,0,19355,7296803,15.567567567567568
400,709,0,19356,7297512,17.725
300,479,0,19357,7297991,15.966666666666667
310,403,0,19358,7298394,13.0
210,317,0,19359,7298711,15.095238095238095
260,410,0,19360,7299121,15.76923076923077
220,398,0,19361,7299519,18.09090909090909
150,164,0,19362,7299683,10.933333333333334
120,194,0,19363,7299877,16.166666666666668
280,389,0,19364,7300266,13.892857142857142
280,431,0,19365,7300697,15.392857142857142
250,342,0,19366,7301039,13.68
150,174,0,19367,7301213,11.6
290,393,0,19368,7301606,13.551724137931034
340,491,0,19369,7302097,14.441176470588236
200,291,0,19370,7302388,14.55
280,423,0,19371,7302811,15.107142857142858
370,556,0,19372,7303367,15.027027027027026
110,126,0,19373,7303493,11.454545454545455
220,393,0,19374,7303886,17.863636363636363
320,623,0,19375,7304509,19.46875
130,137,0,19376,7304646,10.538461538461538
90,138,0,19377,7304784,15.333333333333334
260,369,0,19378,7305153,14.192307692307692
90,106,0,19379,7305259,11.777777777777779
180,212,0,19380,7305471,11.777777777777779
110,136,0,19381,7305607,12.363636363636363
170,246,0,19382,7305853,14.470588235294118
280,401,0,19383,7306254,14.321428571428571
340,613,0,19384,7306867,18.029411764705884
450,762,0,19385,7307629,16.933333333333334
190,328,0,19386,7307957,17.263157894736842
510,868,0,19387,7308825,17.019607843137255
160,263,0,19388,7309088,16.4375
280,387,0,19389,7309475,13.821428571428571
200,268,0,19390,7309743,13.4
160,262,0,19391,7310005,16.375
300,398,0,19392,7310403,13.266666666666667
190,299,0,19393,7310702,15.736842105263158
330,413,0,19394,7311115,12.515151515151516
300,404,0,19395,7311519,13.466666666666667
370,603,0,19396,7312122,16.2972972972973
290,456,0,19397,7312578,15.724137931034482
170,262,0,19398,7312840,15.411764705882353
330,494,0,19399,7313334,14.969696969696969
260,375,0,19400,7313709,14.423076923076923
240,332,0,19401,7314041,13.833333333333334
270,369,0,19402,7314410,13.666666666666666
240,341,0,19403,7314751,14.208333333333334
210,261,0,19404,7315012,12.428571428571429
240,328,0,19405,7315340,13.666666666666666
270,351,0,19406,7315691,13.0
290,405,0,19407,7316096,13.96551724137931
250,374,0,19408,7316470,14.96
250,393,0,19409,7316863,15.72
350,576,0,19410,7317439,16.457142857142856
110,161,0,19411,7317600,14.636363636363637
200,265,0,19412,7317865,13.25
280,433,0,19413,7318298,15.464285714285714
70,78,0,19414,7318376,11.142857142857142
230,364,0,19415,7318740,15.826086956521738
440,741,0,19416,7319481,16.84090909090909
190,293,0,19417,7319774,15.421052631578947
160,198,0,19418,7319972,12.375
290,532,0,19419,7320504,18.344827586206897
330,467,0,19420,7320971,14.151515151515152
190,271,0,19421,7321242,14.263157894736842
250,358,0,19422,7321600,14.32
240,367,0,19423,7321967,15.291666666666666
470,763,0,19424,7322730,16.23404255319149
230,318,0,19425,7323048,13.826086956521738
120,197,0,19426,7323245,16.416666666666668
160,183,0,19427,7323428,11.4375
230,303,0,19428,7323731,13.173913043478262
200,256,0,19429,7323987,12.8
140,171,0,19430,7324158,12.214285714285714
200,262,0,19431,7324420,13.1
360,528,0,19432,7324948,14.666666666666666
210,277,0,19433,7325225,13.19047619047619
300,360,0,19434,7325585,12.0
110,162,0,19435,7325747,14.727272727272727
140,135,0,19436,7325882,9.642857142857142
180,238,0,19437,7326120,13.222222222222221
400,664,0,19438,7326784,16.6
240,294,0,19439,7327078,12.25
180,259,0,19440,7327337,14.38888888888889
220,319,0,19441,7327656,14.5
310,470,0,19442,7328126,15.161290322580646
180,322,0,19443,7328448,17.88888888888889
170,233,0,19444,7328681,13.705882352941176
240,340,0,19445,7329021,14.166666666666666
260,353,0,19446,7329374,13.576923076923077
290,443,0,19447,7329817,15.275862068965518
210,282,0,19448,7330099,13.428571428571429
230,270,0,19449,7330369,11.73913043478261
200,306,0,19450,7330675,15.3
270,479,0,19451,7331154,17.74074074074074
80,130,0,19452,7331284,16.25
410,689,0,19453,7331973,16.804878048780488
230,260,0,19454,7332233,11.304347826086957
460,690,0,19455,7332923,15.0
480,636,0,19456,7333559,13.25
350,589,0,19457,7334148,16.82857142857143
140,207,0,19458,7334355,14.785714285714286
240,336,0,19459,7334691,14.0
210,290,0,19460,7334981,13.80952380952381
220,305,0,19461,7335286,13.863636363636363
120,179,0,19462,7335465,14.916666666666666
240,366,0,19463,7335831,15.25
240,314,0,19464,7336145,13.083333333333334
270,430,0,19465,7336575,15.925925925925926
290,475,0,19466,7337050,16.379310344827587
280,437,0,19467,7337487,15.607142857142858
180,246,0,19468,7337733,13.666666666666666
180,261,0,19469,7337994,14.5
170,257,0,19470,7338251,15.117647058823529
270,350,0,19471,7338601,12.962962962962964
250,406,0,19472,7339007,16.24
170,274,0,19473,7339281,16.11764705882353
280,362,0,19474,7339643,12.928571428571429
370,452,0,19475,7340095,12.216216216216216
220,253,0,19476,7340348,11.5
430,743,0,19477,7341091,17.27906976744186
260,355,0,19478,7341446,13.653846153846153
250,388,0,19479,7341834,15.52
300,445,0,19480,7342279,14.833333333333334
310,408,0,19481,7342687,13.161290322580646
200,277,0,19482,7342964,13.85
250,353,0,19483,7343317,14.12
310,483,0,19484,7343800,15.580645161290322
180,294,0,19485,7344094,16.333333333333332
70,128,0,19486,7344222,18.285714285714285
270,437,0,19487,7344659,16.185185185185187
200,285,0,19488,7344944,14.25
140,208,0,19489,7345152,14.857142857142858
400,542,0,19490,7345694,13.55
100,134,0,19491,7345828,13.4
240,368,0,19492,7346196,15.333333333333334
440,656,0,19493,7346852,14.909090909090908
200,282,0,19494,7347134,14.1
240,354,0,19495,7347488,14.75
280,394,0,19496,7347882,14.071428571428571
200,270,0,19497,7348152,13.5
370,525,0,19498,7348677,14.18918918918919
90,74,0,19499,7348751,8.222222222222221
170,233,0,19500,7348984,13.705882352941176
510,826,0,19501,7349810,16.19607843137255
200,253,0,19502,7350063,12.65
290,352,0,19503,7350415,12.137931034482758
220,315,0,19504,7350730,14.318181818181818
400,565,0,19505,7351295,14.125
400,628,0,19506,7351923,15.7
270,407,0,19507,7352330,15.074074074074074
180,283,0,19508,7352613,15.722222222222221
150,229,0,19509,7352842,15.266666666666667
240,376,0,19510,7353218,15.666666666666666
160,240,0,19511,7353458,15.0
310,460,0,19512,7353918,14.838709677419354
240,405,0,19513,7354323,16.875
380,552,0,19514,7354875,14.526315789473685
270,331,0,19515,7355206,12.25925925925926
160,205,0,19516,7355411,12.8125
230,361,0,19517,7355772,15.695652173913043
310,582,0,19518,7356354,18.774193548387096
470,755,0,19519,7357109,16.06382978723404
340,437,0,19520,7357546,12.852941176470589
210,255,0,19521,7357801,12.142857142857142
290,463,0,19522,7358264,15.96551724137931
140,215,0,19523,7358479,15.357142857142858
130,197,0,19524,7358676,15.153846153846153
210,296,0,19525,7358972,14.095238095238095
360,609,0,19526,7359581,16.916666666666668
210,409,0,19527,7359990,19.476190476190474
190,197,0,19528,7360187,10.368421052631579
230,286,0,19529,7360473,12.434782608695652
240,340,0,19530,7360813,14.166666666666666
270,381,0,19531,7361194,14.11111111111111
210,304,0,19532,7361498,14.476190476190476
320,486,0,19533,7361984,15.1875
240,290,0,19534,7362274,12.083333333333334
640,898,0,19535,7363172,14.03125
290,419,0,19536,7363591,14.448275862068966
90,127,0,19537,7363718,14.11111111111111
410,691,0,19538,7364409,16.853658536585368
310,483,0,19539,7364892,15.580645161290322
170,229,0,19540,7365121,13.470588235294118
200,295,0,19541,7365416,14.75
340,513,0,19542,7365929,15.088235294117647
330,461,0,19543,7366390,13.969696969696969
220,332,0,19544,7366722,15.090909090909092
280,426,0,19545,7367148,15.214285714285714
330,458,0,19546,7367606,13.878787878787879
210,279,0,19547,7367885,13.285714285714286
100,158,0,19548,7368043,15.8
230,342,0,19549,7368385,14.869565217391305
370,659,0,19550,7369044,17.81081081081081
300,364,0,19551,7369408,12.133333333333333
280,399,0,19552,7369807,14.25
310,527,0,19553,7370334,17.0
210,291,0,19554,7370625,13.857142857142858
160,207,0,19555,7370832,12.9375
200,285,0,19556,7371117,14.25
340,489,0,19557,7371606,14.382352941176471
330,505,0,19558,7372111,15.303030303030303
350,468,0,19559,7372579,13.371428571428572
270,341,0,19560,7372920,12.62962962962963
230,360,0,19561,7373280,15.652173913043478
250,373,0,19562,7373653,14.92
220,330,0,19563,7373983,15.0
330,476,0,19564,7374459,14.424242424242424
190,271,0,19565,7374730,14.263157894736842
240,380,0,19566,7375110,15.833333333333334
250,436,0,19567,7375546,17.44
180,278,0,19568,7375824,15.444444444444445
390,617,0,19569,7376441,15.820512820512821
200,254,0,19570,7376695,12.7
290,421,0,19571,7377116,14.517241379310345
230,318,0,19572,7377434,13.826086956521738
240,333,0,19573,7377767,13.875
120,151,0,19574,7377918,12.583333333333334
380,656,0,19575,7378574,17.263157894736842
360,525,0,19576,7379099,14.583333333333334
340,526,0,19577,7379625,15.470588235294118
260,312,0,19578,7379937,12.0
340,497,0,19579,7380434,14.617647058823529
320,531,0,19580,7380965,16.59375
240,318,0,19581,7381283,13.25
220,295,0,19582,7381578,13.409090909090908
300,468,0,19583,7382046,15.6
210,253,0,19584,7382299,12.047619047619047
280,382,0,19585,7382681,13.642857142857142
140,184,0,19586,7382865,13.142857142857142
310,540,0,19587,7383405,17.419354838709676
140,209,0,19588,7383614,14.928571428571429
270,332,0,19589,7383946,12.296296296296296
150,222,0,19590,7384168,14.8
350,475,0,19591,7384643,13.571428571428571
220,333,0,19592,7384976,15.136363636363637
190,206,0,19593,7385182,10.842105263157896
380,570,0,19594,7385752,15.0
330,531,0,19595,7386283,16.09090909090909
320,526,0,19596,7386809,16.4375
240,361,0,19597,7387170,15.041666666666666
180,253,0,19598,7387423,14.055555555555555
110,162,0,19599,7387585,14.727272727272727
380,659,0,19600,7388244,17.342105263157894
250,356,0,19601,7388600,14.24
300,467,0,19602,7389067,15.566666666666666
290,432,0,19603,7389499,14.89655172413793
220,386,0,19604,7389885,17.545454545454547
320,553,0,19605,7390438,17.28125
170,222,0,19606,7390660,13.058823529411764
300,458,0,19607,7391118,15.266666666666667
110,134,0,19608,7391252,12.181818181818182
400,637,0,19609,7391889,15.925
350,567,0,19610,7392456,16.2
130,198,0,19611,7392654,15.23076923076923
250,378,0,19612,7393032,15.12
280,477,0,19613,7393509,17.035714285714285
310,473,0,19614,7393982,15.258064516129032
310,437,0,19615,7394419,14.096774193548388
190,401,0,19616,7394820,21.105263157894736
440,683,0,19617,7395503,15.522727272727273
230,290,0,19618,7395793,12.608695652173912
370,540,0,19619,7396333,14.594594594594595
250,369,0,19620,7396702,14.76
130,156,0,19621,7396858,12.0
150,161,0,19622,7397019,10.733333333333333
480,846,0,19623,7397865,17.625
200,306,0,19624,7398171,15.3
250,382,0,19625,7398553,15.28
290,481,0,19626,7399034,16.586206896551722
200,344,0,19627,7399378,17.2
380,627,0,19628,7400005,16.5
250,350,0,19629,7400355,14.0
150,135,0,19630,7400490,9.0
290,431,0,19631,7400921,14.862068965517242
270,446,0,19632,7401367,16.51851851851852
180,206,0,19633,7401573,11.444444444444445
240,353,0,19634,7401926,14.708333333333334
250,294,0,19635,7402220,11.76
280,384,0,19636,7402604,13.714285714285714
290,496,0,19637,7403100,17.103448275862068
100,118,0,19638,7403218,11.8
320,510,0,19639,7403728,15.9375
370,617,0,19640,7404345,16.675675675675677
250,447,0,19641,7404792,17.88
130,217,0,19642,7405009,16.692307692307693
240,352,0,19643,7405361,14.666666666666666
340,496,0,19644,7405857,14.588235294117647
420,679,0,19645,7406536,16.166666666666668
460,733,0,19646,7407269,15.934782608695652
370,704,0,19647,7407973,19.027027027027028
260,352,0,19648,7408325,13.538461538461538
190,286,0,19649,7408611,15.052631578947368
180,285,0,19650,7408896,15.833333333333334
260,411,0,19651,7409307,15.807692307692308
190,324,0,19652,7409631,17.05263157894737
410,650,0,19653,7410281,15.853658536585366
200,343,0,19654,7410624,17.15
290,384,0,19655,7411008,13.241379310344827
200,284,0,19656,7411292,14.2
220,261,0,19657,7411553,11.863636363636363
210,326,0,19658,7411879,15.523809523809524
160,184,0,19659,7412063,11.5
230,307,0,19660,7412370,13.347826086956522
290,427,0,19661,7412797,14.724137931034482
450,727,0,19662,7413524,16.155555555555555
390,636,0,19663,7414160,16.307692307692307
270,380,0,19664,7414540,14.074074074074074
220,301,0,19665,7414841,13.681818181818182
170,218,0,19666,7415059,12.823529411764707
280,390,0,19667,7415449,13.928571428571429
260,380,0,19668,7415829,14.615384615384615
170,243,0,19669,7416072,14.294117647058824
130,135,0,19670,7416207,10.384615384615385
310,570,0,19671,7416777,18.387096774193548
420,657,0,19672,7417434,15.642857142857142
330,527,0,19673,7417961,15.969696969696969
190,263,0,19674,7418224,13.842105263157896
140,179,0,19675,7418403,12.785714285714286
230,375,0,19676,7418778,16.304347826086957
260,492,0,19677,7419270,18.923076923076923
190,238,0,19678,7419508,12.526315789473685
310,457,0,19679,7419965,14.741935483870968
170,285,0,19680,7420250,16.764705882352942
310,421,0,19681,7420671,13.580645161290322
300,445,0,19682,7421116,14.833333333333334
190,320,0,19683,7421436,16.842105263157894
60,82,0,19684,7421518,13.666666666666666
330,531,0,19685,7422049,16.09090909090909
290,453,0,19686,7422502,15.620689655172415
340,468,0,19687,7422970,13.764705882352942
140,195,0,19688,7423165,13.928571428571429
230,344,0,19689,7423509,14.956521739130435
180,256,0,19690,7423765,14.222222222222221
340,526,0,19691,7424291,15.470588235294118
220,294,0,19692,7424585,13.363636363636363
360,525,0,19693,7425110,14.583333333333334
250,424,0,19694,7425534,16.96
190,246,0,19695,7425780,12.947368421052632
210,283,0,19696,7426063,13.476190476190476
340,500,0,19697,7426563,14.705882352941176
190,274,0,19698,7426837,14.421052631578947
230,307,0,19699,7427144,13.347826086956522
250,372,0,19700,7427516,14.88
340,440,0,19701,7427956,12.941176470588236
300,413,0,19702,7428369,13.766666666666667
160,210,0,19703,7428579,13.125
290,414,0,19704,7428993,14.275862068965518
80,120,0,19705,7429113,15.0
130,165,0,19706,7429278,12.692307692307692
330,452,0,19707,7429730,13.696969696969697
160,178,0,19708,7429908,11.125
110,139,0,19709,7430047,12.636363636363637
180,236,0,19710,7430283,13.11111111111111
290,473,0,19711,7430756,16.310344827586206
200,269,0,19712,7431025,13.45
280,474,0,19713,7431499,16.928571428571427
300,438,0,19714,7431937,14.6
160,233,0,19715,7432170,14.5625
260,375,0,19716,7432545,14.423076923076923
190,212,0,19717,7432757,11.157894736842104
210,360,0,19718,7433117,17.142857142857142
230,280,0,19719,7433397,12.173913043478262
160,216,0,19720,7433613,13.5
250,396,0,19721,7434009,15.84
210,300,0,19722,7434309,14.285714285714286
240,319,0,19723,7434628,13.291666666666666
330,429,0,19724,7435057,13.0
170,256,0,19725,7435313,15.058823529411764
230,361,0,19726,7435674,15.695652173913043
150,207,0,19727,7435881,13.8
130,196,0,19728,7436077,15.076923076923077
110,149,0,19729,7436226,13.545454545454545
230,382,0,19730,7436608,16.608695652173914
90,83,0,19731,7436691,9.222222222222221
260,437,0,19732,7437128,16.807692307692307
220,288,0,19733,7437416,13.090909090909092
210,301,0,19734,7437717,14.333333333333334
330,443,0,19735,7438160,13.424242424242424
170,225,0,19736,7438385,13.235294117647058
120,152,0,19737,7438537,12.666666666666666
310,428,0,19738,7438965,13.806451612903226
200,312,0,19739,7439277,15.6
170,193,0,19740,7439470,11.352941176470589
420,723,0,19741,7440193,17.214285714285715
280,434,0,19742,7440627,15.5
120,170,0,19743,7440797,14.166666666666666
120,158,0,19744,7440955,13.166666666666666
120,168,0,19745,7441123,14.0
170,218,0,19746,7441341,12.823529411764707
270,390,0,19747,7441731,14.444444444444445
390,597,0,19748,7442328,15.307692307692308
310,449,0,19749,7442777,14.483870967741936
260,409,0,19750,7443186,15.73076923076923
270,403,0,19751,7443589,14.925925925925926
350,533,0,19752,7444122,15.228571428571428
450,800,0,19753,7444922,17.77777777777778
310,471,0,19754,7445393,15.193548387096774
280,429,0,19755,7445822,15.321428571428571
130,131,0,19756,7445953,10.076923076923077
180,214,0,19757,7446167,11.88888888888889
270,429,0,19758,7446596,15.88888888888889
160,257,0,19759,7446853,16.0625
460,789,0,19760,7447642,17.152173913043477
360,547,0,19761,7448189,15.194444444444445
140,202,0,19762,7448391,14.428571428571429
230,313,0,19763,7448704,13.608695652173912
210,286,0,19764,7448990,13.619047619047619
130,217,0,19765,7449207,16.692307692307693
500,908,0,19766,7450115,18.16
230,401,0,19767,7450516,17.434782608695652
150,204,0,19768,7450720,13.6
190,280,0,19769,7451000,14.736842105263158
100,131,0,19770,7451131,13.1
260,419,0,19771,7451550,16.115384615384617
200,305,0,19772,7451855,15.25
220,306,0,19773,7452161,13.909090909090908
180,236,0,19774,7452397,13.11111111111111
320,496,0,19775,7452893,15.5
260,375,0,19776,7453268,14.423076923076923
190,226,0,19777,7453494,11.894736842105264
380,632,0,19778,7454126,16.63157894736842
260,373,0,19779,7454499,14.346153846153847
280,388,0,19780,7454887,13.857142857142858
210,378,0,19781,7455265,18.0
270,376,0,19782,7455641,13.925925925925926
400,667,0,19783,7456308,16.675
300,492,0,19784,7456800,16.4
100,117,0,19785,7456917,11.7
170,304,0,19786,7457221,17.88235294117647
310,504,0,19787,7457725,16.258064516129032
260,364,0,19788,7458089,14.0
270,397,0,19789,7458486,14.703703703703704
250,353,0,19790,7458839,14.12
160,269,0,19791,7459108,16.8125
110,186,0,19792,7459294,16.90909090909091
110,147,0,19793,7459441,13.363636363636363
80,121,0,19794,7459562,15.125
190,287,0,19795,7459849,15.105263157894736
190,242,0,19796,7460091,12.736842105263158
240,295,0,19797,7460386,12.291666666666666
290,382,0,19798,7460768,13.172413793103448
170,230,0,19799,7460998,13.529411764705882
310,483,0,19800,7461481,15.580645161290322
320,384,0,19801,7461865,12.0
150,198,0,19802,7462063,13.2
320,515,0,19803,7462578,16.09375
130,185,0,19804,7462763,14.23076923076923
180,289,0,19805,7463052,16.055555555555557
310,377,0,19806,7463429,12.161290322580646
210,303,0,19807,7463732,14.428571428571429
320,460,0,19808,7464192,14.375
270,425,0,19809,7464617,15.74074074074074
230,386,0,19810,7465003,16.782608695652176
320,477,0,19811,7465480,14.90625
160,207,0,19812,7465687,12.9375
300,422,0,19813,7466109,14.066666666666666
190,297,0,19814,7466406,15.631578947368421
350,508,0,19815,7466914,14.514285714285714
190,307,0,19816,7467221,16.157894736842106
220,227,0,19817,7467448,10.318181818181818
210,270,0,19818,7467718,12.857142857142858
290,373,0,19819,7468091,12.862068965517242
350,506,0,19820,7468597,14.457142857142857
110,141,0,19821,7468738,12.818181818181818
360,539,0,19822,7469277,14.972222222222221
500,802,0,19823,7470079,16.04
370,625,0,19824,7470704,16.89189189189189
310,432,0,19825,7471136,13.935483870967742
350,472,0,19826,7471608,13.485714285714286
340,421,0,19827,7472029,12.382352941176471
160,261,0,19828,7472290,16.3125
220,335,0,19829,7472625,15.227272727272727
160,187,0,19830,7472812,11.6875
130,186,0,19831,7472998,14.307692307692308
180,297,0,19832,7473295,16.5
280,380,0,19833,7473675,13.571428571428571
240,366,0,19834,7474041,15.25
180,259,0,19835,7474300,14.38888888888889
120,163,0,19836,7474463,13.583333333333334
150,189,0,19837,7474652,12.6
230,360,0,19838,7475012,15.652173913043478
470,703,0,19839,7475715,14.957446808510639
260,385,0,19840,7476100,14.807692307692308
210,270,0,19841,7476370,12.857142857142858
130,185,0,19842,7476555,14.23076923076923
390,689,0,19843,7477244,17.666666666666668
320,443,0,19844,7477687,13.84375
470,619,0,19845,7478306,13.170212765957446
320,540,0,19846,7478846,16.875
100,140,0,19847,7478986,14.0
330,532,0,19848,7479518,16.12121212121212
70,99,0,19849,7479617,14.142857142857142
200,296,0,19850,7479913,14.8
350,540,0,19851,7480453,15.428571428571429
240,347,0,19852,7480800,14.458333333333334
90,116,0,19853,7480916,12.88888888888889
160,240,0,19854,7481156,15.0
330,508,0,19855,7481664,15.393939393939394
230,252,0,19856,7481916,10.956521739130435
200,267,0,19857,7482183,13.35
220,322,0,19858,7482505,14.636363636363637
190,281,0,19859,7482786,14.789473684210526
360,509,0,19860,7483295,14.13888888888889
260,363,0,19861,7483658,13.961538461538462
400,560,0,19862,7484218,14.0
420,625,0,19863,7484843,14.880952380952381
300,438,0,19864,7485281,14.6
340,534,0,19865,7485815,15.705882352941176
250,374,0,19866,7486189,14.96
420,800,0,19867,7486989,19.047619047619047
250,363,0,19868,7487352,14.52
420,585,0,19869,7487937,13.928571428571429
270,439,0,19870,7488376,16.25925925925926
280,463,0,19871,7488839,16.535714285714285
250,283,0,19872,7489122,11.32
250,369,0,19873,7489491,14.76
470,680,0,19874,7490171,14.46808510638298
420,640,0,19875,7490811,15.238095238095237
300,424,0,19876,7491235,14.133333333333333
110,109,0,19877,7491344,9.909090909090908
290,451,0,19878,7491795,15.551724137931034
310,445,0,19879,7492240,14.35483870967742
310,447,0,19880,7492687,14.419354838709678
60,82,0,19881,7492769,13.666666666666666
350,582,0,19882,7493351,16.62857142857143
110,111,0,19883,7493462,10.090909090909092
220,347,0,19884,7493809,15.772727272727273
310,504,0,19885,7494313,16.258064516129032
120,166,0,19886,7494479,13.833333333333334
190,246,0,19887,7494725,12.947368421052632
280,391,0,19888,7495116,13.964285714285714
360,562,0,19889,7495678,15.61111111111111
310,441,0,19890,7496119,14.225806451612904
330,492,0,19891,7496611,14.909090909090908
260,370,0,19892,7496981,14.23076923076923
150,213,0,19893,7497194,14.2
180,242,0,19894,7497436,13.444444444444445
280,412,0,19895,7497848,14.714285714285714
350,723,0,19896,7498571,20.65714285714286
230,344,0,19897,7498915,14.956521739130435
240,356,0,19898,7499271,14.833333333333334
220,304,0,19899,7499575,13.818181818181818
240,320,0,19900,7499895,13.333333333333334
180,210,0,19901,7500105,11.666666666666666
390,557,0,19902,7500662,14.282051282051283
160,199,0,19903,7500861,12.4375
220,342,0,19904,7501203,15.545454545454545
270,388,0,19905,7501591,14.37037037037037
330,456,0,19906,7502047,13.818181818181818
240,353,0,19907,7502400,14.708333333333334
200,262,0,19908,7502662,13.1
430,665,0,19909,7503327,15.465116279069768
460,639,0,19910,7503966,13.891304347826088
230,358,0,19911,7504324,15.565217391304348
70,59,0,19912,7504383,8.428571428571429
490,784,0,19913,7505167,16.0
290,486,0,19914,7505653,16.75862068965517
270,352,0,19915,7506005,13.037037037037036
180,254,0,19916,7506259,14.11111111111111
90,122,0,19917,7506381,13.555555555555555
100,106,0,19918,7506487,10.6
220,280,0,19919,7506767,12.727272727272727
360,489,0,19920,7507256,13.583333333333334
370,698,0,19921,7507954,18.864864864864863
280,458,0,19922,7508412,16.357142857142858
250,323,0,19923,7508735,12.92
410,730,0,19924,7509465,17.804878048780488
300,415,0,19925,7509880,13.833333333333334
280,377,0,19926,7510257,13.464285714285714
280,435,0,19927,7510692,15.535714285714286
270,327,0,19928,7511019,12.11111111111111
250,384,0,19929,7511403,15.36
340,489,0,19930,7511892,14.382352941176471
360,525,0,19931,7512417,14.583333333333334
340,476,0,19932,7512893,14.0
170,243,0,19933,7513136,14.294117647058824
410,598,0,19934,7513734,14.585365853658537
180,266,0,19935,7514000,14.777777777777779
390,581,0,19936,7514581,14.897435897435898
200,319,0,19937,7514900,15.95
350,551,0,19938,7515451,15.742857142857142
140,154,0,19939,7515605,11.0
340,428,0,19940,7516033,12.588235294117647
340,509,0,19941,7516542,14.970588235294118
110,134,0,19942,7516676,12.181818181818182
350,527,0,19943,7517203,15.057142857142857
370,502,0,19944,7517705,13.567567567567568
50,43,0,19945,7517748,8.6
480,897,0,19946,7518645,18.6875
260,414,0,19947,7519059,15.923076923076923
170,245,0,19948,7519304,14.411764705882353
280,418,0,19949,7519722,14.928571428571429
240,378,0,19950,7520100,15.75
400,647,0,19951,7520747,16.175
150,228,0,19952,7520975,15.2
450,720,0,19953,7521695,16.0
260,431,0,19954,7522126,16.576923076923077
280,434,0,19955,7522560,15.5
150,246,0,19956,7522806,16.4
140,160,0,19957,7522966,11.428571428571429
80,116,0,19958,7523082,14.5
430,606,0,19959,7523688,14.093023255813954
190,327,0,19960,7524015,17.210526315789473
210,301,0,19961,7524316,14.333333333333334
260,377,0,19962,7524693,14.5
140,232,0,19963,7524925,16.571428571428573
180,264,0,19964,7525189,14.666666666666666
260,360,0,19965,7525549,13.846153846153847
240,405,0,19966,7525954,16.875
260,384,0,19967,7526338,14.76923076923077
310,465,0,19968,7526803,15.0
330,440,0,19969,7527243,13.333333333333334
200,296,0,19970,7527539,14.8
310,490,0,19971,7528029,15.806451612903226
220,320,0,19972,7528349,14.545454545454545
160,247,0,19973,7528596,15.4375
240,388,0,19974,7528984,16.166666666666668
230,323,0,19975,7529307,14.043478260869565
180,246,0,19976,7529553,13.666666666666666
270,450,0,19977,7530003,16.666666666666668
120,184,0,19978,7530187,15.333333333333334
270,440,0,19979,7530627,16.296296296296298
190,243,0,19980,7530870,12.789473684210526
90,154,0,19981,7531024,17.11111111111111
210,330,0,19982,7531354,15.714285714285714
260,384,0,19983,7531738,14.76923076923077
110,158,0,19984,7531896,14.363636363636363
210,309,0,19985,7532205,14.714285714285714
310,388,0,19986,7532593,12.516129032258064
160,206,0,19987,7532799,12.875
130,176,0,19988,7532975,13.538461538461538
250,427,0,19989,7533402,17.08
230,332,0,19990,7533734,14.434782608695652
410,717,0,19991,7534451,17.48780487804878
230,305,0,19992,7534756,13.26086956521739
280,494,0,19993,7535250,17.642857142857142
120,149,0,19994,7535399,12.416666666666666
330,467,0,19995,7535866,14.151515151515152
290,398,0,19996,7536264,13.724137931034482
330,518,0,19997,7536782,15.696969696969697
200,294,0,19998,7537076,14.7
170,204,0,19999,7537280,12.0
140,196,0,20000,7537476,14.0
300,397,0,20001,7537873,13.233333333333333
230,395,0,20002,7538268,17.17391304347826
370,527,0,20003,7538795,14.243243243243244
280,440,0,20004,7539235,15.714285714285714
100,134,0,20005,7539369,13.4
200,252,0,20006,7539621,12.6
260,341,0,20007,7539962,13.115384615384615
270,396,0,20008,7540358,14.666666666666666
270,417,0,20009,7540775,15.444444444444445
210,352,0,20010,7541127,16.761904761904763
310,493,0,20011,7541620,15.903225806451612
360,432,0,20012,7542052,12.0
160,214,0,20013,7542266,13.375
210,314,0,20014,7542580,14.952380952380953
390,591,0,20015,7543171,15.153846153846153
290,466,0,20016,7543637,16.06896551724138
240,358,0,20017,7543995,14.916666666666666
200,236,0,20018,7544231,11.8
250,319,0,20019,7544550,12.76
340,575,0,20020,7545125,16.91176470588235
180,261,0,20021,7545386,14.5
320,473,0,20022,7545859,14.78125
230,326,0,20023,7546185,14.173913043478262
200,266,0,20024,7546451,13.3
230,337,0,20025,7546788,14.652173913043478
270,415,0,20026,7547203,15.37037037037037
300,419,0,20027,7547622,13.966666666666667
80,122,0,20028,7547744,15.25
350,472,0,20029,7548216,13.485714285714286
130,159,0,20030,7548375,12.23076923076923
210,318,0,20031,7548693,15.142857142857142
350,537,0,20032,7549230,15.342857142857143
290,428,0,20033,7549658,14.758620689655173
340,535,0,20034,7550193,15.735294117647058
190,223,0,20035,7550416,11.736842105263158
180,288,0,20036,7550704,16.0
330,523,0,20037,7551227,15.848484848484848
250,361,0,20038,7551588,14.44
420,500,0,20039,7552088,11.904761904761905
210,327,0,20040,7552415,15.571428571428571
200,270,0,20041,7552685,13.5
440,737,0,20042,7553422,16.75
300,449,0,20043,7553871,14.966666666666667
290,490,0,20044,7554361,16.896551724137932
130,167,0,20045,7554528,12.846153846153847
220,286,0,20046,7554814,13.0
120,146,0,20047,7554960,12.166666666666666
100,111,0,20048,7555071,11.1
240,370,0,20049,7555441,15.416666666666666
260,482,0,20050,7555923,18.53846153846154
320,513,0,20051,7556436,16.03125
260,388,0,20052,7556824,14.923076923076923
110,161,0,20053,7556985,14.636363636363637
320,366,0,20054,7557351,11.4375
210,336,0,20055,7557687,16.0
230,302,0,20056,7557989,13.130434782608695
130,149,0,20057,7558138,11.461538461538462
310,406,0,20058,7558544,13.096774193548388
240,320,0,20059,7558864,13.333333333333334
270,443,0,20060,7559307,16.40740740740741
190,246,0,20061,7559553,12.947368421052632
340,511,0,20062,7560064,15.029411764705882
130,172,0,20063,7560236,13.23076923076923
280,354,0,20064,7560590,12.642857142857142
260,419,0,20065,7561009,16.115384615384617
260,432,0,20066,7561441,16.615384615384617
220,328,0,20067,7561769,14.909090909090908
320,453,0,20068,7562222,14.15625
220,343,0,20069,7562565,15.590909090909092
190,233,0,20070,7562798,12.263157894736842
320,480,0,20071,7563278,15.0
260,339,0,20072,7563617,13.038461538461538
310,439,0,20073,7564056,14.161290322580646
240,309,0,20074,7564365,12.875
160,181,0,20075,7564546,11.3125
400,708,0,20076,7565254,17.7
170,231,0,20077,7565485,13.588235294117647
460,757,0,20078,7566242,16.456521739130434
340,553,0,20079,7566795,16.264705882352942
340,490,0,20080,7567285,14.411764705882353
240,380,0,20081,7567665,15.833333333333334
350,511,0,20082,7568176,14.6
140,211,0,20083,7568387,15.071428571428571
580,1072,0,20084,7569459,18.482758620689655
190,268,0,20085,7569727,14.105263157894736
230,313,0,20086,7570040,13.608695652173912
150,146,0,20087,7570186,9.733333333333333
210,347,0,20088,7570533,16.523809523809526
420,629,0,20089,7571162,14.976190476190476
400,638,0,20090,7571800,15.95
270,429,0,20091,7572229,15.88888888888889
330,498,0,20092,7572727,15.090909090909092
270,425,0,20093,7573152,15.74074074074074
250,395,0,20094,7573547,15.8
260,368,0,20095,7573915,14.153846153846153
330,565,0,20096,7574480,17.12121212121212
210,262,0,20097,7574742,12.476190476190476
280,507,0,20098,7575249,18.107142857142858
230,347,0,20099,7575596,15.08695652173913
370,547,0,20100,7576143,14.783783783783784
100,190,0,20101,7576333,19.0
160,229,0,20102,7576562,14.3125
410,697,0,20103,7577259,17.0
220,300,0,20104,7577559,13.636363636363637
320,411,0,20105,7577970,12.84375
300,373,0,20106,7578343,12.433333333333334
190,254,0,20107,7578597,13.368421052631579
190,267,0,20108,7578864,14.052631578947368
360,460,0,20109,7579324,12.777777777777779
120,169,0,20110,7579493,14.083333333333334
90,146,0,20111,7579639,16.22222222222222
220,295,0,20112,7579934,13.409090909090908
340,563,0,20113,7580497,16.558823529411764
140,245,0,20114,7580742,17.5
240,309,0,20115,7581051,12.875
420,688,0,20116,7581739,16.38095238095238
380,612,0,20117,7582351,16.105263157894736
350,520,0,20118,7582871,14.857142857142858
180,302,0,20119,7583173,16.77777777777778
210,317,0,20120,7583490,15.095238095238095
330,468,0,20121,7583958,14.181818181818182
370,661,0,20122,7584619,17.864864864864863
200,264,0,20123,7584883,13.2
140,264,0,20124,7585147,18.857142857142858
170,236,0,20125,7585383,13.882352941176471
380,606,0,20126,7585989,15.947368421052632
170,252,0,20127,7586241,14.823529411764707
190,238,0,20128,7586479,12.526315789473685
210,408,0,20129,7586887,19.428571428571427
350,594,0,20130,7587481,16.97142857142857
140,218,0,20131,7587699,15.571428571428571
190,329,0,20132,7588028,17.31578947368421
120,183,0,20133,7588211,15.25
230,322,0,20134,7588533,14.0
210,277,0,20135,7588810,13.19047619047619
450,662,0,20136,7589472,14.71111111111111
230,301,0,20137,7589773,13.08695652173913
280,355,0,20138,7590128,12.678571428571429
380,543,0,20139,7590671,14.289473684210526
260,403,0,20140,7591074,15.5
160,238,0,20141,7591312,14.875
190,332,0,20142,7591644,17.473684210526315
220,356,0,20143,7592000,16.181818181818183
290,456,0,20144,7592456,15.724137931034482
440,818,0,20145,7593274,18.59090909090909
210,278,0,20146,7593552,13.238095238095237
270,323,0,20147,7593875,11.962962962962964
480,803,0,20148,7594678,16.729166666666668
150,212,0,20149,7594890,14.133333333333333
290,453,0,20150,7595343,15.620689655172415
120,145,0,20151,7595488,12.083333333333334
290,433,0,20152,7595921,14.931034482758621
280,471,0,20153,7596392,16.821428571428573
130,159,0,20154,7596551,12.23076923076923
310,435,0,20155,7596986,14.03225806451613
530,798,0,20156,7597784,15.056603773584905
260,464,0,20157,7598248,17.846153846153847
190,260,0,20158,7598508,13.68421052631579
240,392,0,20159,7598900,16.333333333333332
120,139,0,20160,7599039,11.583333333333334
320,379,0,20161,7599418,11.84375
170,194,0,20162,7599612,11.411764705882353
320,467,0,20163,7600079,14.59375
250,387,0,20164,7600466,15.48
280,355,0,20165,7600821,12.678571428571429
310,474,0,20166,7601295,15.290322580645162
110,170,0,20167,7601465,15.454545454545455
190,277,0,20168,7601742,14.578947368421053
220,290,0,20169,7602032,13.181818181818182
100,131,0,20170,7602163,13.1
230,332,0,20171,7602495,14.434782608695652
140,180,0,20172,7602675,12.857142857142858
160,191,0,20173,7602866,11.9375
130,183,0,20174,7603049,14.076923076923077
290,417,0,20175,7603466,14.379310344827585
150,174,0,20176,7603640,11.6
360,527,0,20177,7604167,14.63888888888889
240,347,0,20178,7604514,14.458333333333334
290,539,0,20179,7605053,18.586206896551722
330,563,0,20180,7605616,17.060606060606062
190,245,0,20181,7605861,12.894736842105264
230,302,0,20182,7606163,13.130434782608695
160,207,0,20183,7606370,12.9375
210,278,0,20184,7606648,13.238095238095237
200,304,0,20185,7606952,15.2
270,379,0,20186,7607331,14.037037037037036
310,493,0,20187,7607824,15.903225806451612
200,294,0,20188,7608118,14.7
330,461,0,20189,7608579,13.969696969696969
380,603,0,20190,7609182,15.868421052631579
180,245,0,20191,7609427,13.61111111111111
410,653,0,20192,7610080,15.926829268292684
300,482,0,20193,7610562,16.066666666666666
130,163,0,20194,7610725,12.538461538461538
200,284,0,20195,7611009,14.2
310,544,0,20196,7611553,17.548387096774192
220,328,0,20197,7611881,14.909090909090908
250,293,0,20198,7612174,11.72
290,393,0,20199,7612567,13.551724137931034
200,351,0,20200,7612918,17.55
170,225,0,20201,7613143,13.235294117647058
130,157,0,20202,7613300,12.076923076923077
230,347,0,20203,7613647,15.08695652173913
320,427,0,20204,7614074,13.34375
180,251,0,20205,7614325,13.944444444444445
310,338,0,20206,7614663,10.903225806451612
250,407,0,20207,7615070,16.28
300,513,0,20208,7615583,17.1
340,429,0,20209,7616012,12.617647058823529
210,286,0,20210,7616298,13.619047619047619
460,808,0,20211,7617106,17.565217391304348
280,427,0,20212,7617533,15.25
330,492,0,20213,7618025,14.909090909090908
70,83,0,20214,7618108,11.857142857142858
200,277,0,20215,7618385,13.85
150,206,0,20216,7618591,13.733333333333333
320,448,0,20217,7619039,14.0
240,314,0,20218,7619353,13.083333333333334
290,431,0,20219,7619784,14.862068965517242
260,380,0,20220,7620164,14.615384615384615
210,255,0,20221,7620419,12.142857142857142
190,302,0,20222,7620721,15.894736842105264
90,122,0,20223,7620843,13.555555555555555
210,303,0,20224,7621146,14.428571428571429
380,623,0,20225,7621769,16.394736842105264
380,587,0,20226,7622356,15.447368421052632
200,270,0,20227,7622626,13.5
180,269,0,20228,7622895,14.944444444444445
290,417,0,20229,7623312,14.379310344827585
220,324,0,20230,7623636,14.727272727272727
240,378,0,20231,7624014,15.75
410,657,0,20232,7624671,16.024390243902438
250,298,0,20233,7624969,11.92
540,744,0,20234,7625713,13.777777777777779
70,67,0,20235,7625780,9.571428571428571
360,495,0,20236,7626275,13.75
340,593,0,20237,7626868,17.441176470588236
320,375,0,20238,7627243,11.71875
310,404,0,20239,7627647,13.03225806451613
390,649,0,20240,7628296,16.641025641025642
460,828,0,20241,7629124,18.0
380,582,0,20242,7629706,15.31578947368421
120,120,0,20243,7629826,10.0
180,286,0,20244,7630112,15.88888888888889
170,266,0,20245,7630378,15.647058823529411
180,247,0,20246,7630625,13.722222222222221
230,318,0,20247,7630943,13.826086956521738
300,495,0,20248,7631438,16.5
330,497,0,20249,7631935,15.06060606060606
280,427,0,20250,7632362,15.25
300,552,0,20251,7632914,18.4
410,751,0,20252,7633665,18.317073170731707
310,551,0,20253,7634216,17.774193548387096
180,232,0,20254,7634448,12.88888888888889
390,601,0,20255,7635049,15.41025641025641
130,210,0,20256,7635259,16.153846153846153
330,453,0,20257,7635712,13.727272727272727
210,304,0,20258,7636016,14.476190476190476
480,763,0,20259,7636779,15.895833333333334
220,375,0,20260,7637154,17.045454545454547
180,267,0,20261,7637421,14.833333333333334
280,337,0,20262,7637758,12.035714285714286
300,498,0,20263,7638256,16.6
190,242,0,20264,7638498,12.736842105263158
380,483,0,20265,7638981,12.710526315789474
190,280,0,20266,7639261,14.736842105263158
380,591,0,20267,7639852,15.552631578947368
310,425,0,20268,7640277,13.709677419354838
450,587,0,20269,7640864,13.044444444444444
260,429,0,20270,7641293,16.5
200,290,0,20271,7641583,14.5
110,140,0,20272,7641723,12.727272727272727
150,207,0,20273,7641930,13.8
220,332,0,20274,7642262,15.090909090909092
170,284,0,20275,7642546,16.705882352941178
250,285,0,20276,7642831,11.4
440,727,0,20277,7643558,16.522727272727273
230,280,0,20278,7643838,12.173913043478262
260,289,0,20279,7644127,11.115384615384615
170,250,0,20280,7644377,14.705882352941176
140,235,0,20281,7644612,16.785714285714285
270,387,0,20282,7644999,14.333333333333334
130,186,0,20283,7645185,14.307692307692308
220,315,0,20284,7645500,14.318181818181818
350,518,0,20285,7646018,14.8
310,558,0,20286,7646576,18.0
360,561,0,20287,7647137,15.583333333333334
170,206,0,20288,7647343,12.117647058823529
210,346,0,20289,7647689,16.476190476190474
160,262,0,20290,7647951,16.375
440,702,0,20291,7648653,15.954545454545455
220,309,0,20292,7648962,14.045454545454545
410,609,0,20293,7649571,14.853658536585366
100,123,0,20294,7649694,12.3
190,254,0,20295,7649948,13.368421052631579
220,330,0,20296,7650278,15.0
390,601,0,20297,7650879,15.41025641025641
220,337,0,20298,7651216,15.318181818181818
200,266,0,20299,7651482,13.3
300,419,0,20300,7651901,13.966666666666667
250,368,0,20301,7652269,14.72
310,520,0,20302,7652789,16.774193548387096
250,330,0,20303,7653119,13.2
310,496,0,20304,7653615,16.0
200,333,0,20305,7653948,16.65
390,610,0,20306,7654558,15.64102564102564
220,357,0,20307,7654915,16.227272727272727
230,330,0,20308,7655245,14.347826086956522
150,265,0,20309,7655510,17.666666666666668
500,838,0,20310,7656348,16.76
160,247,0,20311,7656595,15.4375
120,149,0,20312,7656744,12.416666666666666
280,389,0,20313,7657133,13.892857142857142
200,230,0,20314,7657363,11.5
220,410,0,20315,7657773,18.636363636363637
170,200,0,20316,7657973,11.764705882352942
130,212,0,20317,7658185,16.307692307692307
140,187,0,20318,7658372,13.357142857142858
420,722,0,20319,7659094,17.19047619047619
100,133,0,20320,7659227,13.3
210,299,0,20321,7659526,14.238095238095237
160,205,0,20322,7659731,12.8125
260,401,0,20323,7660132,15.423076923076923
470,743,0,20324,7660875,15.808510638297872
330,457,0,20325,7661332,13.848484848484848
240,314,0,20326,7661646,13.083333333333334
400,610,0,20327,7662256,15.25
240,353,0,20328,7662609,14.708333333333334
260,480,0,20329,7663089,18.46153846153846
90,119,0,20330,7663208,13.222222222222221
370,567,0,20331,7663775,15.324324324324325
220,356,0,20332,7664131,16.181818181818183
170,275,0,20333,7664406,16.176470588235293
180,232,0,20334,7664638,12.88888888888889
250,332,0,20335,7664970,13.28
260,428,0,20336,7665398,16.46153846153846
330,428,0,20337,7665826,12.969696969696969
330,568,0,20338,7666394,17.21212121212121
350,642,0,20339,7667036,18.34285714285714
260,362,0,20340,7667398,13.923076923076923
180,284,0,20341,7667682,15.777777777777779
80,131,0,20342,7667813,16.375
180,218,0,20343,7668031,12.11111111111111
360,631,0,20344,7668662,17.52777777777778
170,252,0,20345,7668914,14.823529411764707
320,463,0,20346,7669377,14.46875
460,671,0,20347,7670048,14.58695652173913
80,90,0,20348,7670138,11.25
190,297,0,20349,7670435,15.631578947368421
200,284,0,20350,7670719,14.2
250,326,0,20351,7671045,13.04
270,410,0,20352,7671455,15.185185185185185
180,250,0,20353,7671705,13.88888888888889
370,513,0,20354,7672218,13.864864864864865
310,482,0,20355,7672700,15.548387096774194
320,515,0,20356,7673215,16.09375
190,299,0,20357,7673514,15.736842105263158
470,622,0,20358,7674136,13.23404255319149
260,329,0,20359,7674465,12.653846153846153
240,349,0,20360,7674814,14.541666666666666
240,308,0,20361,7675122,12.833333333333334
80,86,0,20362,7675208,10.75
80,94,0,20363,7675302,11.75
270,343,0,20364,7675645,12.703703703703704
370,558,0,20365,7676203,15.08108108108108
210,321,0,20366,7676524,15.285714285714286
250,337,0,20367,7676861,13.48
170,250,0,20368,7677111,14.705882352941176
370,630,0,20369,7677741,17.027027027027028
210,344,0,20370,7678085,16.38095238095238
160,249,0,20371,7678334,15.5625
230,273,0,20372,7678607,11.869565217391305
110,144,0,20373,7678751,13.090909090909092
210,305,0,20374,7679056,14.523809523809524
220,280,0,20375,7679336,12.727272727272727
420,693,0,20376,7680029,16.5
150,248,0,20377,7680277,16.533333333333335
130,148,0,20378,7680425,11.384615384615385
100,156,0,20379,7680581,15.6
280,415,0,20380,7680996,14.821428571428571
220,316,0,20381,7681312,14.363636363636363
160,269,0,20382,7681581,16.8125
370,559,0,20383,7682140,15.108108108108109
270,440,0,20384,7682580,16.296296296296298
250,348,0,20385,7682928,13.92
150,200,0,20386,7683128,13.333333333333334
140,192,0,20387,7683320,13.714285714285714
250,352,0,20388,7683672,14.08
220,338,0,20389,7684010,15.363636363636363
220,333,0,20390,7684343,15.136363636363637
270,377,0,20391,7684720,13.962962962962964
280,445,0,20392,7685165,15.892857142857142
240,327,0,20393,7685492,13.625
340,608,0,20394,7686100,17.88235294117647
300,490,0,20395,7686590,16.333333333333332
110,131,0,20396,7686721,11.909090909090908
310,405,0,20397,7687126,13.064516129032258
350,496,0,20398,7687622,14.17142857142857
130,160,0,20399,7687782,12.307692307692308
370,534,0,20400,7688316,14.432432432432432
370,543,0,20401,7688859,14.675675675675675
320,467,0,20402,7689326,14.59375
150,243,0,20403,7689569,16.2
210,263,0,20404,7689832,12.523809523809524
150,212,0,20405,7690044,14.133333333333333
370,616,0,20406,7690660,16.64864864864865
320,472,0,20407,7691132,14.75
170,261,0,20408,7691393,15.352941176470589
380,636,0,20409,7692029,16.736842105263158
130,177,0,20410,7692206,13.615384615384615
90,90,0,20411,7692296,10.0
210,384,0,20412,7692680,18.285714285714285
160,229,0,20413,7692909,14.3125
100,94,0,20414,7693003,9.4
280,365,0,20415,7693368,13.035714285714286
170,247,0,20416,7693615,14.529411764705882
290,371,0,20417,7693986,12.793103448275861
350,475,0,20418,7694461,13.571428571428571
320,537,0,20419,7694998,16.78125
150,203,0,20420,7695201,13.533333333333333
60,107,0,20421,7695308,17.833333333333332
200,220,0,20422,7695528,11.0
250,374,0,20423,7695902,14.96
130,167,0,20424,7696069,12.846153846153847
460,735,0,20425,7696804,15.978260869565217
200,270,0,20426,7697074,13.5
200,298,0,20427,7697372,14.9
250,359,0,20428,7697731,14.36
270,498,0,20429,7698229,18.444444444444443
300,432,0,20430,7698661,14.4
420,721,0,20431,7699382,17.166666666666668
300,430,0,20432,7699812,14.333333333333334
230,351,0,20433,7700163,15.26086956521739
170,273,0,20434,7700436,16.058823529411764
170,262,0,20435,7700698,15.411764705882353
440,758,0,20436,7701456,17.227272727272727
160,245,0,20437,7701701,15.3125
230,307,0,20438,7702008,13.347826086956522
170,221,0,20439,7702229,13.0
160,197,0,20440,7702426,12.3125
230,389,0,20441,7702815,16.91304347826087
210,265,0,20442,7703080,12.619047619047619
220,343,0,20443,7703423,15.590909090909092
390,422,0,20444,7703845,10.820512820512821
260,361,0,20445,7704206,13.884615384615385
280,341,0,20446,7704547,12.178571428571429
370,597,0,20447,7705144,16.135135135135137
250,388,0,20448,7705532,15.52
200,279,0,20449,7705811,13.95
200,243,0,20450,7706054,12.15
230,403,0,20451,7706457,17.52173913043478
290,401,0,20452,7706858,13.827586206896552
170,292,0,20453,7707150,17.176470588235293
210,298,0,20454,7707448,14.19047619047619
300,440,0,20455,7707888,14.666666666666666
190,234,0,20456,7708122,12.31578947368421
240,358,0,20457,7708480,14.916666666666666
290,428,0,20458,7708908,14.758620689655173
190,241,0,20459,7709149,12.68421052631579
270,361,0,20460,7709510,13.37037037037037
360,477,0,20461,7709987,13.25
400,633,0,20462,7710620,15.825
340,547,0,20463,7711167,16.08823529411765
300,469,0,20464,7711636,15.633333333333333
370,545,0,20465,7712181,14.72972972972973
150,190,0,20466,7712371,12.666666666666666
280,419,0,20467,7712790,14.964285714285714
430,667,0,20468,7713457,15.511627906976743
240,361,0,20469,7713818,15.041666666666666
430,700,0,20470,7714518,16.27906976744186
300,412,0,20471,7714930,13.733333333333333
140,233,0,20472,7715163,16.642857142857142
120,137,0,20473,7715300,11.416666666666666
380,591,0,20474,7715891,15.552631578947368
280,469,0,20475,7716360,16.75
290,497,0,20476,7716857,17.137931034482758
50,42,0,20477,7716899,8.4
360,576,0,20478,7717475,16.0
60,82,0,20479,7717557,13.666666666666666
240,312,0,20480,7717869,13.0
230,370,0,20481,7718239,16.08695652173913
270,398,0,20482,7718637,14.74074074074074
220,416,0,20483,7719053,18.90909090909091
410,653,0,20484,7719706,15.926829268292684
250,365,0,20485,7720071,14.6
160,209,0,20486,7720280,13.0625
280,389,0,20487,7720669,13.892857142857142
380,625,0,20488,7721294,16.44736842105263
220,294,0,20489,7721588,13.363636363636363
160,189,0,20490,7721777,11.8125
230,293,0,20491,7722070,12.73913043478261
190,265,0,20492,7722335,13.947368421052632
90,149,0,20493,7722484,16.555555555555557
200,314,0,20494,7722798,15.7
290,463,0,20495,7723261,15.96551724137931
160,231,0,20496,7723492,14.4375
360,553,0,20497,7724045,15.36111111111111
300,408,0,20498,7724453,13.6
330,455,0,20499,7724908,13.787878787878787
260,348,0,20500,7725256,13.384615384615385
340,610,0,20501,7725866,17.941176470588236
140,209,0,20502,7726075,14.928571428571429
130,176,0,20503,7726251,13.538461538461538
380,564,0,20504,7726815,14.842105263157896
180,239,0,20505,7727054,13.277777777777779
230,303,0,20506,7727357,13.173913043478262
180,321,0,20507,7727678,17.833333333333332
200,255,0,20508,7727933,12.75
210,343,0,20509,7728276,16.333333333333332
220,360,0,20510,7728636,16.363636363636363
400,759,0,20511,7729395,18.975
340,582,0,20512,7729977,17.11764705882353
310,480,0,20513,7730457,15.483870967741936
170,237,0,20514,7730694,13.941176470588236
630,1178,0,20515,7731872,18.6984126984127
210,286,0,20516,7732158,13.619047619047619
250,407,0,20517,7732565,16.28
370,553,0,20518,7733118,14.945945945945946
530,833,0,20519,7733951,15.716981132075471
140,184,0,20520,7734135,13.142857142857142
380,525,0,20521,7734660,13.81578947368421
210,261,0,20522,7734921,12.428571428571429
250,382,0,20523,7735303,15.28
160,206,0,20524,7735509,12.875
170,274,0,20525,7735783,16.11764705882353
230,331,0,20526,7736114,14.391304347826088
200,289,0,20527,7736403,14.45
440,755,0,20528,7737158,17.15909090909091
150,174,0,20529,7737332,11.6
320,493,0,20530,7737825,15.40625
270,390,0,20531,7738215,14.444444444444445
400,713,0,20532,7738928,17.825
270,342,0,20533,7739270,12.666666666666666
120,170,0,20534,7739440,14.166666666666666
280,321,0,20535,7739761,11.464285714285714
330,481,0,20536,7740242,14.575757575757576
110,164,0,20537,7740406,14.909090909090908
240,423,0,20538,7740829,17.625
220,355,0,20539,7741184,16.136363636363637
340,508,0,20540,7741692,14.941176470588236
220,382,0,20541,7742074,17.363636363636363
270,318,0,20542,7742392,11.777777777777779
390,692,0,20543,7743084,17.743589743589745
350,504,0,20544,7743588,14.4
320,444,0,20545,7744032,13.875
240,347,0,20546,7744379,14.458333333333334
270,485,0,20547,7744864,17.962962962962962
240,281,0,20548,7745145,11.708333333333334
330,541,0,20549,7745686,16.393939393939394
350,549,0,20550,7746235,15.685714285714285
220,292,0,20551,7746527,13.272727272727273
90,149,0,20552,7746676,16.555555555555557
330,529,0,20553,7747205,16.03030303030303
90,104,0,20554,7747309,11.555555555555555
180,268,0,20555,7747577,14.88888888888889
300,376,0,20556,7747953,12.533333333333333
170,241,0,20557,7748194,14.176470588235293
290,391,0,20558,7748585,13.482758620689655
230,343,0,20559,7748928,14.91304347826087
290,491,0,20560,7749419,16.93103448275862
210,377,0,20561,7749796,17.952380952380953
310,467,0,20562,7750263,15.064516129032258
270,388,0,20563,7750651,14.37037037037037
190,284,0,20564,7750935,14.947368421052632
240,332,0,20565,7751267,13.833333333333334
320,501,0,20566,7751768,15.65625
280,450,0,20567,7752218,16.071428571428573
250,266,0,20568,7752484,10.64
200,318,0,20569,7752802,15.9
320,414,0,20570,7753216,12.9375
340,503,0,20571,7753719,14.794117647058824
200,294,0,20572,7754013,14.7
250,289,0,20573,7754302,11.56
250,338,0,20574,7754640,13.52
150,209,0,20575,7754849,13.933333333333334
220,304,0,20576,7755153,13.818181818181818
280,483,0,20577,7755636,17.25
240,349,0,20578,7755985,14.541666666666666
90,86,0,20579,7756071,9.555555555555555
260,360,0,20580,7756431,13.846153846153847
350,494,0,20581,7756925,14.114285714285714
100,113,0,20582,7757038,11.3
120,139,0,20583,7757177,11.583333333333334
310,431,0,20584,7757608,13.903225806451612
200,296,0,20585,7757904,14.8
200,286,0,20586,7758190,14.3
200,288,0,20587,7758478,14.4
190,251,0,20588,7758729,13.210526315789474
90,111,0,20589,7758840,12.333333333333334
410,603,0,20590,7759443,14.707317073170731
360,560,0,20591,7760003,15.555555555555555
320,467,0,20592,7760470,14.59375
240,354,0,20593,7760824,14.75
340,538,0,20594,7761362,15.823529411764707
170,310,0,20595,7761672,18.235294117647058
380,557,0,20596,7762229,14.657894736842104
270,322,0,20597,7762551,11.925925925925926
180,246,0,20598,7762797,13.666666666666666
120,125,0,20599,7762922,10.416666666666666
240,306,0,20600,7763228,12.75
330,555,0,20601,7763783,16.818181818181817
410,598,0,20602,7764381,14.585365853658537
220,284,0,20603,7764665,12.909090909090908
270,447,0,20604,7765112,16.555555555555557
460,789,0,20605,7765901,17.152173913043477
190,250,0,20606,7766151,13.157894736842104
400,594,0,20607,7766745,14.85
320,525,0,20608,7767270,16.40625
210,278,0,20609,7767548,13.238095238095237
330,572,0,20610,7768120,17.333333333333332
310,442,0,20611,7768562,14.258064516129032
320,540,0,20612,7769102,16.875
220,291,0,20613,7769393,13.227272727272727
210,291,0,20614,7769684,13.857142857142858
190,281,0,20615,7769965,14.789473684210526
300,518,0,20616,7770483,17.266666666666666
240,339,0,20617,7770822,14.125
280,587,0,20618,7771409,20.964285714285715
240,340,0,20619,7771749,14.166666666666666
50,70,0,20620,7771819,14.0
300,447,0,20621,7772266,14.9
180,259,0,20622,7772525,14.38888888888889
270,503,0,20623,7773028,18.62962962962963
240,349,0,20624,7773377,14.541666666666666
260,399,0,20625,7773776,15.346153846153847
190,229,0,20626,7774005,12.052631578947368
180,247,0,20627,7774252,13.722222222222221
230,356,0,20628,7774608,15.478260869565217
230,313,0,20629,7774921,13.608695652173912
240,303,0,20630,7775224,12.625
60,93,0,20631,7775317,15.5
130,206,0,20632,7775523,15.846153846153847
100,149,0,20633,7775672,14.9
330,552,0,20634,7776224,16.727272727272727
310,419,0,20635,7776643,13.516129032258064
260,344,0,20636,7776987,13.23076923076923
190,273,0,20637,7777260,14.368421052631579
320,487,0,20638,7777747,15.21875
250,429,0,20639,7778176,17.16
240,372,0,20640,7778548,15.5
310,475,0,20641,7779023,15.32258064516129
220,237,0,20642,7779260,10.772727272727273
290,426,0,20643,7779686,14.689655172413794
270,441,0,20644,7780127,16.333333333333332
330,483,0,20645,7780610,14.636363636363637
520,814,0,20646,7781424,15.653846153846153
160,255,0,20647,7781679,15.9375
150,209,0,20648,7781888,13.933333333333334
300,396,0,20649,7782284,13.2
240,324,0,20650,7782608,13.5
200,291,0,20651,7782899,14.55
160,208,0,20652,7783107,13.0
320,430,0,20653,7783537,13.4375
370,553,0,20654,7784090,14.945945945945946
380,557,0,20655,7784647,14.657894736842104
380,590,0,20656,7785237,15.526315789473685
140,272,0,20657,7785509,19.428571428571427
100,119,0,20658,7785628,11.9
130,183,0,20659,7785811,14.076923076923077
270,356,0,20660,7786167,13.185185185185185
230,351,0,20661,7786518,15.26086956521739
170,271,0,20662,7786789,15.941176470588236
380,580,0,20663,7787369,15.263157894736842
160,220,0,20664,7787589,13.75
200,274,0,20665,7787863,13.7
430,746,0,20666,7788609,17.348837209302324
190,258,0,20667,7788867,13.578947368421053
150,173,0,20668,7789040,11.533333333333333
210,283,0,20669,7789323,13.476190476190476
180,222,0,20670,7789545,12.333333333333334
170,225,0,20671,7789770,13.235294117647058
70,101,0,20672,7789871,14.428571428571429
240,357,0,20673,7790228,14.875
470,800,0,20674,7791028,17.02127659574468
140,153,0,20675,7791181,10.928571428571429
190,250,0,20676,7791431,13.157894736842104
130,172,0,20677,7791603,13.23076923076923
240,353,0,20678,7791956,14.708333333333334
220,302,0,20679,7792258,13.727272727272727
190,254,0,20680,7792512,13.368421052631579
160,231,0,20681,7792743,14.4375
250,392,0,20682,7793135,15.68
150,173,0,20683,7793308,11.533333333333333
220,296,0,20684,7793604,13.454545454545455
420,573,0,20685,7794177,13.642857142857142
180,270,0,20686,7794447,15.0
260,352,0,20687,7794799,13.538461538461538
190,278,0,20688,7795077,14.631578947368421
380,494,0,20689,7795571,13.0
280,517,0,20690,7796088,18.464285714285715
330,563,0,20691,7796651,17.060606060606062
210,273,0,20692,7796924,13.0
180,272,0,20693,7797196,15.11111111111111
440,691,0,20694,7797887,15.704545454545455
220,325,0,20695,7798212,14.772727272727273
270,446,0,20696,7798658,16.51851851851852
230,333,0,20697,7798991,14.478260869565217
350,549,0,20698,7799540,15.685714285714285
270,455,0,20699,7799995,16.85185185185185
200,316,0,20700,7800311,15.8
300,446,0,20701,7800757,14.866666666666667
170,247,0,20702,7801004,14.529411764705882
160,224,0,20703,7801228,14.0
360,517,0,20704,7801745,14.36111111111111
150,234,0,20705,7801979,15.6
100,148,0,20706,7802127,14.8
140,203,0,20707,7802330,14.5
330,502,0,20708,7802832,15.212121212121213
290,510,0,20709,7803342,17.586206896551722
210,355,0,20710,7803697,16.904761904761905
220,350,0,20711,7804047,15.909090909090908
250,404,0,20712,7804451,16.16
90,121,0,20713,7804572,13.444444444444445
310,340,0,20714,7804912,10.96774193548387
300,576,0,20715,7805488,19.2
160,225,0,20716,7805713,14.0625
300,419,0,20717,7806132,13.966666666666667
250,345,0,20718,7806477,13.8
500,796,0,20719,7807273,15.92
230,395,0,20720,7807668,17.17391304347826
330,511,0,20721,7808179,15.484848484848484
290,414,0,20722,7808593,14.275862068965518
240,350,0,20723,7808943,14.583333333333334
90,132,0,20724,7809075,14.666666666666666
150,198,0,20725,7809273,13.2
390,592,0,20726,7809865,15.179487179487179
290,470,0,20727,7810335,16.20689655172414
130,148,0,20728,7810483,11.384615384615385
150,181,0,20729,7810664,12.066666666666666
80,79,0,20730,7810743,9.875
460,636,0,20731,7811379,13.826086956521738
420,581,0,20732,7811960,13.833333333333334
180,294,0,20733,7812254,16.333333333333332
350,505,0,20734,7812759,14.428571428571429
240,309,0,20735,7813068,12.875
330,460,0,20736,7813528,13.93939393939394
360,593,0,20737,7814121,16.47222222222222
320,474,0,20738,7814595,14.8125
290,442,0,20739,7815037,15.241379310344827
290,442,0,20740,7815479,15.241379310344827
340,557,0,20741,7816036,16.38235294117647
330,539,0,20742,7816575,16.333333333333332
310,493,0,20743,7817068,15.903225806451612
90,157,0,20744,7817225,17.444444444444443
300,489,0,20745,7817714,16.3
280,523,0,20746,7818237,18.678571428571427
220,288,0,20747,7818525,13.090909090909092
180,262,0,20748,7818787,14.555555555555555
190,308,0,20749,7819095,16.210526315789473
380,609,0,20750,7819704,16.026315789473685
190,270,0,20751,7819974,14.210526315789474
220,310,0,20752,7820284,14.090909090909092
260,387,0,20753,7820671,14.884615384615385
430,761,0,20754,7821432,17.697674418604652
130,184,0,20755,7821616,14.153846153846153
160,174,0,20756,7821790,10.875
450,706,0,20757,7822496,15.688888888888888
360,564,0,20758,7823060,15.666666666666666
390,536,0,20759,7823596,13.743589743589743
300,409,0,20760,7824005,13.633333333333333
260,404,0,20761,7824409,15.538461538461538
340,502,0,20762,7824911,14.764705882352942
200,331,0,20763,7825242,16.55
150,236,0,20764,7825478,15.733333333333333
380,467,0,20765,7825945,12.289473684210526
260,495,0,20766,7826440,19.03846153846154
180,313,0,20767,7826753,17.38888888888889
160,210,0,20768,7826963,13.125
240,387,0,20769,7827350,16.125
400,599,0,20770,7827949,14.975
130,179,0,20771,7828128,13.76923076923077
620,1089,0,20772,7829217,17.56451612903226
360,486,0,20773,7829703,13.5
240,310,0,20774,7830013,12.916666666666666
220,296,0,20775,7830309,13.454545454545455
310,420,0,20776,7830729,13.548387096774194
180,233,0,20777,7830962,12.944444444444445
310,440,0,20778,7831402,14.193548387096774
150,235,0,20779,7831637,15.666666666666666
360,582,0,20780,7832219,16.166666666666668
170,213,0,20781,7832432,12.529411764705882
290,410,0,20782,7832842,14.137931034482758
230,326,0,20783,7833168,14.173913043478262
490,725,0,20784,7833893,14.795918367346939
120,155,0,20785,7834048,12.916666666666666
250,367,0,20786,7834415,14.68
200,304,0,20787,7834719,15.2
170,230,0,20788,7834949,13.529411764705882
220,334,0,20789,7835283,15.181818181818182
150,186,0,20790,7835469,12.4
270,420,0,20791,7835889,15.555555555555555
240,296,0,20792,7836185,12.333333333333334
100,131,0,20793,7836316,13.1
320,478,0,20794,7836794,14.9375
330,533,0,20795,7837327,16.151515151515152
220,366,0,20796,7837693,16.636363636363637
250,397,0,20797,7838090,15.88
270,384,0,20798,7838474,14.222222222222221
290,403,0,20799,7838877,13.89655172413793
310,439,0,20800,7839316,14.161290322580646
90,96,0,20801,7839412,10.666666666666666
160,259,0,20802,7839671,16.1875
300,487,0,20803,7840158,16.233333333333334
110,101,0,20804,7840259,9.181818181818182
190,282,0,20805,7840541,14.842105263157896
230,327,0,20806,7840868,14.217391304347826
90,113,0,20807,7840981,12.555555555555555
470,784,0,20808,7841765,16.680851063829788
160,181,0,20809,7841946,11.3125
160,229,0,20810,7842175,14.3125
190,245,0,20811,7842420,12.894736842105264
270,430,0,20812,7842850,15.925925925925926
210,320,0,20813,7843170,15.238095238095237
170,197,0,20814,7843367,11.588235294117647
290,471,0,20815,7843838,16.24137931034483
70,137,0,20816,7843975,19.571428571428573
120,157,0,20817,7844132,13.083333333333334
290,372,0,20818,7844504,12.827586206896552
260,440,0,20819,7844944,16.923076923076923
180,224,0,20820,7845168,12.444444444444445
280,312,0,20821,7845480,11.142857142857142
290,411,0,20822,7845891,14.172413793103448
120,175,0,20823,7846066,14.583333333333334
240,359,0,20824,7846425,14.958333333333334
160,220,0,20825,7846645,13.75
240,351,0,20826,7846996,14.625
190,269,0,20827,7847265,14.157894736842104
140,178,0,20828,7847443,12.714285714285714
170,263,0,20829,7847706,15.470588235294118
160,184,0,20830,7847890,11.5
390,737,0,20831,7848627,18.897435897435898
150,168,0,20832,7848795,11.2
70,99,0,20833,7848894,14.142857142857142
260,373,0,20834,7849267,14.346153846153847
320,495,0,20835,7849762,15.46875
240,330,0,20836,7850092,13.75
310,497,0,20837,7850589,16.032258064516128
150,211,0,20838,7850800,14.066666666666666
290,535,0,20839,7851335,18.448275862068964
340,470,0,20840,7851805,13.823529411764707
290,388,0,20841,7852193,13.379310344827585
310,506,0,20842,7852699,16.322580645161292
200,286,0,20843,7852985,14.3
350,513,0,20844,7853498,14.657142857142857
360,459,0,20845,7853957,12.75
260,358,0,20846,7854315,13.76923076923077
160,205,0,20847,7854520,12.8125
160,196,0,20848,7854716,12.25
150,249,0,20849,7854965,16.6
540,784,0,20850,7855749,14.518518518518519
240,380,0,20851,7856129,15.833333333333334
300,415,0,20852,7856544,13.833333333333334
500,930,0,20853,7857474,18.6
340,612,0,20854,7858086,18.0
200,273,0,20855,7858359,13.65
260,354,0,20856,7858713,13.615384615384615
180,241,0,20857,7858954,13.38888888888889
430,657,0,20858,7859611,15.279069767441861
190,289,0,20859,7859900,15.210526315789474
320,460,0,20860,7860360,14.375
120,167,0,20861,7860527,13.916666666666666
320,527,0,20862,7861054,16.46875
80,102,0,20863,7861156,12.75
280,450,0,20864,7861606,16.071428571428573
110,116,0,20865,7861722,10.545454545454545
370,515,0,20866,7862237,13.91891891891892
400,704,0,20867,7862941,17.6
320,541,0,20868,7863482,16.90625
300,437,0,20869,7863919,14.566666666666666
120,132,0,20870,7864051,11.0
220,322,0,20871,7864373,14.636363636363637
150,213,0,20872,7864586,14.2
380,626,0,20873,7865212,16.473684210526315
340,520,0,20874,7865732,15.294117647058824
330,568,0,20875,7866300,17.21212121212121
230,368,0,20876,7866668,16.0
340,521,0,20877,7867189,15.323529411764707
290,524,0,20878,7867713,18.06896551724138
260,367,0,20879,7868080,14.115384615384615
280,406,0,20880,7868486,14.5
250,329,0,20881,7868815,13.16
250,389,0,20882,7869204,15.56
200,289,0,20883,7869493,14.45
300,455,0,20884,7869948,15.166666666666666
350,568,0,20885,7870516,16.228571428571428
240,330,0,20886,7870846,13.75
290,386,0,20887,7871232,13.310344827586206
230,324,0,20888,7871556,14.08695652173913
400,539,0,20889,7872095,13.475
310,448,0,20890,7872543,14.451612903225806
140,209,0,20891,7872752,14.928571428571429
170,243,0,20892,7872995,14.294117647058824
110,149,0,20893,7873144,13.545454545454545
290,397,0,20894,7873541,13.689655172413794
450,707,0,20895,7874248,15.71111111111111
190,234,0,20896,7874482,12.31578947368421
260,295,0,20897,7874777,11.346153846153847
250,371,0,20898,7875148,14.84
200,238,0,20899,7875386,11.9
420,656,0,20900,7876042,15.619047619047619
70,97,0,20901,7876139,13.857142857142858
450,713,0,20902,7876852,15.844444444444445
400,752,0,20903,7877604,18.8
190,288,0,20904,7877892,15.157894736842104
270,394,0,20905,7878286,14.592592592592593
370,546,0,20906,7878832,14.756756756756756
370,597,0,20907,7879429,16.135135135135137
180,234,0,20908,7879663,13.0
440,610,0,20909,7880273,13.863636363636363
170,244,0,20910,7880517,14.352941176470589
270,325,0,20911,7880842,12.037037037037036
180,274,0,20912,7881116,15.222222222222221
320,498,0,20913,7881614,15.5625
250,375,0,20914,7881989,15.0
290,415,0,20915,7882404,14.310344827586206
120,166,0,20916,7882570,13.833333333333334
160,262,0,20917,7882832,16.375
380,558,0,20918,7883390,14.68421052631579
190,275,0,20919,7883665,14.473684210526315
330,544,0,20920,7884209,16.484848484848484
220,316,0,20921,7884525,14.363636363636363
350,440,0,20922,7884965,12.571428571428571
300,492,0,20923,7885457,16.4
260,476,0,20924,7885933,18.307692307692307
230,328,0,20925,7886261,14.26086956521739
240,347,0,20926,7886608,14.458333333333334
220,318,0,20927,7886926,14.454545454545455
190,276,0,20928,7887202,14.526315789473685
310,441,0,20929,7887643,14.225806451612904
300,412,0,20930,7888055,13.733333333333333
370,590,0,20931,7888645,15.945945945945946
270,411,0,20932,7889056,15.222222222222221
240,300,0,20933,7889356,12.5
150,176,0,20934,7889532,11.733333333333333
240,373,0,20935,7889905,15.541666666666666
170,193,0,20936,7890098,11.352941176470589
330,412,0,20937,7890510,12.484848484848484
510,944,0,20938,7891454,18.50980392156863
490,792,0,20939,7892246,16.163265306122447
130,197,0,20940,7892443,15.153846153846153
300,412,0,20941,7892855,13.733333333333333
220,284,0,20942,7893139,12.909090909090908
200,273,0,20943,7893412,13.65
280,438,0,20944,7893850,15.642857142857142
450,709,0,20945,7894559,15.755555555555556
210,303,0,20946,7894862,14.428571428571429
330,450,0,20947,7895312,13.636363636363637
340,501,0,20948,7895813,14.735294117647058
320,476,0,20949,7896289,14.875
140,195,0,20950,7896484,13.928571428571429
220,261,0,20951,7896745,11.863636363636363
100,118,0,20952,7896863,11.8
220,341,0,20953,7897204,15.5
420,566,0,20954,7897770,13.476190476190476
490,901,0,20955,7898671,18.387755102040817
200,290,0,20956,7898961,14.5
310,492,0,20957,7899453,15.870967741935484
150,211,0,20958,7899664,14.066666666666666
220,276,0,20959,7899940,12.545454545454545
200,289,0,20960,7900229,14.45
150,217,0,20961,7900446,14.466666666666667
420,696,0,20962,7901142,16.571428571428573
330,469,0,20963,7901611,14.212121212121213
300,457,0,20964,7902068,15.233333333333333
270,388,0,20965,7902456,14.37037037037037
570,982,0,20966,7903438,17.228070175438596
330,547,0,20967,7903985,16.575757575757574
130,158,0,20968,7904143,12.153846153846153
390,664,0,20969,7904807,17.025641025641026
160,229,0,20970,7905036,14.3125
190,291,0,20971,7905327,15.31578947368421
280,339,0,20972,7905666,12.107142857142858
290,393,0,20973,7906059,13.551724137931034
190,268,0,20974,7906327,14.105263157894736
100,158,0,20975,7906485,15.8
120,186,0,20976,7906671,15.5
390,586,0,20977,7907257,15.025641025641026
300,402,0,20978,7907659,13.4
130,177,0,20979,7907836,13.615384615384615
220,340,0,20980,7908176,15.454545454545455
200,336,0,20981,7908512,16.8
310,523,0,20982,7909035,16.870967741935484
200,265,0,20983,7909300,13.25
130,184,0,20984,7909484,14.153846153846153
300,469,0,20985,7909953,15.633333333333333
260,343,0,20986,7910296,13.192307692307692
300,412,0,20987,7910708,13.733333333333333
330,485,0,20988,7911193,14.696969696969697
310,433,0,20989,7911626,13.96774193548387
360,594,0,20990,7912220,16.5
480,666,0,20991,7912886,13.875
190,270,0,20992,7913156,14.210526315789474
280,433,0,20993,7913589,15.464285714285714
260,397,0,20994,7913986,15.26923076923077
120,156,0,20995,7914142,13.0
110,167,0,20996,7914309,15.181818181818182
260,380,0,20997,7914689,14.615384615384615
290,453,0,20998,7915142,15.620689655172415
320,454,0,20999,7915596,14.1875
360,684,0,21000,7916280,19.0
250,398,0,21001,7916678,15.92
300,457,0,21002,7917135,15.233333333333333
180,237,0,21003,7917372,13.166666666666666
150,186,0,21004,7917558,12.4
270,389,0,21005,7917947,14.407407407407407
320,496,0,21006,7918443,15.5
150,160,0,21007,7918603,10.666666666666666
220,326,0,21008,7918929,14.818181818181818
170,242,0,21009,7919171,14.235294117647058
260,405,0,21010,7919576,15.576923076923077
270,395,0,21011,7919971,14.62962962962963
170,230,0,21012,7920201,13.529411764705882
240,338,0,21013,7920539,14.083333333333334
210,308,0,21014,7920847,14.666666666666666
230,336,0,21015,7921183,14.608695652173912
290,451,0,21016,7921634,15.551724137931034
300,504,0,21017,7922138,16.8
140,185,0,21018,7922323,13.214285714285714
180,284,0,21019,7922607,15.777777777777779
260,406,0,21020,7923013,15.615384615384615
290,421,0,21021,7923434,14.517241379310345
150,224,0,21022,7923658,14.933333333333334
140,247,0,21023,7923905,17.642857142857142
210,251,0,21024,7924156,11.952380952380953
190,285,0,21025,7924441,15.0
120,151,0,21026,7924592,12.583333333333334
230,333,0,21027,7924925,14.478260869565217
280,448,0,21028,7925373,16.0
200,308,0,21029,7925681,15.4
300,435,0,21030,7926116,14.5
270,407,0,21031,7926523,15.074074074074074
190,303,0,21032,7926826,15.947368421052632
330,453,0,21033,7927279,13.727272727272727
250,357,0,21034,7927636,14.28
220,325,0,21035,7927961,14.772727272727273
260,361,0,21036,7928322,13.884615384615385
370,584,0,21037,7928906,15.783783783783784
180,251,0,21038,7929157,13.944444444444445
240,355,0,21039,7929512,14.791666666666666
320,494,0,21040,7930006,15.4375
80,99,0,21041,7930105,12.375
210,291,0,21042,7930396,13.857142857142858
260,382,0,21043,7930778,14.692307692307692
60,83,0,21044,7930861,13.833333333333334
250,412,0,21045,7931273,16.48
310,416,0,21046,7931689,13.419354838709678
260,365,0,21047,7932054,14.038461538461538
160,232,0,21048,7932286,14.5
200,273,0,21049,7932559,13.65
210,255,0,21050,7932814,12.142857142857142
180,261,0,21051,7933075,14.5
90,85,0,21052,7933160,9.444444444444445
250,348,0,21053,7933508,13.92
280,386,0,21054,7933894,13.785714285714286
210,353,0,21055,7934247,16.80952380952381
150,224,0,21056,7934471,14.933333333333334
60,40,0,21057,7934511,6.666666666666667
200,304,0,21058,7934815,15.2
300,513,0,21059,7935328,17.1
240,340,0,21060,7935668,14.166666666666666
300,579,0,21061,7936247,19.3
320,530,0,21062,7936777,16.5625
270,336,0,21063,7937113,12.444444444444445
150,175,0,21064,7937288,11.666666666666666
320,546,0,21065,7937834,17.0625
340,492,0,21066,7938326,14.470588235294118
140,188,0,21067,7938514,13.428571428571429
300,416,0,21068,7938930,13.866666666666667
140,201,0,21069,7939131,14.357142857142858
150,163,0,21070,7939294,10.866666666666667
210,317,0,21071,7939611,15.095238095238095
230,353,0,21072,7939964,15.347826086956522
220,404,0,21073,7940368,18.363636363636363
400,718,0,21074,7941086,17.95
180,293,0,21075,7941379,16.27777777777778
230,373,0,21076,7941752,16.217391304347824
350,486,0,21077,7942238,13.885714285714286
230,298,0,21078,7942536,12.956521739130435
190,250,0,21079,7942786,13.157894736842104
430,807,0,21080,7943593,18.767441860465116
320,477,0,21081,7944070,14.90625
350,454,0,21082,7944524,12.971428571428572
240,314,0,21083,7944838,13.083333333333334
140,198,0,21084,7945036,14.142857142857142
390,628,0,21085,7945664,16.102564102564102
230,277,0,21086,7945941,12.043478260869565
130,200,0,21087,7946141,15.384615384615385
340,442,0,21088,7946583,13.0
350,545,0,21089,7947128,15.571428571428571
450,724,0,21090,7947852,16.08888888888889
270,437,0,21091,7948289,16.185185185185187
160,225,0,21092,7948514,14.0625
450,739,0,21093,7949253,16.42222222222222
180,227,0,21094,7949480,12.61111111111111
220,336,0,21095,7949816,15.272727272727273
240,419,0,21096,7950235,17.458333333333332
160,206,0,21097,7950441,12.875
110,116,0,21098,7950557,10.545454545454545
350,548,0,21099,7951105,15.657142857142857
170,237,0,21100,7951342,13.941176470588236
370,669,0,21101,7952011,18.08108108108108
270,451,0,21102,7952462,16.703703703703702
360,424,0,21103,7952886,11.777777777777779
190,238,0,21104,7953124,12.526315789473685
200,257,0,21105,7953381,12.85
260,396,0,21106,7953777,15.23076923076923
320,454,0,21107,7954231,14.1875
180,280,0,21108,7954511,15.555555555555555
360,568,0,21109,7955079,15.777777777777779
230,336,0,21110,7955415,14.608695652173912
60,73,0,21111,7955488,12.166666666666666
160,183,0,21112,7955671,11.4375
100,102,0,21113,7955773,10.2
220,320,0,21114,7956093,14.545454545454545
200,235,0,21115,7956328,11.75
280,362,0,21116,7956690,12.928571428571429
220,332,0,21117,7957022,15.090909090909092
240,289,0,21118,7957311,12.041666666666666
190,282,0,21119,7957593,14.842105263157896
250,357,0,21120,7957950,14.28
310,516,0,21121,7958466,16.64516129032258
250,336,0,21122,7958802,13.44
200,282,0,21123,7959084,14.1
390,688,0,21124,7959772,17.641025641025642
300,505,0,21125,7960277,16.833333333333332
180,237,0,21126,7960514,13.166666666666666
260,409,0,21127,7960923,15.73076923076923
170,236,0,21128,7961159,13.882352941176471
150,218,0,21129,7961377,14.533333333333333
90,146,0,21130,7961523,16.22222222222222
160,182,0,21131,7961705,11.375
210,306,0,21132,7962011,14.571428571428571
360,486,0,21133,7962497,13.5
220,325,0,21134,7962822,14.772727272727273
350,489,0,21135,7963311,13.971428571428572
180,295,0,21136,7963606,16.38888888888889
190,291,0,21137,7963897,15.31578947368421
200,306,0,21138,7964203,15.3
350,642,0,21139,7964845,18.34285714285714
140,169,0,21140,7965014,12.071428571428571
290,426,0,21141,7965440,14.689655172413794
510,837,0,21142,7966277,16.41176470588235
210,273,0,21143,7966550,13.0
50,73,0,21144,7966623,14.6
200,308,0,21145,7966931,15.4
180,288,0,21146,7967219,16.0
320,473,0,21147,7967692,14.78125
320,474,0,21148,7968166,14.8125
100,144,0,21149,7968310,14.4
130,167,0,21150,7968477,12.846153846153847
310,474,0,21151,7968951,15.290322580645162
410,731,0,21152,7969682,17.829268292682926
210,239,0,21153,7969921,11.380952380952381
300,463,0,21154,7970384,15.433333333333334
250,310,0,21155,7970694,12.4
230,347,0,21156,7971041,15.08695652173913
140,207,0,21157,7971248,14.785714285714286
230,333,0,21158,7971581,14.478260869565217
300,442,0,21159,7972023,14.733333333333333
160,172,0,21160,7972195,10.75
70,65,0,21161,7972260,9.285714285714286
280,467,0,21162,7972727,16.678571428571427
340,565,0,21163,7973292,16.61764705882353
220,296,0,21164,7973588,13.454545454545455
430,604,0,21165,7974192,14.046511627906977
150,198,0,21166,7974390,13.2
230,281,0,21167,7974671,12.217391304347826
330,446,0,21168,7975117,13.515151515151516
400,616,0,21169,7975733,15.4
250,377,0,21170,7976110,15.08
230,281,0,21171,7976391,12.217391304347826
400,650,0,21172,7977041,16.25
180,261,0,21173,7977302,14.5
240,320,0,21174,7977622,13.333333333333334
120,207,0,21175,7977829,17.25
190,269,0,21176,7978098,14.157894736842104
390,619,0,21177,7978717,15.871794871794872
180,247,0,21178,7978964,13.722222222222221
220,294,0,21179,7979258,13.363636363636363
280,449,0,21180,7979707,16.035714285714285
260,395,0,21181,7980102,15.192307692307692
270,453,0,21182,7980555,16.77777777777778
150,194,0,21183,7980749,12.933333333333334
180,274,0,21184,7981023,15.222222222222221
140,113,0,21185,7981136,8.071428571428571
210,322,0,21186,7981458,15.333333333333334
150,181,0,21187,7981639,12.066666666666666
120,157,0,21188,7981796,13.083333333333334
310,484,0,21189,7982280,15.612903225806452
180,229,0,21190,7982509,12.722222222222221
210,302,0,21191,7982811,14.380952380952381
100,106,0,21192,7982917,10.6
330,425,0,21193,7983342,12.878787878787879
120,140,0,21194,7983482,11.666666666666666
380,559,0,21195,7984041,14.710526315789474
130,183,0,21196,7984224,14.076923076923077
190,227,0,21197,7984451,11.947368421052632
170,277,0,21198,7984728,16.294117647058822
240,364,0,21199,7985092,15.166666666666666
430,799,0,21200,7985891,18.58139534883721
140,155,0,21201,7986046,11.071428571428571
290,340,0,21202,7986386,11.724137931034482
210,287,0,21203,7986673,13.666666666666666
90,103,0,21204,7986776,11.444444444444445
410,582,0,21205,7987358,14.195121951219512
450,633,0,21206,7987991,14.066666666666666
130,180,0,21207,7988171,13.846153846153847
180,260,0,21208,7988431,14.444444444444445
330,495,0,21209,7988926,15.0
310,578,0,21210,7989504,18.64516129032258
330,538,0,21211,7990042,16.303030303030305
140,204,0,21212,7990246,14.571428571428571
300,459,0,21213,7990705,15.3
320,508,0,21214,7991213,15.875
260,427,0,21215,7991640,16.423076923076923
110,161,0,21216,7991801,14.636363636363637
330,481,0,21217,7992282,14.575757575757576
210,263,0,21218,7992545,12.523809523809524
90,129,0,21219,7992674,14.333333333333334
190,299,0,21220,7992973,15.736842105263158
110,162,0,21221,7993135,14.727272727272727
250,365,0,21222,7993500,14.6
280,423,0,21223,7993923,15.107142857142858
330,484,0,21224,7994407,14.666666666666666
350,458,0,21225,7994865,13.085714285714285
350,516,0,21226,7995381,14.742857142857142
150,205,0,21227,7995586,13.666666666666666
230,349,0,21228,7995935,15.173913043478262
260,398,0,21229,7996333,15.307692307692308
140,168,0,21230,7996501,12.0
230,375,0,21231,7996876,16.304347826086957
320,548,0,21232,7997424,17.125
260,380,0,21233,7997804,14.615384615384615
210,296,0,21234,7998100,14.095238095238095
280,425,0,21235,7998525,15.178571428571429
160,242,0,21236,7998767,15.125
290,393,0,21237,7999160,13.551724137931034
510,742,0,21238,7999902,14.549019607843137
300,418,0,21239,8000320,13.933333333333334
280,448,0,21240,8000768,16.0
140,240,0,21241,8001008,17.142857142857142
380,495,0,21242,8001503,13.026315789473685
340,390,0,21243,8001893,11.470588235294118
240,357,0,21244,8002250,14.875
350,681,0,21245,8002931,19.457142857142856
290,408,0,21246,8003339,14.068965517241379
200,314,0,21247,8003653,15.7
280,414,0,21248,8004067,14.785714285714286
130,165,0,21249,8004232,12.692307692307692
210,300,0,21250,8004532,14.285714285714286
260,379,0,21251,8004911,14.576923076923077
230,388,0,21252,8005299,16.869565217391305
240,282,0,21253,8005581,11.75
370,669,0,21254,8006250,18.08108108108108
210,339,0,21255,8006589,16.142857142857142
160,192,0,21256,8006781,12.0
220,419,0,21257,8007200,19.045454545454547
190,258,0,21258,8007458,13.578947368421053
210,321,0,21259,8007779,15.285714285714286
280,452,0,21260,8008231,16.142857142857142
80,79,0,21261,8008310,9.875
120,161,0,21262,8008471,13.416666666666666
330,491,0,21263,8008962,14.878787878787879
160,252,0,21264,8009214,15.75
160,246,0,21265,8009460,15.375
70,75,0,21266,8009535,10.714285714285714
320,497,0,21267,8010032,15.53125
380,640,0,21268,8010672,16.842105263157894
270,421,0,21269,8011093,15.592592592592593
230,297,0,21270,8011390,12.91304347826087
300,456,0,21271,8011846,15.2
250,377,0,21272,8012223,15.08
310,503,0,21273,8012726,16.225806451612904
160,218,0,21274,8012944,13.625
60,58,0,21275,8013002,9.666666666666666
260,339,0,21276,8013341,13.038461538461538
140,187,0,21277,8013528,13.357142857142858
300,477,0,21278,8014005,15.9
370,569,0,21279,8014574,15.378378378378379
380,628,0,21280,8015202,16.526315789473685
280,436,0,21281,8015638,15.571428571428571
240,357,0,21282,8015995,14.875
290,352,0,21283,8016347,12.137931034482758
280,448,0,21284,8016795,16.0
180,236,0,21285,8017031,13.11111111111111
190,258,0,21286,8017289,13.578947368421053
130,204,0,21287,8017493,15.692307692307692
170,204,0,21288,8017697,12.0
340,517,0,21289,8018214,15.205882352941176
210,295,0,21290,8018509,14.047619047619047
310,407,0,21291,8018916,13.129032258064516
370,580,0,21292,8019496,15.675675675675675
460,826,0,21293,8020322,17.956521739130434
370,598,0,21294,8020920,16.16216216216216
300,438,0,21295,8021358,14.6
270,354,0,21296,8021712,13.11111111111111
110,128,0,21297,8021840,11.636363636363637
210,246,0,21298,8022086,11.714285714285714
130,189,0,21299,8022275,14.538461538461538
360,525,0,21300,8022800,14.583333333333334
230,325,0,21301,8023125,14.130434782608695
140,185,0,21302,8023310,13.214285714285714
300,449,0,21303,8023759,14.966666666666667
350,581,0,21304,8024340,16.6
330,538,0,21305,8024878,16.303030303030305
290,421,0,21306,8025299,14.517241379310345
170,315,0,21307,8025614,18.529411764705884
80,115,0,21308,8025729,14.375
220,322,0,21309,8026051,14.636363636363637
160,183,0,21310,8026234,11.4375
260,371,0,21311,8026605,14.26923076923077
340,579,0,21312,8027184,17.029411764705884
330,488,0,21313,8027672,14.787878787878787
230,357,0,21314,8028029,15.521739130434783
190,255,0,21315,8028284,13.421052631578947
120,161,0,21316,8028445,13.416666666666666
120,145,0,21317,8028590,12.083333333333334
130,143,0,21318,8028733,11.0
390,519,0,21319,8029252,13.307692307692308
240,320,0,21320,8029572,13.333333333333334
120,154,0,21321,8029726,12.833333333333334
250,410,0,21322,8030136,16.4
140,232,0,21323,8030368,16.571428571428573
220,342,0,21324,8030710,15.545454545454545
170,270,0,21325,8030980,15.882352941176471
280,471,0,21326,8031451,16.821428571428573
190,271,0,21327,8031722,14.263157894736842
310,457,0,21328,8032179,14.741935483870968
220,292,0,21329,8032471,13.272727272727273
250,376,0,21330,8032847,15.04
90,82,0,21331,8032929,9.11111111111111
360,529,0,21332,8033458,14.694444444444445
300,399,0,21333,8033857,13.3
240,360,0,21334,8034217,15.0
250,381,0,21335,8034598,15.24
340,508,0,21336,8035106,14.941176470588236
250,370,0,21337,8035476,14.8
400,563,0,21338,8036039,14.075
320,501,0,21339,8036540,15.65625
340,479,0,21340,8037019,14.088235294117647
200,293,0,21341,8037312,14.65
360,579,0,21342,8037891,16.083333333333332
350,604,0,21343,8038495,17.257142857142856
240,359,0,21344,8038854,14.958333333333334
290,421,0,21345,8039275,14.517241379310345
290,483,0,21346,8039758,16.655172413793103
210,373,0,21347,8040131,17.761904761904763
260,438,0,21348,8040569,16.846153846153847
330,501,0,21349,8041070,15.181818181818182
180,254,0,21350,8041324,14.11111111111111
230,373,0,21351,8041697,16.217391304347824
230,315,0,21352,8042012,13.695652173913043
210,278,0,21353,8042290,13.238095238095237
380,526,0,21354,8042816,13.842105263157896
150,184,0,21355,8043000,12.266666666666667
370,565,0,21356,8043565,15.27027027027027
180,259,0,21357,8043824,14.38888888888889
280,407,0,21358,8044231,14.535714285714286
110,154,0,21359,8044385,14.0
170,186,0,21360,8044571,10.941176470588236
300,488,0,21361,8045059,16.266666666666666
80,67,0,21362,8045126,8.375
390,633,0,21363,8045759,16.23076923076923
160,166,0,21364,8045925,10.375
390,652,0,21365,8046577,16.71794871794872
140,168,0,21366,8046745,12.0
390,595,0,21367,8047340,15.256410256410257
190,230,0,21368,8047570,12.105263157894736
180,259,0,21369,8047829,14.38888888888889
120,145,0,21370,8047974,12.083333333333334
210,354,0,21371,8048328,16.857142857142858
180,242,0,21372,8048570,13.444444444444445
200,277,0,21373,8048847,13.85
210,324,0,21374,8049171,15.428571428571429
180,221,0,21375,8049392,12.277777777777779
270,455,0,21376,8049847,16.85185185185185
90,103,0,21377,8049950,11.444444444444445
260,351,0,21378,8050301,13.5
280,344,0,21379,8050645,12.285714285714286
320,488,0,21380,8051133,15.25
250,310,0,21381,8051443,12.4
390,661,0,21382,8052104,16.94871794871795
130,238,0,21383,8052342,18.307692307692307
120,184,0,21384,8052526,15.333333333333334
280,376,0,21385,8052902,13.428571428571429
130,186,0,21386,8053088,14.307692307692308
200,296,0,21387,8053384,14.8
190,257,0,21388,8053641,13.526315789473685
230,298,0,21389,8053939,12.956521739130435
220,295,0,21390,8054234,13.409090909090908
220,389,0,21391,8054623,17.681818181818183
270,332,0,21392,8054955,12.296296296296296
150,205,0,21393,8055160,13.666666666666666
180,234,0,21394,8055394,13.0
340,609,0,21395,8056003,17.91176470588235
330,510,0,21396,8056513,15.454545454545455
280,389,0,21397,8056902,13.892857142857142
200,286,0,21398,8057188,14.3
200,289,0,21399,8057477,14.45
200,289,0,21400,8057766,14.45
170,181,0,21401,8057947,10.647058823529411
270,444,0,21402,8058391,16.444444444444443
150,166,0,21403,8058557,11.066666666666666
50,63,0,21404,8058620,12.6
150,220,0,21405,8058840,14.666666666666666
300,489,0,21406,8059329,16.3
190,226,0,21407,8059555,11.894736842105264
230,340,0,21408,8059895,14.782608695652174
200,285,0,21409,8060180,14.25
370,573,0,21410,8060753,15.486486486486486
280,406,0,21411,8061159,14.5
270,418,0,21412,8061577,15.481481481481481
210,297,0,21413,8061874,14.142857142857142
410,607,0,21414,8062481,14.804878048780488
300,477,0,21415,8062958,15.9
170,236,0,21416,8063194,13.882352941176471
260,349,0,21417,8063543,13.423076923076923
280,364,0,21418,8063907,13.0
310,441,0,21419,8064348,14.225806451612904
300,420,0,21420,8064768,14.0
190,285,0,21421,8065053,15.0
280,389,0,21422,8065442,13.892857142857142
220,261,0,21423,8065703,11.863636363636363
330,499,0,21424,8066202,15.121212121212121
150,241,0,21425,8066443,16.066666666666666
200,261,0,21426,8066704,13.05
420,616,0,21427,8067320,14.666666666666666
240,354,0,21428,8067674,14.75
180,233,0,21429,8067907,12.944444444444445
130,154,0,21430,8068061,11.846153846153847
490,766,0,21431,8068827,15.63265306122449
150,189,0,21432,8069016,12.6
200,302,0,21433,8069318,15.1
360,509,0,21434,8069827,14.13888888888889
290,331,0,21435,8070158,11.413793103448276
410,571,0,21436,8070729,13.926829268292684
130,189,0,21437,8070918,14.538461538461538
140,205,0,21438,8071123,14.642857142857142
240,375,0,21439,8071498,15.625
230,354,0,21440,8071852,15.391304347826088
140,167,0,21441,8072019,11.928571428571429
270,409,0,21442,8072428,15.148148148148149
120,126,0,21443,8072554,10.5
280,410,0,21444,8072964,14.642857142857142
100,114,0,21445,8073078,11.4
250,429,0,21446,8073507,17.16
190,310,0,21447,8073817,16.31578947368421
130,158,0,21448,8073975,12.153846153846153
290,452,0,21449,8074427,15.586206896551724
320,530,0,21450,8074957,16.5625
190,278,0,21451,8075235,14.631578947368421
250,353,0,21452,8075588,14.12
160,178,0,21453,8075766,11.125
270,376,0,21454,8076142,13.925925925925926
200,282,0,21455,8076424,14.1
270,376,0,21456,8076800,13.925925925925926
130,225,0,21457,8077025,17.307692307692307
140,178,0,21458,8077203,12.714285714285714
590,1186,0,21459,8078389,20.10169491525424
290,418,0,21460,8078807,14.413793103448276
230,390,0,21461,8079197,16.956521739130434
280,377,0,21462,8079574,13.464285714285714
340,566,0,21463,8080140,16.647058823529413
100,109,0,21464,8080249,10.9
100,162,0,21465,8080411,16.2
210,330,0,21466,8080741,15.714285714285714
120,162,0,21467,8080903,13.5
330,519,0,21468,8081422,15.727272727272727
210,334,0,21469,8081756,15.904761904761905
410,611,0,21470,8082367,14.902439024390244
190,279,0,21471,8082646,14.68421052631579
200,360,0,21472,8083006,18.0
170,236,0,21473,8083242,13.882352941176471
340,480,0,21474,8083722,14.117647058823529
170,258,0,21475,8083980,15.176470588235293
290,425,0,21476,8084405,14.655172413793103
200,315,0,21477,8084720,15.75
160,190,0,21478,8084910,11.875
300,437,0,21479,8085347,14.566666666666666
170,252,0,21480,8085599,14.823529411764707
120,163,0,21481,8085762,13.583333333333334
210,284,0,21482,8086046,13.523809523809524
140,209,0,21483,8086255,14.928571428571429
310,431,0,21484,8086686,13.903225806451612
270,367,0,21485,8087053,13.592592592592593
380,629,0,21486,8087682,16.55263157894737
370,590,0,21487,8088272,15.945945945945946
90,80,0,21488,8088352,8.88888888888889
130,202,0,21489,8088554,15.538461538461538
80,76,0,21490,8088630,9.5
430,620,0,21491,8089250,14.418604651162791
340,470,0,21492,8089720,13.823529411764707
400,655,0,21493,8090375,16.375
120,174,0,21494,8090549,14.5
240,375,0,21495,8090924,15.625
200,227,0,21496,8091151,11.35
200,263,0,21497,8091414,13.15
60,62,0,21498,8091476,10.333333333333334
120,177,0,21499,8091653,14.75
350,489,0,21500,8092142,13.971428571428572
390,585,0,21501,8092727,15.0
410,609,0,21502,8093336,14.853658536585366
190,271,0,21503,8093607,14.263157894736842
190,271,0,21504,8093878,14.263157894736842
230,306,0,21505,8094184,13.304347826086957
140,193,0,21506,8094377,13.785714285714286
320,507,0,21507,8094884,15.84375
370,516,0,21508,8095400,13.945945945945946
270,416,0,21509,8095816,15.407407407407407
230,299,0,21510,8096115,13.0
500,978,0,21511,8097093,19.56
160,217,0,21512,8097310,13.5625
270,431,0,21513,8097741,15.962962962962964
280,358,0,21514,8098099,12.785714285714286
430,630,0,21515,8098729,14.651162790697674
330,463,0,21516,8099192,14.030303030303031
300,415,0,21517,8099607,13.833333333333334
290,467,0,21518,8100074,16.103448275862068
200,272,0,21519,8100346,13.6
320,561,0,21520,8100907,17.53125
320,464,0,21521,8101371,14.5
110,127,0,21522,8101498,11.545454545454545
230,307,0,21523,8101805,13.347826086956522
220,326,0,21524,8102131,14.818181818181818
180,308,0,21525,8102439,17.11111111111111
200,274,0,21526,8102713,13.7
400,621,0,21527,8103334,15.525
430,645,0,21528,8103979,15.0
100,126,0,21529,8104105,12.6
230,305,0,21530,8104410,13.26086956521739
140,208,0,21531,8104618,14.857142857142858
220,365,0,21532,8104983,16.59090909090909
250,332,0,21533,8105315,13.28
210,358,0,21534,8105673,17.047619047619047
220,325,0,21535,8105998,14.772727272727273
130,237,0,21536,8106235,18.23076923076923
210,292,0,21537,8106527,13.904761904761905
320,426,0,21538,8106953,13.3125
350,537,0,21539,8107490,15.342857142857143
350,559,0,21540,8108049,15.971428571428572
250,296,0,21541,8108345,11.84
310,477,0,21542,8108822,15.387096774193548
340,463,0,21543,8109285,13.617647058823529
190,306,0,21544,8109591,16.105263157894736
220,336,0,21545,8109927,15.272727272727273
280,397,0,21546,8110324,14.178571428571429
240,342,0,21547,8110666,14.25
270,401,0,21548,8111067,14.851851851851851
280,402,0,21549,8111469,14.357142857142858
240,326,0,21550,8111795,13.583333333333334
300,485,0,21551,8112280,16.166666666666668
290,390,0,21552,8112670,13.448275862068966
310,415,0,21553,8113085,13.387096774193548
240,338,0,21554,8113423,14.083333333333334
330,502,0,21555,8113925,15.212121212121213
120,186,0,21556,8114111,15.5
460,730,0,21557,8114841,15.869565217391305
300,470,0,21558,8115311,15.666666666666666
270,398,0,21559,8115709,14.74074074074074
370,587,0,21560,8116296,15.864864864864865
350,641,0,21561,8116937,18.314285714285713
330,543,0,21562,8117480,16.454545454545453
120,141,0,21563,8117621,11.75
220,319,0,21564,8117940,14.5
450,740,0,21565,8118680,16.444444444444443
310,379,0,21566,8119059,12.225806451612904
130,188,0,21567,8119247,14.461538461538462
290,425,0,21568,8119672,14.655172413793103
400,583,0,21569,8120255,14.575
320,516,0,21570,8120771,16.125
190,240,0,21571,8121011,12.631578947368421
440,747,0,21572,8121758,16.977272727272727
420,683,0,21573,8122441,16.261904761904763
360,516,0,21574,8122957,14.333333333333334
250,412,0,21575,8123369,16.48
270,362,0,21576,8123731,13.407407407407407
370,543,0,21577,8124274,14.675675675675675
130,164,0,21578,8124438,12.615384615384615
250,397,0,21579,8124835,15.88
140,177,0,21580,8125012,12.642857142857142
500,788,0,21581,8125800,15.76
390,506,0,21582,8126306,12.974358974358974
220,249,0,21583,8126555,11.318181818181818
370,570,0,21584,8127125,15.405405405405405
290,441,0,21585,8127566,15.206896551724139
310,454,0,21586,8128020,14.64516129032258
220,285,0,21587,8128305,12.954545454545455
160,214,0,21588,8128519,13.375
80,77,0,21589,8128596,9.625
360,526,0,21590,8129122,14.61111111111111
370,638,0,21591,8129760,17.243243243243242
150,170,0,21592,8129930,11.333333333333334
220,287,0,21593,8130217,13.045454545454545
200,257,0,21594,8130474,12.85
230,396,0,21595,8130870,17.217391304347824
150,215,0,21596,8131085,14.333333333333334
300,404,0,21597,8131489,13.466666666666667
300,396,0,21598,8131885,13.2
210,343,0,21599,8132228,16.333333333333332
270,378,0,21600,8132606,14.0
440,677,0,21601,8133283,15.386363636363637
190,244,0,21602,8133527,12.842105263157896
270,400,0,21603,8133927,14.814814814814815
180,215,0,21604,8134142,11.944444444444445
240,372,0,21605,8134514,15.5
150,242,0,21606,8134756,16.133333333333333
170,226,0,21607,8134982,13.294117647058824
110,167,0,21608,8135149,15.181818181818182
300,395,0,21609,8135544,13.166666666666666
220,259,0,21610,8135803,11.772727272727273
230,326,0,21611,8136129,14.173913043478262
440,681,0,21612,8136810,15.477272727272727
280,425,0,21613,8137235,15.178571428571429
120,209,0,21614,8137444,17.416666666666668
290,397,0,21615,8137841,13.689655172413794
390,603,0,21616,8138444,15.461538461538462
270,431,0,21617,8138875,15.962962962962964
210,269,0,21618,8139144,12.80952380952381
150,178,0,21619,8139322,11.866666666666667
130,178,0,21620,8139500,13.692307692307692
390,566,0,21621,8140066,14.512820512820513
190,284,0,21622,8140350,14.947368421052632
170,280,0,21623,8140630,16.470588235294116
220,332,0,21624,8140962,15.090909090909092
100,137,0,21625,8141099,13.7
180,272,0,21626,8141371,15.11111111111111
130,206,0,21627,8141577,15.846153846153847
130,161,0,21628,8141738,12.384615384615385
230,347,0,21629,8142085,15.08695652173913
230,323,0,21630,8142408,14.043478260869565
530,841,0,21631,8143249,15.867924528301886
260,327,0,21632,8143576,12.576923076923077
160,216,0,21633,8143792,13.5
240,381,0,21634,8144173,15.875
240,313,0,21635,8144486,13.041666666666666
170,208,0,21636,8144694,12.235294117647058
380,557,0,21637,8145251,14.657894736842104
310,459,0,21638,8145710,14.806451612903226
220,253,0,21639,8145963,11.5
430,672,0,21640,8146635,15.627906976744185
310,476,0,21641,8147111,15.35483870967742
190,310,0,21642,8147421,16.31578947368421
260,379,0,21643,8147800,14.576923076923077
280,461,0,21644,8148261,16.464285714285715
200,264,0,21645,8148525,13.2
280,429,0,21646,8148954,15.321428571428571
250,330,0,21647,8149284,13.2
430,706,0,21648,8149990,16.41860465116279
290,407,0,21649,8150397,14.03448275862069
320,485,0,21650,8150882,15.15625
370,546,0,21651,8151428,14.756756756756756
170,199,0,21652,8151627,11.705882352941176
60,58,0,21653,8151685,9.666666666666666
270,374,0,21654,8152059,13.851851851851851
270,401,0,21655,8152460,14.851851851851851
420,638,0,21656,8153098,15.19047619047619
250,396,0,21657,8153494,15.84
270,366,0,21658,8153860,13.555555555555555
180,252,0,21659,8154112,14.0
230,353,0,21660,8154465,15.347826086956522
210,346,0,21661,8154811,16.476190476190474
290,436,0,21662,8155247,15.03448275862069
150,171,0,21663,8155418,11.4
220,336,0,21664,8155754,15.272727272727273
240,369,0,21665,8156123,15.375
180,225,0,21666,8156348,12.5
220,359,0,21667,8156707,16.318181818181817
330,534,0,21668,8157241,16.181818181818183
230,327,0,21669,8157568,14.217391304347826
400,655,0,21670,8158223,16.375
190,230,0,21671,8158453,12.105263157894736
80,130,0,21672,8158583,16.25
140,208,0,21673,8158791,14.857142857142858
190,277,0,21674,8159068,14.578947368421053
180,281,0,21675,8159349,15.61111111111111
390,568,0,21676,8159917,14.564102564102564
240,337,0,21677,8160254,14.041666666666666
410,702,0,21678,8160956,17.121951219512194
210,285,0,21679,8161241,13.571428571428571
210,310,0,21680,8161551,14.761904761904763
130,83,0,21681,8161634,6.384615384615385
150,194,0,21682,8161828,12.933333333333334
150,197,0,21683,8162025,13.133333333333333
130,201,0,21684,8162226,15.461538461538462
140,210,0,21685,8162436,15.0
80,79,0,21686,8162515,9.875
110,160,0,21687,8162675,14.545454545454545
210,301,0,21688,8162976,14.333333333333334
170,216,0,21689,8163192,12.705882352941176
270,414,0,21690,8163606,15.333333333333334
310,483,0,21691,8164089,15.580645161290322
230,353,0,21692,8164442,15.347826086956522
160,254,0,21693,8164696,15.875
200,282,0,21694,8164978,14.1
140,181,0,21695,8165159,12.928571428571429
190,275,0,21696,8165434,14.473684210526315
380,518,0,21697,8165952,13.631578947368421
150,182,0,21698,8166134,12.133333333333333
270,335,0,21699,8166469,12.407407407407407
220,312,0,21700,8166781,14.181818181818182
110,182,0,21701,8166963,16.545454545454547
190,263,0,21702,8167226,13.842105263157896
360,603,0,21703,8167829,16.75
140,213,0,21704,8168042,15.214285714285714
160,240,0,21705,8168282,15.0
300,434,0,21706,8168716,14.466666666666667
390,571,0,21707,8169287,14.64102564102564
160,196,0,21708,8169483,12.25
320,429,0,21709,8169912,13.40625
260,400,0,21710,8170312,15.384615384615385
290,467,0,21711,8170779,16.103448275862068
130,143,0,21712,8170922,11.0
180,269,0,21713,8171191,14.944444444444445
280,365,0,21714,8171556,13.035714285714286
280,381,0,21715,8171937,13.607142857142858
210,246,0,21716,8172183,11.714285714285714
240,410,0,21717,8172593,17.083333333333332
150,203,0,21718,8172796,13.533333333333333
250,432,0,21719,8173228,17.28
250,370,0,21720,8173598,14.8
220,325,0,21721,8173923,14.772727272727273
290,487,0,21722,8174410,16.79310344827586
420,754,0,21723,8175164,17.952380952380953
130,204,0,21724,8175368,15.692307692307692
340,504,0,21725,8175872,14.823529411764707
410,519,0,21726,8176391,12.658536585365853
260,475,0,21727,8176866,18.26923076923077
150,216,0,21728,8177082,14.4
100,103,0,21729,8177185,10.3
210,266,0,21730,8177451,12.666666666666666
240,315,0,21731,8177766,13.125
50,36,0,21732,8177802,7.2
240,352,0,21733,8178154,14.666666666666666
250,380,0,21734,8178534,15.2
100,108,0,21735,8178642,10.8
200,286,0,21736,8178928,14.3
120,136,0,21737,8179064,11.333333333333334
360,524,0,21738,8179588,14.555555555555555
120,124,0,21739,8179712,10.333333333333334
400,637,0,21740,8180349,15.925
270,373,0,21741,8180722,13.814814814814815
190,285,0,21742,8181007,15.0
420,643,0,21743,8181650,15.30952380952381
210,336,0,21744,8181986,16.0
250,409,0,21745,8182395,16.36
150,250,0,21746,8182645,16.666666666666668
250,287,0,21747,8182932,11.48
200,321,0,21748,8183253,16.05
120,169,0,21749,8183422,14.083333333333334
370,586,0,21750,8184008,15.837837837837839
260,386,0,21751,8184394,14.846153846153847
120,199,0,21752,8184593,16.583333333333332
170,276,0,21753,8184869,16.235294117647058
320,520,0,21754,8185389,16.25
190,250,0,21755,8185639,13.157894736842104
200,363,0,21756,8186002,18.15
210,327,0,21757,8186329,15.571428571428571
180,269,0,21758,8186598,14.944444444444445
340,488,0,21759,8187086,14.352941176470589
270,449,0,21760,8187535,16.62962962962963
120,150,0,21761,8187685,12.5
240,345,0,21762,8188030,14.375
350,572,0,21763,8188602,16.34285714285714
280,413,0,21764,8189015,14.75
100,119,0,21765,8189134,11.9
230,349,0,21766,8189483,15.173913043478262
300,425,0,21767,8189908,14.166666666666666
160,188,0,21768,8190096,11.75
220,315,0,21769,8190411,14.318181818181818
280,407,0,21770,8190818,14.535714285714286
390,572,0,21771,8191390,14.666666666666666
180,210,0,21772,8191600,11.666666666666666
380,500,0,21773,8192100,13.157894736842104
320,418,0,21774,8192518,13.0625
200,297,0,21775,8192815,14.85
200,249,0,21776,8193064,12.45
140,205,0,21777,8193269,14.642857142857142
230,341,0,21778,8193610,14.826086956521738
210,247,0,21779,8193857,11.761904761904763
300,487,0,21780,8194344,16.233333333333334
170,230,0,21781,8194574,13.529411764705882
340,563,0,21782,8195137,16.558823529411764
250,370,0,21783,8195507,14.8
300,452,0,21784,8195959,15.066666666666666
90,94,0,21785,8196053,10.444444444444445
410,567,0,21786,8196620,13.829268292682928
220,320,0,21787,8196940,14.545454545454545
200,270,0,21788,8197210,13.5
420,681,0,21789,8197891,16.214285714285715
250,436,0,21790,8198327,17.44
330,556,0,21791,8198883,16.848484848484848
140,178,0,21792,8199061,12.714285714285714
90,103,0,21793,8199164,11.444444444444445
160,216,0,21794,8199380,13.5
90,91,0,21795,8199471,10.11111111111111
100,129,0,21796,8199600,12.9
440,673,0,21797,8200273,15.295454545454545
280,396,0,21798,8200669,14.142857142857142
250,306,0,21799,8200975,12.24
200,293,0,21800,8201268,14.65
320,528,0,21801,8201796,16.5
200,299,0,21802,8202095,14.95
160,227,0,21803,8202322,14.1875
180,249,0,21804,8202571,13.833333333333334
230,372,0,21805,8202943,16.17391304347826
140,217,0,21806,8203160,15.5
240,332,0,21807,8203492,13.833333333333334
240,377,0,21808,8203869,15.708333333333334
290,475,0,21809,8204344,16.379310344827587
430,706,0,21810,8205050,16.41860465116279
140,195,0,21811,8205245,13.928571428571429
320,506,0,21812,8205751,15.8125
270,462,0,21813,8206213,17.11111111111111
210,310,0,21814,8206523,14.761904761904763
100,173,0,21815,8206696,17.3
410,614,0,21816,8207310,14.975609756097562
180,242,0,21817,8207552,13.444444444444445
250,401,0,21818,8207953,16.04
280,393,0,21819,8208346,14.035714285714286
220,258,0,21820,8208604,11.727272727272727
230,346,0,21821,8208950,15.043478260869565
60,47,0,21822,8208997,7.833333333333333
250,381,0,21823,8209378,15.24
150,228,0,21824,8209606,15.2
220,332,0,21825,8209938,15.090909090909092
110,120,0,21826,8210058,10.909090909090908
250,409,0,21827,8210467,16.36
440,676,0,21828,8211143,15.363636363636363
240,356,0,21829,8211499,14.833333333333334
290,478,0,21830,8211977,16.482758620689655
130,202,0,21831,8212179,15.538461538461538
150,182,0,21832,8212361,12.133333333333333
190,272,0,21833,8212633,14.31578947368421
160,221,0,21834,8212854,13.8125
250,369,0,21835,8213223,14.76
290,386,0,21836,8213609,13.310344827586206
270,431,0,21837,8214040,15.962962962962964
180,240,0,21838,8214280,13.333333333333334
250,363,0,21839,8214643,14.52
230,283,0,21840,8214926,12.304347826086957
120,170,0,21841,8215096,14.166666666666666
80,79,0,21842,8215175,9.875
210,260,0,21843,8215435,12.380952380952381
180,201,0,21844,8215636,11.166666666666666
220,301,0,21845,8215937,13.681818181818182
240,368,0,21846,8216305,15.333333333333334
390,664,0,21847,8216969,17.025641025641026
220,402,0,21848,8217371,18.272727272727273
160,232,0,21849,8217603,14.5
410,633,0,21850,8218236,15.439024390243903
360,590,0,21851,8218826,16.38888888888889
260,392,0,21852,8219218,15.076923076923077
290,409,0,21853,8219627,14.10344827586207
230,348,0,21854,8219975,15.130434782608695
300,456,0,21855,8220431,15.2
290,378,0,21856,8220809,13.03448275862069
320,557,0,21857,8221366,17.40625
190,260,0,21858,8221626,13.68421052631579
310,504,0,21859,8222130,16.258064516129032
170,315,0,21860,8222445,18.529411764705884
140,199,0,21861,8222644,14.214285714285714
150,207,0,21862,8222851,13.8
320,450,0,21863,8223301,14.0625
170,268,0,21864,8223569,15.764705882352942
200,267,0,21865,8223836,13.35
350,585,0,21866,8224421,16.714285714285715
290,367,0,21867,8224788,12.655172413793103
250,365,0,21868,8225153,14.6
210,330,0,21869,8225483,15.714285714285714
330,459,0,21870,8225942,13.909090909090908
230,378,0,21871,8226320,16.434782608695652
490,874,0,21872,8227194,17.836734693877553
300,476,0,21873,8227670,15.866666666666667
200,270,0,21874,8227940,13.5
60,59,0,21875,8227999,9.833333333333334
180,236,0,21876,8228235,13.11111111111111
390,621,0,21877,8228856,15.923076923076923
250,290,0,21878,8229146,11.6
290,402,0,21879,8229548,13.862068965517242
80,96,0,21880,8229644,12.0
220,304,0,21881,8229948,13.818181818181818
340,448,0,21882,8230396,13.176470588235293
240,306,0,21883,8230702,12.75
210,274,0,21884,8230976,13.047619047619047
240,366,0,21885,8231342,15.25
130,230,0,21886,8231572,17.692307692307693
370,571,0,21887,8232143,15.432432432432432
300,429,0,21888,8232572,14.3
220,244,0,21889,8232816,11.090909090909092
90,139,0,21890,8232955,15.444444444444445
200,246,0,21891,8233201,12.3
290,390,0,21892,8233591,13.448275862068966
180,267,0,21893,8233858,14.833333333333334
290,433,0,21894,8234291,14.931034482758621
330,506,0,21895,8234797,15.333333333333334
400,550,0,21896,8235347,13.75
380,562,0,21897,8235909,14.789473684210526
110,127,0,21898,8236036,11.545454545454545
130,165,0,21899,8236201,12.692307692307692
290,401,0,21900,8236602,13.827586206896552
160,277,0,21901,8236879,17.3125
80,107,0,21902,8236986,13.375
210,292,0,21903,8237278,13.904761904761905
240,351,0,21904,8237629,14.625
160,206,0,21905,8237835,12.875
250,402,0,21906,8238237,16.08
190,314,0,21907,8238551,16.526315789473685
140,181,0,21908,8238732,12.928571428571429
220,304,0,21909,8239036,13.818181818181818
240,350,0,21910,8239386,14.583333333333334
290,395,0,21911,8239781,13.620689655172415
330,438,0,21912,8240219,13.272727272727273
400,678,0,21913,8240897,16.95
470,869,0,21914,8241766,18.48936170212766
140,151,0,21915,8241917,10.785714285714286
270,476,0,21916,8242393,17.62962962962963
190,307,0,21917,8242700,16.157894736842106
220,277,0,21918,8242977,12.590909090909092
210,274,0,21919,8243251,13.047619047619047
390,697,0,21920,8243948,17.871794871794872
320,507,0,21921,8244455,15.84375
340,508,0,21922,8244963,14.941176470588236
210,311,0,21923,8245274,14.80952380952381
300,478,0,21924,8245752,15.933333333333334
270,395,0,21925,8246147,14.62962962962963
340,576,0,21926,8246723,16.941176470588236
250,389,0,21927,8247112,15.56
440,701,0,21928,8247813,15.931818181818182
550,697,0,21929,8248510,12.672727272727272
160,243,0,21930,8248753,15.1875
250,339,0,21931,8249092,13.56
410,655,0,21932,8249747,15.975609756097562
210,331,0,21933,8250078,15.761904761904763
310,494,0,21934,8250572,15.935483870967742
340,474,0,21935,8251046,13.941176470588236
150,212,0,21936,8251258,14.133333333333333
130,205,0,21937,8251463,15.76923076923077
160,256,0,21938,8251719,16.0
210,310,0,21939,8252029,14.761904761904763
150,230,0,21940,8252259,15.333333333333334
330,537,0,21941,8252796,16.272727272727273
260,380,0,21942,8253176,14.615384615384615
310,514,0,21943,8253690,16.580645161290324
260,434,0,21944,8254124,16.692307692307693
360,534,0,21945,8254658,14.833333333333334
230,363,0,21946,8255021,15.782608695652174
180,261,0,21947,8255282,14.5
220,347,0,21948,8255629,15.772727272727273
260,429,0,21949,8256058,16.5
270,495,0,21950,8256553,18.333333333333332
180,239,0,21951,8256792,13.277777777777779
470,655,0,21952,8257447,13.936170212765957
130,121,0,21953,8257568,9.307692307692308
470,849,0,21954,8258417,18.06382978723404
170,233,0,21955,8258650,13.705882352941176
250,415,0,21956,8259065,16.6
350,596,0,21957,8259661,17.02857142857143
200,251,0,21958,8259912,12.55
350,536,0,21959,8260448,15.314285714285715
210,317,0,21960,8260765,15.095238095238095
250,362,0,21961,8261127,14.48
130,173,0,21962,8261300,13.307692307692308
230,312,0,21963,8261612,13.565217391304348
260,379,0,21964,8261991,14.576923076923077
160,220,0,21965,8262211,13.75
320,445,0,21966,8262656,13.90625
280,408,0,21967,8263064,14.571428571428571
340,515,0,21968,8263579,15.147058823529411
340,580,0,21969,8264159,17.058823529411764
280,325,0,21970,8264484,11.607142857142858
260,398,0,21971,8264882,15.307692307692308
230,391,0,21972,8265273,17.0
420,720,0,21973,8265993,17.142857142857142
250,409,0,21974,8266402,16.36
360,558,0,21975,8266960,15.5
160,216,0,21976,8267176,13.5
390,597,0,21977,8267773,15.307692307692308
220,310,0,21978,8268083,14.090909090909092
440,639,0,21979,8268722,14.522727272727273
120,152,0,21980,8268874,12.666666666666666
230,396,0,21981,8269270,17.217391304347824
210,281,0,21982,8269551,13.380952380952381
190,290,0,21983,8269841,15.263157894736842
250,379,0,21984,8270220,15.16
200,239,0,21985,8270459,11.95
200,229,0,21986,8270688,11.45
150,202,0,21987,8270890,13.466666666666667
350,549,0,21988,8271439,15.685714285714285
190,254,0,21989,8271693,13.368421052631579
450,705,0,21990,8272398,15.666666666666666
130,126,0,21991,8272524,9.692307692307692
160,216,0,21992,8272740,13.5
200,263,0,21993,8273003,13.15
200,309,0,21994,8273312,15.45
170,268,0,21995,8273580,15.764705882352942
400,672,0,21996,8274252,16.8
280,439,0,21997,8274691,15.678571428571429
280,380,0,21998,8275071,13.571428571428571
140,177,0,21999,8275248,12.642857142857142
110,121,0,22000,8275369,11.0
410,789,0,22001,8276158,19.24390243902439
220,328,0,22002,8276486,14.909090909090908
180,283,0,22003,8276769,15.722222222222221
370,613,0,22004,8277382,16.56756756756757
430,730,0,22005,8278112,16.976744186046513
370,592,0,22006,8278704,16.0
160,233,0,22007,8278937,14.5625
310,471,0,22008,8279408,15.193548387096774
360,547,0,22009,8279955,15.194444444444445
310,539,0,22010,8280494,17.387096774193548
210,265,0,22011,8280759,12.619047619047619
180,247,0,22012,8281006,13.722222222222221
180,280,0,22013,8281286,15.555555555555555
50,64,0,22014,8281350,12.8
200,302,0,22015,8281652,15.1
360,549,0,22016,8282201,15.25
300,561,0,22017,8282762,18.7
330,511,0,22018,8283273,15.484848484848484
470,723,0,22019,8283996,15.382978723404255
120,126,0,22020,8284122,10.5
150,238,0,22021,8284360,15.866666666666667
350,565,0,22022,8284925,16.142857142857142
350,514,0,22023,8285439,14.685714285714285
370,541,0,22024,8285980,14.621621621621621
280,365,0,22025,8286345,13.035714285714286
480,742,0,22026,8287087,15.458333333333334
180,291,0,22027,8287378,16.166666666666668
180,252,0,22028,8287630,14.0
160,195,0,22029,8287825,12.1875
340,463,0,22030,8288288,13.617647058823529
120,139,0,22031,8288427,11.583333333333334
270,315,0,22032,8288742,11.666666666666666
220,349,0,22033,8289091,15.863636363636363
220,294,0,22034,8289385,13.363636363636363
330,448,0,22035,8289833,13.575757575757576
260,405,0,22036,8290238,15.576923076923077
430,754,0,22037,8290992,17.53488372093023
230,390,0,22038,8291382,16.956521739130434
370,592,0,22039,8291974,16.0
90,80,0,22040,8292054,8.88888888888889
350,522,0,22041,8292576,14.914285714285715
280,343,0,22042,8292919,12.25
390,604,0,22043,8293523,15.487179487179487
150,212,0,22044,8293735,14.133333333333333
180,251,0,22045,8293986,13.944444444444445
200,272,0,22046,8294258,13.6
300,429,0,22047,8294687,14.3
310,475,0,22048,8295162,15.32258064516129
260,393,0,22049,8295555,15.115384615384615
330,486,0,22050,8296041,14.727272727272727
190,304,0,22051,8296345,16.0
200,293,0,22052,8296638,14.65
520,844,0,22053,8297482,16.23076923076923
350,593,0,22054,8298075,16.942857142857143
370,534,0,22055,8298609,14.432432432432432
220,276,0,22056,8298885,12.545454545454545
240,430,0,22057,8299315,17.916666666666668
220,309,0,22058,8299624,14.045454545454545
180,242,0,22059,8299866,13.444444444444445
200,297,0,22060,8300163,14.85
280,375,0,22061,8300538,13.392857142857142
190,268,0,22062,8300806,14.105263157894736
150,196,0,22063,8301002,13.066666666666666
160,219,0,22064,8301221,13.6875
290,378,0,22065,8301599,13.03448275862069
390,718,0,22066,8302317,18.41025641025641
300,513,0,22067,8302830,17.1
150,208,0,22068,8303038,13.866666666666667
250,347,0,22069,8303385,13.88
220,323,0,22070,8303708,14.681818181818182
160,194,0,22071,8303902,12.125
400,665,0,22072,8304567,16.625
210,235,0,22073,8304802,11.19047619047619
190,226,0,22074,8305028,11.894736842105264
370,547,0,22075,8305575,14.783783783783784
100,131,0,22076,8305706,13.1
340,486,0,22077,8306192,14.294117647058824
210,293,0,22078,8306485,13.952380952380953
110,191,0,22079,8306676,17.363636363636363
290,380,0,22080,8307056,13.10344827586207
140,213,0,22081,8307269,15.214285714285714
240,412,0,22082,8307681,17.166666666666668
280,431,0,22083,8308112,15.392857142857142
240,375,0,22084,8308487,15.625
290,396,0,22085,8308883,13.655172413793103
140,164,0,22086,8309047,11.714285714285714
130,199,0,22087,8309246,15.307692307692308
190,285,0,22088,8309531,15.0
250,386,0,22089,8309917,15.44
270,399,0,22090,8310316,14.777777777777779
290,477,0,22091,8310793,16.448275862068964
240,318,0,22092,8311111,13.25
200,308,0,22093,8311419,15.4
220,381,0,22094,8311800,17.318181818181817
310,557,0,22095,8312357,17.967741935483872
190,255,0,22096,8312612,13.421052631578947
580,1003,0,22097,8313615,17.29310344827586
210,378,0,22098,8313993,18.0
200,316,0,22099,8314309,15.8
320,459,0,22100,8314768,14.34375
330,478,0,22101,8315246,14.484848484848484
220,319,0,22102,8315565,14.5
270,324,0,22103,8315889,12.0
430,657,0,22104,8316546,15.279069767441861
360,582,0,22105,8317128,16.166666666666668
200,217,0,22106,8317345,10.85
330,479,0,22107,8317824,14.515151515151516
210,264,0,22108,8318088,12.571428571428571
230,302,0,22109,8318390,13.130434782608695
330,505,0,22110,8318895,15.303030303030303
240,325,0,22111,8319220,13.541666666666666
220,354,0,22112,8319574,16.09090909090909
190,176,0,22113,8319750,9.263157894736842
280,465,0,22114,8320215,16.607142857142858
220,323,0,22115,8320538,14.681818181818182
80,89,0,22116,8320627,11.125
220,311,0,22117,8320938,14.136363636363637
290,393,0,22118,8321331,13.551724137931034
410,645,0,22119,8321976,15.731707317073171
260,345,0,22120,8322321,13.26923076923077
270,403,0,22121,8322724,14.925925925925926
320,521,0,22122,8323245,16.28125
330,477,0,22123,8323722,14.454545454545455
240,329,0,22124,8324051,13.708333333333334
310,436,0,22125,8324487,14.064516129032258
270,384,0,22126,8324871,14.222222222222221
270,468,0,22127,8325339,17.333333333333332
160,208,0,22128,8325547,13.0
190,282,0,22129,8325829,14.842105263157896
240,387,0,22130,8326216,16.125
380,637,0,22131,8326853,16.763157894736842
120,154,0,22132,8327007,12.833333333333334
290,387,0,22133,8327394,13.344827586206897
180,257,0,22134,8327651,14.277777777777779
280,411,0,22135,8328062,14.678571428571429
290,436,0,22136,8328498,15.03448275862069
270,494,0,22137,8328992,18.296296296296298
290,507,0,22138,8329499,17.482758620689655
130,182,0,22139,8329681,14.0
260,372,0,22140,8330053,14.307692307692308
200,285,0,22141,8330338,14.25
160,306,0,22142,8330644,19.125
380,587,0,22143,8331231,15.447368421052632
200,287,0,22144,8331518,14.35
350,603,0,22145,8332121,17.228571428571428
210,237,0,22146,8332358,11.285714285714286
130,147,0,22147,8332505,11.307692307692308
280,457,0,22148,8332962,16.321428571428573
330,449,0,22149,8333411,13.606060606060606
70,105,0,22150,8333516,15.0
260,411,0,22151,8333927,15.807692307692308
430,687,0,22152,8334614,15.976744186046512
110,142,0,22153,8334756,12.909090909090908
180,252,0,22154,8335008,14.0
220,252,0,22155,8335260,11.454545454545455
220,333,0,22156,8335593,15.136363636363637
320,472,0,22157,8336065,14.75
290,395,0,22158,8336460,13.620689655172415
280,375,0,22159,8336835,13.392857142857142
250,305,0,22160,8337140,12.2
350,517,0,22161,8337657,14.771428571428572
430,594,0,22162,8338251,13.813953488372093
370,673,0,22163,8338924,18.18918918918919
250,321,0,22164,8339245,12.84
490,890,0,22165,8340135,18.163265306122447
300,347,0,22166,8340482,11.566666666666666
200,273,0,22167,8340755,13.65
80,124,0,22168,8340879,15.5
370,553,0,22169,8341432,14.945945945945946
130,153,0,22170,8341585,11.76923076923077
260,426,0,22171,8342011,16.384615384615383
440,791,0,22172,8342802,17.977272727272727
160,213,0,22173,8343015,13.3125
240,331,0,22174,8343346,13.791666666666666
200,299,0,22175,8343645,14.95
240,393,0,22176,8344038,16.375
140,209,0,22177,8344247,14.928571428571429
160,212,0,22178,8344459,13.25
660,1175,0,22179,8345634,17.803030303030305
340,524,0,22180,8346158,15.411764705882353
310,485,0,22181,8346643,15.64516129032258
460,759,0,22182,8347402,16.5
50,57,0,22183,8347459,11.4
290,450,0,22184,8347909,15.517241379310345
290,379,0,22185,8348288,13.068965517241379
180,256,0,22186,8348544,14.222222222222221
240,398,0,22187,8348942,16.583333333333332
320,416,0,22188,8349358,13.0
220,357,0,22189,8349715,16.227272727272727
200,251,0,22190,8349966,12.55
290,505,0,22191,8350471,17.413793103448278
230,351,0,22192,8350822,15.26086956521739
170,275,0,22193,8351097,16.176470588235293
210,313,0,22194,8351410,14.904761904761905
220,367,0,22195,8351777,16.681818181818183
390,649,0,22196,8352426,16.641025641025642
340,510,0,22197,8352936,15.0
440,733,0,22198,8353669,16.65909090909091
160,219,0,22199,8353888,13.6875
270,431,0,22200,8354319,15.962962962962964
410,563,0,22201,8354882,13.731707317073171
440,689,0,22202,8355571,15.659090909090908
200,252,0,22203,8355823,12.6
400,628,0,22204,8356451,15.7
260,346,0,22205,8356797,13.307692307692308
250,317,0,22206,8357114,12.68
250,418,0,22207,8357532,16.72
200,257,0,22208,8357789,12.85
180,244,0,22209,8358033,13.555555555555555
130,208,0,22210,8358241,16.0
100,128,0,22211,8358369,12.8
280,364,0,22212,8358733,13.0
280,466,0,22213,8359199,16.642857142857142
170,252,0,22214,8359451,14.823529411764707
240,340,0,22215,8359791,14.166666666666666
190,267,0,22216,8360058,14.052631578947368
140,205,0,22217,8360263,14.642857142857142
320,534,0,22218,8360797,16.6875
300,493,0,22219,8361290,16.433333333333334
400,691,0,22220,8361981,17.275
300,429,0,22221,8362410,14.3
190,181,0,22222,8362591,9.526315789473685
140,209,0,22223,8362800,14.928571428571429
140,216,0,22224,8363016,15.428571428571429
270,347,0,22225,8363363,12.851851851851851
380,631,0,22226,8363994,16.605263157894736
230,278,0,22227,8364272,12.08695652173913
190,253,0,22228,8364525,13.31578947368421
170,245,0,22229,8364770,14.411764705882353
350,528,0,22230,8365298,15.085714285714285
370,656,0,22231,8365954,17.72972972972973
310,494,0,22232,8366448,15.935483870967742
380,569,0,22233,8367017,14.973684210526315
100,159,0,22234,8367176,15.9
330,554,0,22235,8367730,16.78787878787879
270,394,0,22236,8368124,14.592592592592593
130,201,0,22237,8368325,15.461538461538462
250,353,0,22238,8368678,14.12
200,241,0,22239,8368919,12.05
320,461,0,22240,8369380,14.40625
190,248,0,22241,8369628,13.052631578947368
300,441,0,22242,8370069,14.7
360,584,0,22243,8370653,16.22222222222222
270,409,0,22244,8371062,15.148148148148149
90,116,0,22245,8371178,12.88888888888889
270,379,0,22246,8371557,14.037037037037036
340,506,0,22247,8372063,14.882352941176471
220,333,0,22248,8372396,15.136363636363637
200,216,0,22249,8372612,10.8
200,265,0,22250,8372877,13.25
240,361,0,22251,8373238,15.041666666666666
230,361,0,22252,8373599,15.695652173913043
270,439,0,22253,8374038,16.25925925925926
160,219,0,22254,8374257,13.6875
150,263,0,22255,8374520,17.533333333333335
180,278,0,22256,8374798,15.444444444444445
170,225,0,22257,8375023,13.235294117647058
270,402,0,22258,8375425,14.88888888888889
130,147,0,22259,8375572,11.307692307692308
310,431,0,22260,8376003,13.903225806451612
210,331,0,22261,8376334,15.761904761904763
60,98,0,22262,8376432,16.333333333333332
110,168,0,22263,8376600,15.272727272727273
230,330,0,22264,8376930,14.347826086956522
200,307,0,22265,8377237,15.35
180,252,0,22266,8377489,14.0
250,400,0,22267,8377889,16.0
100,182,0,22268,8378071,18.2
170,245,0,22269,8378316,14.411764705882353
330,472,0,22270,8378788,14.303030303030303
330,487,0,22271,8379275,14.757575757575758
580,1002,0,22272,8380277,17.275862068965516
390,644,0,22273,8380921,16.512820512820515
390,608,0,22274,8381529,15.58974358974359
400,556,0,22275,8382085,13.9
150,230,0,22276,8382315,15.333333333333334
380,526,0,22277,8382841,13.842105263157896
260,335,0,22278,8383176,12.884615384615385
330,527,0,22279,8383703,15.969696969696969
190,308,0,22280,8384011,16.210526315789473
280,335,0,22281,8384346,11.964285714285714
260,365,0,22282,8384711,14.038461538461538
260,318,0,22283,8385029,12.23076923076923
80,118,0,22284,8385147,14.75
450,743,0,22285,8385890,16.511111111111113
250,422,0,22286,8386312,16.88
210,337,0,22287,8386649,16.047619047619047
150,195,0,22288,8386844,13.0
170,231,0,22289,8387075,13.588235294117647
230,326,0,22290,8387401,14.173913043478262
240,401,0,22291,8387802,16.708333333333332
230,319,0,22292,8388121,13.869565217391305
250,390,0,22293,8388511,15.6
370,587,0,22294,8389098,15.864864864864865
300,519,0,22295,8389617,17.3
280,449,0,22296,8390066,16.035714285714285
320,600,0,22297,8390666,18.75
340,530,0,22298,8391196,15.588235294117647
380,572,0,22299,8391768,15.052631578947368
220,365,0,22300,8392133,16.59090909090909
280,410,0,22301,8392543,14.642857142857142
280,399,0,22302,8392942,14.25
170,234,0,22303,8393176,13.764705882352942
350,485,0,22304,8393661,13.857142857142858
260,452,0,22305,8394113,17.384615384615383
310,449,0,22306,8394562,14.483870967741936
310,536,0,22307,8395098,17.29032258064516
250,382,0,22308,8395480,15.28
540,971,0,22309,8396451,17.98148148148148
190,284,0,22310,8396735,14.947368421052632
230,365,0,22311,8397100,15.869565217391305
430,697,0,22312,8397797,16.209302325581394
220,330,0,22313,8398127,15.0
330,516,0,22314,8398643,15.636363636363637
130,173,0,22315,8398816,13.307692307692308
120,183,0,22316,8398999,15.25
210,346,0,22317,8399345,16.476190476190474
110,152,0,22318,8399497,13.818181818181818
310,428,0,22319,8399925,13.806451612903226
410,655,0,22320,8400580,15.975609756097562
240,348,0,22321,8400928,14.5
110,137,0,22322,8401065,12.454545454545455
160,266,0,22323,8401331,16.625
260,332,0,22324,8401663,12.76923076923077
170,231,0,22325,8401894,13.588235294117647
370,552,0,22326,8402446,14.91891891891892
380,604,0,22327,8403050,15.894736842105264
340,613,0,22328,8403663,18.029411764705884
400,611,0,22329,8404274,15.275
310,452,0,22330,8404726,14.580645161290322
170,209,0,22331,8404935,12.294117647058824
270,445,0,22332,8405380,16.48148148148148
110,125,0,22333,8405505,11.363636363636363
240,315,0,22334,8405820,13.125
180,301,0,22335,8406121,16.72222222222222
300,434,0,22336,8406555,14.466666666666667
240,325,0,22337,8406880,13.541666666666666
190,316,0,22338,8407196,16.63157894736842
210,267,0,22339,8407463,12.714285714285714
230,309,0,22340,8407772,13.434782608695652
360,575,0,22341,8408347,15.972222222222221
330,487,0,22342,8408834,14.757575757575758
440,692,0,22343,8409526,15.727272727272727
320,514,0,22344,8410040,16.0625
490,781,0,22345,8410821,15.938775510204081
320,466,0,22346,8411287,14.5625
230,325,0,22347,8411612,14.130434782608695
250,339,0,22348,8411951,13.56
500,816,0,22349,8412767,16.32
380,574,0,22350,8413341,15.105263157894736
210,260,0,22351,8413601,12.380952380952381
400,638,0,22352,8414239,15.95
150,162,0,22353,8414401,10.8
170,304,0,22354,8414705,17.88235294117647
320,437,0,22355,8415142,13.65625
280,466,0,22356,8415608,16.642857142857142
230,372,0,22357,8415980,16.17391304347826
210,318,0,22358,8416298,15.142857142857142
130,230,0,22359,8416528,17.692307692307693
240,340,0,22360,8416868,14.166666666666666
200,218,0,22361,8417086,10.9
210,271,0,22362,8417357,12.904761904761905
110,142,0,22363,8417499,12.909090909090908
290,403,0,22364,8417902,13.89655172413793
370,534,0,22365,8418436,14.432432432432432
240,298,0,22366,8418734,12.416666666666666
400,725,0,22367,8419459,18.125
300,423,0,22368,8419882,14.1
260,362,0,22369,8420244,13.923076923076923
290,428,0,22370,8420672,14.758620689655173
110,166,0,22371,8420838,15.090909090909092
310,488,0,22372,8421326,15.741935483870968
350,581,0,22373,8421907,16.6
120,168,0,22374,8422075,14.0
120,165,0,22375,8422240,13.75
340,583,0,22376,8422823,17.147058823529413
190,197,0,22377,8423020,10.368421052631579
240,351,0,22378,8423371,14.625
390,584,0,22379,8423955,14.974358974358974
270,399,0,22380,8424354,14.777777777777779
170,199,0,22381,8424553,11.705882352941176
190,228,0,22382,8424781,12.0
240,416,0,22383,8425197,17.333333333333332
440,639,0,22384,8425836,14.522727272727273
260,451,0,22385,8426287,17.346153846153847
360,452,0,22386,8426739,12.555555555555555
280,354,0,22387,8427093,12.642857142857142
290,452,0,22388,8427545,15.586206896551724
350,453,0,22389,8427998,12.942857142857143
220,330,0,22390,8428328,15.0
310,392,0,22391,8428720,12.64516129032258
160,242,0,22392,8428962,15.125
210,347,0,22393,8429309,16.523809523809526
330,462,0,22394,8429771,14.0
150,196,0,22395,8429967,13.066666666666666
290,430,0,22396,8430397,14.827586206896552
410,681,0,22397,8431078,16.609756097560975
90,125,0,22398,8431203,13.88888888888889
190,276,0,22399,8431479,14.526315789473685
370,502,0,22400,8431981,13.567567567567568
570,1013,0,22401,8432994,17.771929824561404
310,502,0,22402,8433496,16.193548387096776
370,584,0,22403,8434080,15.783783783783784
290,428,0,22404,8434508,14.758620689655173
320,472,0,22405,8434980,14.75
290,435,0,22406,8435415,15.0
380,554,0,22407,8435969,14.578947368421053
390,732,0,22408,8436701,18.76923076923077
330,527,0,22409,8437228,15.969696969696969
260,350,0,22410,8437578,13.461538461538462
290,472,0,22411,8438050,16.275862068965516
230,326,0,22412,8438376,14.173913043478262
120,187,0,22413,8438563,15.583333333333334
160,237,0,22414,8438800,14.8125
220,309,0,22415,8439109,14.045454545454545
170,237,0,22416,8439346,13.941176470588236
320,460,0,22417,8439806,14.375
160,239,0,22418,8440045,14.9375
420,712,0,22419,8440757,16.952380952380953
410,662,0,22420,8441419,16.146341463414632
150,221,0,22421,8441640,14.733333333333333
260,437,0,22422,8442077,16.807692307692307
240,322,0,22423,8442399,13.416666666666666
300,420,0,22424,8442819,14.0
210,298,0,22425,8443117,14.19047619047619
140,164,0,22426,8443281,11.714285714285714
270,406,0,22427,8443687,15.037037037037036
300,460,0,22428,8444147,15.333333333333334
400,624,0,22429,8444771,15.6
140,183,0,22430,8444954,13.071428571428571
240,371,0,22431,8445325,15.458333333333334
300,415,0,22432,8445740,13.833333333333334
230,398,0,22433,8446138,17.304347826086957
350,580,0,22434,8446718,16.571428571428573
280,386,0,22435,8447104,13.785714285714286
280,375,0,22436,8447479,13.392857142857142
170,214,0,22437,8447693,12.588235294117647
240,311,0,22438,8448004,12.958333333333334
180,268,0,22439,8448272,14.88888888888889
140,230,0,22440,8448502,16.428571428571427
300,496,0,22441,8448998,16.533333333333335
310,520,0,22442,8449518,16.774193548387096
440,688,0,22443,8450206,15.636363636363637
240,306,0,22444,8450512,12.75
210,279,0,22445,8450791,13.285714285714286
190,239,0,22446,8451030,12.578947368421053
270,391,0,22447,8451421,14.481481481481481
100,122,0,22448,8451543,12.2
360,593,0,22449,8452136,16.47222222222222
460,821,0,22450,8452957,17.847826086956523
220,344,0,22451,8453301,15.636363636363637
330,473,0,22452,8453774,14.333333333333334
230,360,0,22453,8454134,15.652173913043478
280,408,0,22454,8454542,14.571428571428571
350,586,0,22455,8455128,16.742857142857144
280,431,0,22456,8455559,15.392857142857142
260,399,0,22457,8455958,15.346153846153847
190,277,0,22458,8456235,14.578947368421053
240,372,0,22459,8456607,15.5
270,549,0,22460,8457156,20.333333333333332
210,335,0,22461,8457491,15.952380952380953
150,221,0,22462,8457712,14.733333333333333
350,512,0,22463,8458224,14.628571428571428
190,288,0,22464,8458512,15.157894736842104
390,575,0,22465,8459087,14.743589743589743
270,340,0,22466,8459427,12.592592592592593
170,275,0,22467,8459702,16.176470588235293
480,825,0,22468,8460527,17.1875
310,485,0,22469,8461012,15.64516129032258
110,140,0,22470,8461152,12.727272727272727
230,379,0,22471,8461531,16.47826086956522
180,290,0,22472,8461821,16.11111111111111
300,546,0,22473,8462367,18.2
280,346,0,22474,8462713,12.357142857142858
140,152,0,22475,8462865,10.857142857142858
90,159,0,22476,8463024,17.666666666666668
290,456,0,22477,8463480,15.724137931034482
290,445,0,22478,8463925,15.344827586206897
380,729,0,22479,8464654,19.18421052631579
210,395,0,22480,8465049,18.80952380952381
240,359,0,22481,8465408,14.958333333333334
170,242,0,22482,8465650,14.235294117647058
260,336,0,22483,8465986,12.923076923076923
360,534,0,22484,8466520,14.833333333333334
350,502,0,22485,8467022,14.342857142857143
400,591,0,22486,8467613,14.775
220,300,0,22487,8467913,13.636363636363637
290,443,0,22488,8468356,15.275862068965518
240,373,0,22489,8468729,15.541666666666666
140,193,0,22490,8468922,13.785714285714286
240,402,0,22491,8469324,16.75
240,387,0,22492,8469711,16.125
430,757,0,22493,8470468,17.6046511627907
340,524,0,22494,8470992,15.411764705882353
290,454,0,22495,8471446,15.655172413793103
320,497,0,22496,8471943,15.53125
140,227,0,22497,8472170,16.214285714285715
190,286,0,22498,8472456,15.052631578947368
300,416,0,22499,8472872,13.866666666666667
260,349,0,22500,8473221,13.423076923076923
300,406,0,22501,8473627,13.533333333333333
400,643,0,22502,8474270,16.075
130,204,0,22503,8474474,15.692307692307692
510,855,0,22504,8475329,16.764705882352942
330,457,0,22505,8475786,13.848484848484848
130,167,0,22506,8475953,12.846153846153847
100,95,0,22507,8476048,9.5
340,570,0,22508,8476618,16.764705882352942
160,211,0,22509,8476829,13.1875
370,635,0,22510,8477464,17.16216216216216
110,140,0,22511,8477604,12.727272727272727
250,395,0,22512,8477999,15.8
330,462,0,22513,8478461,14.0
340,530,0,22514,8478991,15.588235294117647
170,241,0,22515,8479232,14.176470588235293
150,225,0,22516,8479457,15.0
380,601,0,22517,8480058,15.81578947368421
280,431,0,22518,8480489,15.392857142857142
280,411,0,22519,8480900,14.678571428571429
320,460,0,22520,8481360,14.375
280,403,0,22521,8481763,14.392857142857142
320,519,0,22522,8482282,16.21875
270,351,0,22523,8482633,13.0
190,220,0,22524,8482853,11.578947368421053
280,453,0,22525,8483306,16.178571428571427
300,510,0,22526,8483816,17.0
210,272,0,22527,8484088,12.952380952380953
390,644,0,22528,8484732,16.512820512820515
120,192,0,22529,8484924,16.0
420,686,0,22530,8485610,16.333333333333332
220,355,0,22531,8485965,16.136363636363637
260,349,0,22532,8486314,13.423076923076923
360,543,0,22533,8486857,15.083333333333334
110,179,0,22534,8487036,16.272727272727273
260,358,0,22535,8487394,13.76923076923077
280,399,0,22536,8487793,14.25
220,317,0,22537,8488110,14.409090909090908
300,491,0,22538,8488601,16.366666666666667
330,555,0,22539,8489156,16.818181818181817
280,344,0,22540,8489500,12.285714285714286
350,460,0,22541,8489960,13.142857142857142
250,342,0,22542,8490302,13.68
300,488,0,22543,8490790,16.266666666666666
430,690,0,22544,8491480,16.046511627906977
220,364,0,22545,8491844,16.545454545454547
390,678,0,22546,8492522,17.384615384615383
200,299,0,22547,8492821,14.95
240,424,0,22548,8493245,17.666666666666668
210,263,0,22549,8493508,12.523809523809524
220,322,0,22550,8493830,14.636363636363637
390,571,0,22551,8494401,14.64102564102564
310,428,0,22552,8494829,13.806451612903226
220,364,0,22553,8495193,16.545454545454547
500,916,0,22554,8496109,18.32
300,401,0,22555,8496510,13.366666666666667
180,301,0,22556,8496811,16.72222222222222
130,193,0,22557,8497004,14.846153846153847
160,249,0,22558,8497253,15.5625
320,518,0,22559,8497771,16.1875
220,373,0,22560,8498144,16.954545454545453
260,380,0,22561,8498524,14.615384615384615
300,379,0,22562,8498903,12.633333333333333
270,373,0,22563,8499276,13.814814814814815
260,442,0,22564,8499718,17.0
170,273,0,22565,8499991,16.058823529411764
320,491,0,22566,8500482,15.34375
220,318,0,22567,8500800,14.454545454545455
200,295,0,22568,8501095,14.75
300,480,0,22569,8501575,16.0
130,174,0,22570,8501749,13.384615384615385
190,266,0,22571,8502015,14.0
240,363,0,22572,8502378,15.125
280,358,0,22573,8502736,12.785714285714286
250,360,0,22574,8503096,14.4
180,241,0,22575,8503337,13.38888888888889
250,387,0,22576,8503724,15.48
250,443,0,22577,8504167,17.72
170,304,0,22578,8504471,17.88235294117647
230,327,0,22579,8504798,14.217391304347826
260,345,0,22580,8505143,13.26923076923077
180,284,0,22581,8505427,15.777777777777779
280,342,0,22582,8505769,12.214285714285714
320,576,0,22583,8506345,18.0
290,409,0,22584,8506754,14.10344827586207
550,1078,0,22585,8507832,19.6
310,502,0,22586,8508334,16.193548387096776
380,626,0,22587,8508960,16.473684210526315
220,302,0,22588,8509262,13.727272727272727
110,114,0,22589,8509376,10.363636363636363
190,314,0,22590,8509690,16.526315789473685
200,309,0,22591,8509999,15.45
240,316,0,22592,8510315,13.166666666666666
430,829,0,22593,8511144,19.27906976744186
370,564,0,22594,8511708,15.243243243243244
280,425,0,22595,8512133,15.178571428571429
400,652,0,22596,8512785,16.3
320,436,0,22597,8513221,13.625
200,207,0,22598,8513428,10.35
160,226,0,22599,8513654,14.125
100,99,0,22600,8513753,9.9
160,205,0,22601,8513958,12.8125
200,269,0,22602,8514227,13.45
210,309,0,22603,8514536,14.714285714285714
190,248,0,22604,8514784,13.052631578947368
350,412,0,22605,8515196,11.771428571428572
210,236,0,22606,8515432,11.238095238095237
390,642,0,22607,8516074,16.46153846153846
180,269,0,22608,8516343,14.944444444444445
380,578,0,22609,8516921,15.210526315789474
220,299,0,22610,8517220,13.590909090909092
460,647,0,22611,8517867,14.065217391304348
210,340,0,22612,8518207,16.19047619047619
400,588,0,22613,8518795,14.7
180,238,0,22614,8519033,13.222222222222221
260,380,0,22615,8519413,14.615384615384615
280,401,0,22616,8519814,14.321428571428571
240,273,0,22617,8520087,11.375
220,284,0,22618,8520371,12.909090909090908
210,234,0,22619,8520605,11.142857142857142
230,362,0,22620,8520967,15.73913043478261
360,491,0,22621,8521458,13.63888888888889
290,410,0,22622,8521868,14.137931034482758
120,157,0,22623,8522025,13.083333333333334
280,384,0,22624,8522409,13.714285714285714
340,524,0,22625,8522933,15.411764705882353
360,495,0,22626,8523428,13.75
250,368,0,22627,8523796,14.72
250,379,0,22628,8524175,15.16
420,631,0,22629,8524806,15.023809523809524
190,279,0,22630,8525085,14.68421052631579
370,549,0,22631,8525634,14.837837837837839
140,234,0,22632,8525868,16.714285714285715
80,75,0,22633,8525943,9.375
200,228,0,22634,8526171,11.4
220,337,0,22635,8526508,15.318181818181818
150,196,0,22636,8526704,13.066666666666666
430,600,0,22637,8527304,13.953488372093023
310,455,0,22638,8527759,14.67741935483871
250,389,0,22639,8528148,15.56
380,625,0,22640,8528773,16.44736842105263
190,247,0,22641,8529020,13.0
150,213,0,22642,8529233,14.2
220,323,0,22643,8529556,14.681818181818182
330,540,0,22644,8530096,16.363636363636363
230,307,0,22645,8530403,13.347826086956522
100,136,0,22646,8530539,13.6
330,583,0,22647,8531122,17.666666666666668
250,311,0,22648,8531433,12.44
350,504,0,22649,8531937,14.4
290,374,0,22650,8532311,12.89655172413793
300,433,0,22651,8532744,14.433333333333334
200,292,0,22652,8533036,14.6
170,253,0,22653,8533289,14.882352941176471
140,195,0,22654,8533484,13.928571428571429
70,86,0,22655,8533570,12.285714285714286
360,534,0,22656,8534104,14.833333333333334
200,328,0,22657,8534432,16.4
260,410,0,22658,8534842,15.76923076923077
240,353,0,22659,8535195,14.708333333333334
120,147,0,22660,8535342,12.25
250,339,0,22661,8535681,13.56
120,136,0,22662,8535817,11.333333333333334
220,302,0,22663,8536119,13.727272727272727
180,279,0,22664,8536398,15.5
480,707,0,22665,8537105,14.729166666666666
130,181,0,22666,8537286,13.923076923076923
130,179,0,22667,8537465,13.76923076923077
170,253,0,22668,8537718,14.882352941176471
170,273,0,22669,8537991,16.058823529411764
250,366,0,22670,8538357,14.64
210,249,0,22671,8538606,11.857142857142858
200,272,0,22672,8538878,13.6
240,346,0,22673,8539224,14.416666666666666
340,503,0,22674,8539727,14.794117647058824
260,332,0,22675,8540059,12.76923076923077
340,474,0,22676,8540533,13.941176470588236
220,278,0,22677,8540811,12.636363636363637
280,353,0,22678,8541164,12.607142857142858
320,416,0,22679,8541580,13.0
230,295,0,22680,8541875,12.826086956521738
260,360,0,22681,8542235,13.846153846153847
240,292,0,22682,8542527,12.166666666666666
370,492,0,22683,8543019,13.297297297297296
60,95,0,22684,8543114,15.833333333333334
350,573,0,22685,8543687,16.37142857142857
230,313,0,22686,8544000,13.608695652173912
340,551,0,22687,8544551,16.205882352941178
230,348,0,22688,8544899,15.130434782608695
180,274,0,22689,8545173,15.222222222222221
270,403,0,22690,8545576,14.925925925925926
310,483,0,22691,8546059,15.580645161290322
340,570,0,22692,8546629,16.764705882352942
240,386,0,22693,8547015,16.083333333333332
220,274,0,22694,8547289,12.454545454545455
210,289,0,22695,8547578,13.761904761904763
250,382,0,22696,8547960,15.28
210,309,0,22697,8548269,14.714285714285714
270,455,0,22698,8548724,16.85185185185185
260,416,0,22699,8549140,16.0
300,481,0,22700,8549621,16.033333333333335
320,504,0,22701,8550125,15.75
350,543,0,22702,8550668,15.514285714285714
100,150,0,22703,8550818,15.0
80,63,0,22704,8550881,7.875
260,427,0,22705,8551308,16.423076923076923
190,293,0,22706,8551601,15.421052631578947
190,245,0,22707,8551846,12.894736842105264
180,263,0,22708,8552109,14.61111111111111
60,89,0,22709,8552198,14.833333333333334
170,266,0,22710,8552464,15.647058823529411
260,322,0,22711,8552786,12.384615384615385
200,303,0,22712,8553089,15.15
310,380,0,22713,8553469,12.258064516129032
360,512,0,22714,8553981,14.222222222222221
70,97,0,22715,8554078,13.857142857142858
200,245,0,22716,8554323,12.25
230,280,0,22717,8554603,12.173913043478262
210,278,0,22718,8554881,13.238095238095237
180,288,0,22719,8555169,16.0
360,548,0,22720,8555717,15.222222222222221
270,370,0,22721,8556087,13.703703703703704
230,340,0,22722,8556427,14.782608695652174
300,448,0,22723,8556875,14.933333333333334
240,338,0,22724,8557213,14.083333333333334
220,320,0,22725,8557533,14.545454545454545
190,258,0,22726,8557791,13.578947368421053
190,257,0,22727,8558048,13.526315789473685
170,214,0,22728,8558262,12.588235294117647
100,124,0,22729,8558386,12.4
160,198,0,22730,8558584,12.375
200,230,0,22731,8558814,11.5
200,266,0,22732,8559080,13.3
210,275,0,22733,8559355,13.095238095238095
250,422,0,22734,8559777,16.88
300,426,0,22735,8560203,14.2
190,230,0,22736,8560433,12.105263157894736
240,363,0,22737,8560796,15.125
220,304,0,22738,8561100,13.818181818181818
400,584,0,22739,8561684,14.6
290,431,0,22740,8562115,14.862068965517242
380,645,0,22741,8562760,16.973684210526315
500,860,0,22742,8563620,17.2
200,297,0,22743,8563917,14.85
130,152,0,22744,8564069,11.692307692307692
190,284,0,22745,8564353,14.947368421052632
150,183,0,22746,8564536,12.2
240,302,0,22747,8564838,12.583333333333334
130,179,0,22748,8565017,13.76923076923077
220,329,0,22749,8565346,14.954545454545455
220,334,0,22750,8565680,15.181818181818182
190,271,0,22751,8565951,14.263157894736842
300,415,0,22752,8566366,13.833333333333334
280,361,0,22753,8566727,12.892857142857142
350,526,0,22754,8567253,15.028571428571428
350,465,0,22755,8567718,13.285714285714286
340,567,0,22756,8568285,16.676470588235293
230,305,0,22757,8568590,13.26086956521739
290,424,0,22758,8569014,14.620689655172415
120,180,0,22759,8569194,15.0
160,202,0,22760,8569396,12.625
190,232,0,22761,8569628,12.210526315789474
210,300,0,22762,8569928,14.285714285714286
430,707,0,22763,8570635,16.441860465116278
50,60,0,22764,8570695,12.0
240,317,0,22765,8571012,13.208333333333334
240,427,0,22766,8571439,17.791666666666668
220,278,0,22767,8571717,12.636363636363637
150,198,0,22768,8571915,13.2
270,395,0,22769,8572310,14.62962962962963
200,295,0,22770,8572605,14.75
290,379,0,22771,8572984,13.068965517241379
420,592,0,22772,8573576,14.095238095238095
280,407,0,22773,8573983,14.535714285714286
170,256,0,22774,8574239,15.058823529411764
290,418,0,22775,8574657,14.413793103448276
180,242,0,22776,8574899,13.444444444444445
100,113,0,22777,8575012,11.3
340,583,0,22778,8575595,17.147058823529413
270,392,0,22779,8575987,14.518518518518519
240,315,0,22780,8576302,13.125
250,356,0,22781,8576658,14.24
160,219,0,22782,8576877,13.6875
290,530,0,22783,8577407,18.275862068965516
250,372,0,22784,8577779,14.88
340,580,0,22785,8578359,17.058823529411764
440,598,0,22786,8578957,13.590909090909092
300,560,0,22787,8579517,18.666666666666668
160,266,0,22788,8579783,16.625
220,275,0,22789,8580058,12.5
150,203,0,22790,8580261,13.533333333333333
50,42,0,22791,8580303,8.4
350,523,0,22792,8580826,14.942857142857143
220,335,0,22793,8581161,15.227272727272727
230,389,0,22794,8581550,16.91304347826087
270,341,0,22795,8581891,12.62962962962963
90,152,0,22796,8582043,16.88888888888889
190,228,0,22797,8582271,12.0
350,518,0,22798,8582789,14.8
220,291,0,22799,8583080,13.227272727272727
260,396,0,22800,8583476,15.23076923076923
260,344,0,22801,8583820,13.23076923076923
100,118,0,22802,8583938,11.8
200,356,0,22803,8584294,17.8
380,607,0,22804,8584901,15.973684210526315
350,502,0,22805,8585403,14.342857142857143
240,436,0,22806,8585839,18.166666666666668
190,291,0,22807,8586130,15.31578947368421
150,212,0,22808,8586342,14.133333333333333
380,656,0,22809,8586998,17.263157894736842
140,180,0,22810,8587178,12.857142857142858
280,463,0,22811,8587641,16.535714285714285
270,399,0,22812,8588040,14.777777777777779
150,272,0,22813,8588312,18.133333333333333
240,335,0,22814,8588647,13.958333333333334
280,410,0,22815,8589057,14.642857142857142
430,662,0,22816,8589719,15.395348837209303
270,437,0,22817,8590156,16.185185185185187
210,317,0,22818,8590473,15.095238095238095
220,294,0,22819,8590767,13.363636363636363
340,543,0,22820,8591310,15.970588235294118
650,1419,0,22821,8592729,21.83076923076923
220,297,0,22822,8593026,13.5
110,150,0,22823,8593176,13.636363636363637
180,230,0,22824,8593406,12.777777777777779
280,484,0,22825,8593890,17.285714285714285
300,423,0,22826,8594313,14.1
210,305,0,22827,8594618,14.523809523809524
220,370,0,22828,8594988,16.818181818181817
130,166,0,22829,8595154,12.76923076923077
270,415,0,22830,8595569,15.37037037037037
160,256,0,22831,8595825,16.0
150,200,0,22832,8596025,13.333333333333334
220,254,0,22833,8596279,11.545454545454545
70,111,0,22834,8596390,15.857142857142858
110,182,0,22835,8596572,16.545454545454547
370,574,0,22836,8597146,15.513513513513514
240,363,0,22837,8597509,15.125
250,341,0,22838,8597850,13.64
190,249,0,22839,8598099,13.105263157894736
370,634,0,22840,8598733,17.135135135135137
220,307,0,22841,8599040,13.954545454545455
300,475,0,22842,8599515,15.833333333333334
300,433,0,22843,8599948,14.433333333333334
330,437,0,22844,8600385,13.242424242424242
190,291,0,22845,8600676,15.31578947368421
240,366,0,22846,8601042,15.25
120,178,0,22847,8601220,14.833333333333334
430,738,0,22848,8601958,17.162790697674417
420,699,0,22849,8602657,16.642857142857142
370,591,0,22850,8603248,15.972972972972974
430,631,0,22851,8603879,14.674418604651162
140,173,0,22852,8604052,12.357142857142858
120,140,0,22853,8604192,11.666666666666666
290,424,0,22854,8604616,14.620689655172415
190,268,0,22855,8604884,14.105263157894736
390,578,0,22856,8605462,14.820512820512821
140,160,0,22857,8605622,11.428571428571429
250,306,0,22858,8605928,12.24
280,458,0,22859,8606386,16.357142857142858
270,388,0,22860,8606774,14.37037037037037
330,520,0,22861,8607294,15.757575757575758
120,209,0,22862,8607503,17.416666666666668
140,227,0,22863,8607730,16.214285714285715
390,601,0,22864,8608331,15.41025641025641
320,488,0,22865,8608819,15.25
180,211,0,22866,8609030,11.722222222222221
220,357,0,22867,8609387,16.227272727272727
300,491,0,22868,8609878,16.366666666666667
330,456,0,22869,8610334,13.818181818181818
170,274,0,22870,8610608,16.11764705882353
240,380,0,22871,8610988,15.833333333333334
270,394,0,22872,8611382,14.592592592592593
220,272,0,22873,8611654,12.363636363636363
290,523,0,22874,8612177,18.03448275862069
260,359,0,22875,8612536,13.807692307692308
140,216,0,22876,8612752,15.428571428571429
200,298,0,22877,8613050,14.9
280,391,0,22878,8613441,13.964285714285714
390,604,0,22879,8614045,15.487179487179487
130,239,0,22880,8614284,18.384615384615383
50,67,0,22881,8614351,13.4
350,627,0,22882,8614978,17.914285714285715
140,242,0,22883,8615220,17.285714285714285
420,675,0,22884,8615895,16.071428571428573
280,410,0,22885,8616305,14.642857142857142
240,344,0,22886,8616649,14.333333333333334
230,278,0,22887,8616927,12.08695652173913
100,116,0,22888,8617043,11.6
330,493,0,22889,8617536,14.93939393939394
130,173,0,22890,8617709,13.307692307692308
330,532,0,22891,8618241,16.12121212121212
480,957,0,22892,8619198,19.9375
280,407,0,22893,8619605,14.535714285714286
220,321,0,22894,8619926,14.590909090909092
190,293,0,22895,8620219,15.421052631578947
120,154,0,22896,8620373,12.833333333333334
260,417,0,22897,8620790,16.03846153846154
220,351,0,22898,8621141,15.954545454545455
260,419,0,22899,8621560,16.115384615384617
450,697,0,22900,8622257,15.488888888888889
190,234,0,22901,8622491,12.31578947368421
280,444,0,22902,8622935,15.857142857142858
180,274,0,22903,8623209,15.222222222222221
260,382,0,22904,8623591,14.692307692307692
140,131,0,22905,8623722,9.357142857142858
320,523,0,22906,8624245,16.34375
200,291,0,22907,8624536,14.55
200,184,0,22908,8624720,9.2
170,229,0,22909,8624949,13.470588235294118
210,333,0,22910,8625282,15.857142857142858
150,199,0,22911,8625481,13.266666666666667
180,277,0,22912,8625758,15.38888888888889
320,521,0,22913,8626279,16.28125
220,323,0,22914,8626602,14.681818181818182
150,271,0,22915,8626873,18.066666666666666
490,718,0,22916,8627591,14.653061224489797
250,315,0,22917,8627906,12.6
430,629,0,22918,8628535,14.627906976744185
250,355,0,22919,8628890,14.2
250,322,0,22920,8629212,12.88
270,416,0,22921,8629628,15.407407407407407
210,300,0,22922,8629928,14.285714285714286
110,172,0,22923,8630100,15.636363636363637
330,634,0,22924,8630734,19.21212121212121
350,562,0,22925,8631296,16.057142857142857
250,433,0,22926,8631729,17.32
210,291,0,22927,8632020,13.857142857142858
370,658,0,22928,8632678,17.783783783783782
280,381,0,22929,8633059,13.607142857142858
70,97,0,22930,8633156,13.857142857142858
310,533,0,22931,8633689,17.193548387096776
310,465,0,22932,8634154,15.0
190,262,0,22933,8634416,13.789473684210526
320,340,0,22934,8634756,10.625
170,261,0,22935,8635017,15.352941176470589
310,520,0,22936,8635537,16.774193548387096
270,410,0,22937,8635947,15.185185185185185
240,370,0,22938,8636317,15.416666666666666
240,386,0,22939,8636703,16.083333333333332
390,628,0,22940,8637331,16.102564102564102
360,594,0,22941,8637925,16.5
240,332,0,22942,8638257,13.833333333333334
220,316,0,22943,8638573,14.363636363636363
230,313,0,22944,8638886,13.608695652173912
250,380,0,22945,8639266,15.2
410,707,0,22946,8639973,17.24390243902439
250,368,0,22947,8640341,14.72
540,926,0,22948,8641267,17.14814814814815
120,194,0,22949,8641461,16.166666666666668
210,283,0,22950,8641744,13.476190476190476
440,757,0,22951,8642501,17.204545454545453
400,553,0,22952,8643054,13.825
390,607,0,22953,8643661,15.564102564102564
160,224,0,22954,8643885,14.0
340,610,0,22955,8644495,17.941176470588236
240,343,0,22956,8644838,14.291666666666666
230,297,0,22957,8645135,12.91304347826087
160,286,0,22958,8645421,17.875
320,473,0,22959,8645894,14.78125
340,532,0,22960,8646426,15.647058823529411
170,243,0,22961,8646669,14.294117647058824
110,114,0,22962,8646783,10.363636363636363
230,354,0,22963,8647137,15.391304347826088
340,525,0,22964,8647662,15.441176470588236
430,696,0,22965,8648358,16.186046511627907
420,581,0,22966,8648939,13.833333333333334
350,541,0,22967,8649480,15.457142857142857
80,98,0,22968,8649578,12.25
260,455,0,22969,8650033,17.5
380,564,0,22970,8650597,14.842105263157896
240,355,0,22971,8650952,14.791666666666666
180,216,0,22972,8651168,12.0
300,470,0,22973,8651638,15.666666666666666
340,609,0,22974,8652247,17.91176470588235
240,323,0,22975,8652570,13.458333333333334
100,123,0,22976,8652693,12.3
180,230,0,22977,8652923,12.777777777777779
200,264,0,22978,8653187,13.2
260,402,0,22979,8653589,15.461538461538462
270,415,0,22980,8654004,15.37037037037037
200,365,0,22981,8654369,18.25
290,436,0,22982,8654805,15.03448275862069
250,334,0,22983,8655139,13.36
330,492,0,22984,8655631,14.909090909090908
350,433,0,22985,8656064,12.371428571428572
370,589,0,22986,8656653,15.91891891891892
230,373,0,22987,8657026,16.217391304347824
300,446,0,22988,8657472,14.866666666666667
340,578,0,22989,8658050,17.0
240,395,0,22990,8658445,16.458333333333332
280,461,0,22991,8658906,16.464285714285715
490,859,0,22992,8659765,17.53061224489796
140,192,0,22993,8659957,13.714285714285714
270,411,0,22994,8660368,15.222222222222221
270,458,0,22995,8660826,16.962962962962962
120,190,0,22996,8661016,15.833333333333334
310,477,0,22997,8661493,15.387096774193548
210,324,0,22998,8661817,15.428571428571429
190,255,0,22999,8662072,13.421052631578947
310,485,0,23000,8662557,15.64516129032258
300,449,0,23001,8663006,14.966666666666667
240,334,0,23002,8663340,13.916666666666666
250,378,0,23003,8663718,15.12
280,409,0,23004,8664127,14.607142857142858
280,399,0,23005,8664526,14.25
190,280,0,23006,8664806,14.736842105263158
120,146,0,23007,8664952,12.166666666666666
130,177,0,23008,8665129,13.615384615384615
380,594,0,23009,8665723,15.631578947368421
180,287,0,23010,8666010,15.944444444444445
270,368,0,23011,8666378,13.62962962962963
120,167,0,23012,8666545,13.916666666666666
270,432,0,23013,8666977,16.0
420,645,0,23014,8667622,15.357142857142858
270,369,0,23015,8667991,13.666666666666666
160,231,0,23016,8668222,14.4375
380,567,0,23017,8668789,14.921052631578947
170,282,0,23018,8669071,16.58823529411765
480,727,0,23019,8669798,15.145833333333334
300,463,0,23020,8670261,15.433333333333334
270,400,0,23021,8670661,14.814814814814815
250,402,0,23022,8671063,16.08
360,564,0,23023,8671627,15.666666666666666
90,142,0,23024,8671769,15.777777777777779
140,159,0,23025,8671928,11.357142857142858
150,183,0,23026,8672111,12.2
240,327,0,23027,8672438,13.625
130,163,0,23028,8672601,12.538461538461538
180,250,0,23029,8672851,13.88888888888889
450,675,0,23030,8673526,15.0
110,195,0,23031,8673721,17.727272727272727
310,526,0,23032,8674247,16.967741935483872
400,718,0,23033,8674965,17.95
300,357,0,23034,8675322,11.9
310,466,0,23035,8675788,15.03225806451613
280,426,0,23036,8676214,15.214285714285714
460,757,0,23037,8676971,16.456521739130434
250,294,0,23038,8677265,11.76
270,349,0,23039,8677614,12.925925925925926
190,297,0,23040,8677911,15.631578947368421
180,282,0,23041,8678193,15.666666666666666
210,359,0,23042,8678552,17.095238095238095
210,296,0,23043,8678848,14.095238095238095
110,154,0,23044,8679002,14.0
330,489,0,23045,8679491,14.818181818181818
240,395,0,23046,8679886,16.458333333333332
240,294,0,23047,8680180,12.25
300,556,0,23048,8680736,18.533333333333335
360,493,0,23049,8681229,13.694444444444445
110,142,0,23050,8681371,12.909090909090908
420,639,0,23051,8682010,15.214285714285714
280,447,0,23052,8682457,15.964285714285714
210,301,0,23053,8682758,14.333333333333334
330,602,0,23054,8683360,18.242424242424242
420,589,0,23055,8683949,14.023809523809524
250,316,0,23056,8684265,12.64
170,224,0,23057,8684489,13.176470588235293
270,472,0,23058,8684961,17.48148148148148
110,136,0,23059,8685097,12.363636363636363
360,496,0,23060,8685593,13.777777777777779
490,766,0,23061,8686359,15.63265306122449
150,215,0,23062,8686574,14.333333333333334
290,546,0,23063,8687120,18.82758620689655
140,231,0,23064,8687351,16.5
330,446,0,23065,8687797,13.515151515151516
80,133,0,23066,8687930,16.625
150,211,0,23067,8688141,14.066666666666666
230,332,0,23068,8688473,14.434782608695652
280,408,0,23069,8688881,14.571428571428571
260,371,0,23070,8689252,14.26923076923077
340,503,0,23071,8689755,14.794117647058824
150,191,0,23072,8689946,12.733333333333333
390,616,0,23073,8690562,15.794871794871796
250,381,0,23074,8690943,15.24
240,317,0,23075,8691260,13.208333333333334
240,295,0,23076,8691555,12.291666666666666
190,304,0,23077,8691859,16.0
220,235,0,23078,8692094,10.681818181818182
250,358,0,23079,8692452,14.32
260,299,0,23080,8692751,11.5
130,124,0,23081,8692875,9.538461538461538
240,358,0,23082,8693233,14.916666666666666
440,676,0,23083,8693909,15.363636363636363
380,661,0,23084,8694570,17.394736842105264
320,503,0,23085,8695073,15.71875
330,484,0,23086,8695557,14.666666666666666
270,360,0,23087,8695917,13.333333333333334
330,498,0,23088,8696415,15.090909090909092
110,141,0,23089,8696556,12.818181818181818
200,339,0,23090,8696895,16.95
70,88,0,23091,8696983,12.571428571428571
310,423,0,23092,8697406,13.64516129032258
380,714,0,23093,8698120,18.789473684210527
270,436,0,23094,8698556,16.14814814814815
430,608,0,23095,8699164,14.13953488372093
360,699,0,23096,8699863,19.416666666666668
240,367,0,23097,8700230,15.291666666666666
280,422,0,23098,8700652,15.071428571428571
230,363,0,23099,8701015,15.782608695652174
250,363,0,23100,8701378,14.52
130,159,0,23101,8701537,12.23076923076923
100,144,0,23102,8701681,14.4
230,266,0,23103,8701947,11.565217391304348
310,446,0,23104,8702393,14.387096774193548
140,164,0,23105,8702557,11.714285714285714
180,237,0,23106,8702794,13.166666666666666
270,434,0,23107,8703228,16.074074074074073
170,223,0,23108,8703451,13.117647058823529
590,877,0,23109,8704328,14.864406779661017
210,275,0,23110,8704603,13.095238095238095
210,377,0,23111,8704980,17.952380952380953
150,250,0,23112,8705230,16.666666666666668
140,189,0,23113,8705419,13.5
260,422,0,23114,8705841,16.23076923076923
410,631,0,23115,8706472,15.390243902439025
280,490,0,23116,8706962,17.5
240,332,0,23117,8707294,13.833333333333334
240,345,0,23118,8707639,14.375
340,521,0,23119,8708160,15.323529411764707
150,227,0,23120,8708387,15.133333333333333
300,458,0,23121,8708845,15.266666666666667
240,348,0,23122,8709193,14.5
300,454,0,23123,8709647,15.133333333333333
200,280,0,23124,8709927,14.0
260,396,0,23125,8710323,15.23076923076923
230,456,0,23126,8710779,19.82608695652174
300,457,0,23127,8711236,15.233333333333333
160,257,0,23128,8711493,16.0625
430,716,0,23129,8712209,16.651162790697676
180,286,0,23130,8712495,15.88888888888889
320,448,0,23131,8712943,14.0
210,265,0,23132,8713208,12.619047619047619
310,446,0,23133,8713654,14.387096774193548
150,208,0,23134,8713862,13.866666666666667
280,387,0,23135,8714249,13.821428571428571
340,453,0,23136,8714702,13.323529411764707
330,474,0,23137,8715176,14.363636363636363
570,949,0,23138,8716125,16.649122807017545
310,420,0,23139,8716545,13.548387096774194
340,582,0,23140,8717127,17.11764705882353
290,405,0,23141,8717532,13.96551724137931
220,344,0,23142,8717876,15.636363636363637
190,240,0,23143,8718116,12.631578947368421
160,188,0,23144,8718304,11.75
220,283,0,23145,8718587,12.863636363636363
420,648,0,23146,8719235,15.428571428571429
270,426,0,23147,8719661,15.777777777777779
300,532,0,23148,8720193,17.733333333333334
330,550,0,23149,8720743,16.666666666666668
300,466,0,23150,8721209,15.533333333333333
360,585,0,23151,8721794,16.25
300,544,0,23152,8722338,18.133333333333333
170,256,0,23153,8722594,15.058823529411764
230,326,0,23154,8722920,14.173913043478262
290,450,0,23155,8723370,15.517241379310345
430,696,0,23156,8724066,16.186046511627907
320,523,0,23157,8724589,16.34375
50,38,0,23158,8724627,7.6
310,465,0,23159,8725092,15.0
220,323,0,23160,8725415,14.681818181818182
290,361,0,23161,8725776,12.448275862068966
350,485,0,23162,8726261,13.857142857142858
320,490,0,23163,8726751,15.3125
240,353,0,23164,8727104,14.708333333333334
330,511,0,23165,8727615,15.484848484848484
240,381,0,23166,8727996,15.875
170,252,0,23167,8728248,14.823529411764707
310,460,0,23168,8728708,14.838709677419354
300,375,0,23169,8729083,12.5
250,394,0,23170,8729477,15.76
140,197,0,23171,8729674,14.071428571428571
280,429,0,23172,8730103,15.321428571428571
250,348,0,23173,8730451,13.92
130,190,0,23174,8730641,14.615384615384615
190,251,0,23175,8730892,13.210526315789474
260,362,0,23176,8731254,13.923076923076923
370,592,0,23177,8731846,16.0
280,462,0,23178,8732308,16.5
410,572,0,23179,8732880,13.951219512195122
350,491,0,23180,8733371,14.028571428571428
420,676,0,23181,8734047,16.095238095238095
290,416,0,23182,8734463,14.344827586206897
180,287,0,23183,8734750,15.944444444444445
220,287,0,23184,8735037,13.045454545454545
270,389,0,23185,8735426,14.407407407407407
200,299,0,23186,8735725,14.95
270,391,0,23187,8736116,14.481481481481481
300,467,0,23188,8736583,15.566666666666666
170,215,0,23189,8736798,12.647058823529411
190,275,0,23190,8737073,14.473684210526315
450,768,0,23191,8737841,17.066666666666666
140,190,0,23192,8738031,13.571428571428571
370,509,0,23193,8738540,13.756756756756756
590,1112,0,23194,8739652,18.847457627118644
170,243,0,23195,8739895,14.294117647058824
300,488,0,23196,8740383,16.266666666666666
310,446,0,23197,8740829,14.387096774193548
130,167,0,23198,8740996,12.846153846153847
180,291,0,23199,8741287,16.166666666666668
210,238,0,23200,8741525,11.333333333333334
230,373,0,23201,8741898,16.217391304347824
270,414,0,23202,8742312,15.333333333333334
220,323,0,23203,8742635,14.681818181818182
230,351,0,23204,8742986,15.26086956521739
310,456,0,23205,8743442,14.709677419354838
180,205,0,23206,8743647,11.38888888888889
250,377,0,23207,8744024,15.08
310,531,0,23208,8744555,17.129032258064516
310,435,0,23209,8744990,14.03225806451613
220,293,0,23210,8745283,13.318181818181818
220,276,0,23211,8745559,12.545454545454545
190,215,0,23212,8745774,11.31578947368421
240,334,0,23213,8746108,13.916666666666666
150,187,0,23214,8746295,12.466666666666667
110,147,0,23215,8746442,13.363636363636363
360,527,0,23216,8746969,14.63888888888889
170,346,0,23217,8747315,20.352941176470587
200,323,0,23218,8747638,16.15
440,769,0,23219,8748407,17.477272727272727
60,54,0,23220,8748461,9.0
310,459,0,23221,8748920,14.806451612903226
140,174,0,23222,8749094,12.428571428571429
310,413,0,23223,8749507,13.32258064516129
110,163,0,23224,8749670,14.818181818181818
220,330,0,23225,8750000,15.0
230,278,0,23226,8750278,12.08695652173913
140,197,0,23227,8750475,14.071428571428571
240,371,0,23228,8750846,15.458333333333334
290,445,0,23229,8751291,15.344827586206897
270,455,0,23230,8751746,16.85185185185185
310,492,0,23231,8752238,15.870967741935484
460,726,0,23232,8752964,15.782608695652174
180,269,0,23233,8753233,14.944444444444445
380,548,0,23234,8753781,14.421052631578947
130,135,0,23235,8753916,10.384615384615385
440,622,0,23236,8754538,14.136363636363637
310,482,0,23237,8755020,15.548387096774194
310,435,0,23238,8755455,14.03225806451613
410,659,0,23239,8756114,16.073170731707318
340,519,0,23240,8756633,15.264705882352942
190,279,0,23241,8756912,14.68421052631579
380,571,0,23242,8757483,15.026315789473685
370,576,0,23243,8758059,15.567567567567568
170,199,0,23244,8758258,11.705882352941176
330,464,0,23245,8758722,14.06060606060606
150,230,0,23246,8758952,15.333333333333334
160,233,0,23247,8759185,14.5625
250,450,0,23248,8759635,18.0
230,392,0,23249,8760027,17.043478260869566
160,208,0,23250,8760235,13.0
270,396,0,23251,8760631,14.666666666666666
350,608,0,23252,8761239,17.37142857142857
420,662,0,23253,8761901,15.761904761904763
150,248,0,23254,8762149,16.533333333333335
190,228,0,23255,8762377,12.0
300,445,0,23256,8762822,14.833333333333334
220,345,0,23257,8763167,15.681818181818182
190,262,0,23258,8763429,13.789473684210526
360,551,0,23259,8763980,15.305555555555555
320,486,0,23260,8764466,15.1875
220,287,0,23261,8764753,13.045454545454545
240,309,0,23262,8765062,12.875
280,419,0,23263,8765481,14.964285714285714
100,151,0,23264,8765632,15.1
240,325,0,23265,8765957,13.541666666666666
200,260,0,23266,8766217,13.0
380,717,0,23267,8766934,18.86842105263158
170,272,0,23268,8767206,16.0
170,271,0,23269,8767477,15.941176470588236
110,134,0,23270,8767611,12.181818181818182
140,159,0,23271,8767770,11.357142857142858
140,211,0,23272,8767981,15.071428571428571
240,231,0,23273,8768212,9.625
230,270,0,23274,8768482,11.73913043478261
190,297,0,23275,8768779,15.631578947368421
170,262,0,23276,8769041,15.411764705882353
140,190,0,23277,8769231,13.571428571428571
160,204,0,23278,8769435,12.75
110,146,0,23279,8769581,13.272727272727273
160,163,0,23280,8769744,10.1875
330,507,0,23281,8770251,15.363636363636363
230,329,0,23282,8770580,14.304347826086957
150,187,0,23283,8770767,12.466666666666667
420,642,0,23284,8771409,15.285714285714286
270,371,0,23285,8771780,13.74074074074074
370,578,0,23286,8772358,15.621621621621621
170,230,0,23287,8772588,13.529411764705882
360,516,0,23288,8773104,14.333333333333334
180,237,0,23289,8773341,13.166666666666666
200,296,0,23290,8773637,14.8
250,343,0,23291,8773980,13.72
300,489,0,23292,8774469,16.3
250,330,0,23293,8774799,13.2
200,271,0,23294,8775070,13.55
240,463,0,23295,8775533,19.291666666666668
280,445,0,23296,8775978,15.892857142857142
170,207,0,23297,8776185,12.176470588235293
220,282,0,23298,8776467,12.818181818181818
260,337,0,23299,8776804,12.961538461538462
340,522,0,23300,8777326,15.352941176470589
230,322,0,23301,8777648,14.0
230,323,0,23302,8777971,14.043478260869565
340,555,0,23303,8778526,16.323529411764707
530,925,0,23304,8779451,17.452830188679247
240,369,0,23305,8779820,15.375
320,477,0,23306,8780297,14.90625
520,749,0,23307,8781046,14.403846153846153
410,569,0,23308,8781615,13.878048780487806
270,380,0,23309,8781995,14.074074074074074
370,570,0,23310,8782565,15.405405405405405
140,196,0,23311,8782761,14.0
110,175,0,23312,8782936,15.909090909090908
230,336,0,23313,8783272,14.608695652173912
160,208,0,23314,8783480,13.0
290,449,0,23315,8783929,15.482758620689655
250,410,0,23316,8784339,16.4
200,302,0,23317,8784641,15.1
400,645,0,23318,8785286,16.125
310,454,0,23319,8785740,14.64516129032258
110,110,0,23320,8785850,10.0
340,588,0,23321,8786438,17.294117647058822
140,196,0,23322,8786634,14.0
220,358,0,23323,8786992,16.272727272727273
130,183,0,23324,8787175,14.076923076923077
140,203,0,23325,8787378,14.5
460,633,0,23326,8788011,13.76086956521739
370,562,0,23327,8788573,15.18918918918919
400,608,0,23328,8789181,15.2
330,448,0,23329,8789629,13.575757575757576
180,301,0,23330,8789930,16.72222222222222
290,409,0,23331,8790339,14.10344827586207
290,463,0,23332,8790802,15.96551724137931
180,180,0,23333,8790982,10.0
200,254,0,23334,8791236,12.7
310,384,0,23335,8791620,12.387096774193548
330,526,0,23336,8792146,15.93939393939394
170,210,0,23337,8792356,12.352941176470589
140,176,0,23338,8792532,12.571428571428571
310,486,0,23339,8793018,15.67741935483871
420,645,0,23340,8793663,15.357142857142858
410,675,0,23341,8794338,16.463414634146343
290,471,0,23342,8794809,16.24137931034483
310,540,0,23343,8795349,17.419354838709676
280,388,0,23344,8795737,13.857142857142858
320,449,0,23345,8796186,14.03125
220,315,0,23346,8796501,14.318181818181818
430,868,0,23347,8797369,20.186046511627907
360,504,0,23348,8797873,14.0
220,319,0,23349,8798192,14.5
350,541,0,23350,8798733,15.457142857142857
310,549,0,23351,8799282,17.70967741935484
120,154,0,23352,8799436,12.833333333333334
170,213,0,23353,8799649,12.529411764705882
120,183,0,23354,8799832,15.25
60,74,0,23355,8799906,12.333333333333334
290,438,0,23356,8800344,15.10344827586207
180,261,0,23357,8800605,14.5
190,279,0,23358,8800884,14.68421052631579
450,843,0,23359,8801727,18.733333333333334
370,544,0,23360,8802271,14.702702702702704
100,126,0,23361,8802397,12.6
220,362,0,23362,8802759,16.454545454545453
330,450,0,23363,8803209,13.636363636363637
130,196,0,23364,8803405,15.076923076923077
270,346,0,23365,8803751,12.814814814814815
320,412,0,23366,8804163,12.875
490,818,0,23367,8804981,16.693877551020407
200,290,0,23368,8805271,14.5
90,127,0,23369,8805398,14.11111111111111
170,281,0,23370,8805679,16.529411764705884
560,887,0,23371,8806566,15.839285714285714
230,339,0,23372,8806905,14.73913043478261
160,242,0,23373,8807147,15.125
180,254,0,23374,8807401,14.11111111111111
270,370,0,23375,8807771,13.703703703703704
360,538,0,23376,8808309,14.944444444444445
130,157,0,23377,8808466,12.076923076923077
80,85,0,23378,8808551,10.625
440,720,0,23379,8809271,16.363636363636363
480,639,0,23380,8809910,13.3125
220,288,0,23381,8810198,13.090909090909092
440,773,0,23382,8810971,17.568181818181817
130,181,0,23383,8811152,13.923076923076923
290,454,0,23384,8811606,15.655172413793103
340,550,0,23385,8812156,16.176470588235293
300,404,0,23386,8812560,13.466666666666667
340,535,0,23387,8813095,15.735294117647058
350,514,0,23388,8813609,14.685714285714285
480,910,0,23389,8814519,18.958333333333332
230,324,0,23390,8814843,14.08695652173913
180,276,0,23391,8815119,15.333333333333334
280,398,0,23392,8815517,14.214285714285714
290,380,0,23393,8815897,13.10344827586207
380,554,0,23394,8816451,14.578947368421053
270,436,0,23395,8816887,16.14814814814815
230,367,0,23396,8817254,15.956521739130435
280,406,0,23397,8817660,14.5
300,411,0,23398,8818071,13.7
200,345,0,23399,8818416,17.25
480,822,0,23400,8819238,17.125
280,465,0,23401,8819703,16.607142857142858
160,232,0,23402,8819935,14.5
320,458,0,23403,8820393,14.3125
220,280,0,23404,8820673,12.727272727272727
140,188,0,23405,8820861,13.428571428571429
120,161,0,23406,8821022,13.416666666666666
290,463,0,23407,8821485,15.96551724137931
230,287,0,23408,8821772,12.478260869565217
430,646,0,23409,8822418,15.023255813953488
270,402,0,23410,8822820,14.88888888888889
180,257,0,23411,8823077,14.277777777777779
80,113,0,23412,8823190,14.125
400,620,0,23413,8823810,15.5
180,220,0,23414,8824030,12.222222222222221
210,320,0,23415,8824350,15.238095238095237
260,401,0,23416,8824751,15.423076923076923
360,515,0,23417,8825266,14.305555555555555
140,198,0,23418,8825464,14.142857142857142
200,325,0,23419,8825789,16.25
130,171,0,23420,8825960,13.153846153846153
190,234,0,23421,8826194,12.31578947368421
170,230,0,23422,8826424,13.529411764705882
200,292,0,23423,8826716,14.6
260,423,0,23424,8827139,16.26923076923077
320,489,0,23425,8827628,15.28125
220,288,0,23426,8827916,13.090909090909092
550,953,0,23427,8828869,17.327272727272728
330,590,0,23428,8829459,17.87878787878788
270,469,0,23429,8829928,17.37037037037037
160,203,0,23430,8830131,12.6875
330,483,0,23431,8830614,14.636363636363637
270,386,0,23432,8831000,14.296296296296296
490,866,0,23433,8831866,17.6734693877551
260,357,0,23434,8832223,13.73076923076923
220,347,0,23435,8832570,15.772727272727273
250,458,0,23436,8833028,18.32
290,418,0,23437,8833446,14.413793103448276
220,293,0,23438,8833739,13.318181818181818
330,453,0,23439,8834192,13.727272727272727
270,426,0,23440,8834618,15.777777777777779
400,627,0,23441,8835245,15.675
260,363,0,23442,8835608,13.961538461538462
170,248,0,23443,8835856,14.588235294117647
390,727,0,23444,8836583,18.641025641025642
360,558,0,23445,8837141,15.5
190,299,0,23446,8837440,15.736842105263158
260,363,0,23447,8837803,13.961538461538462
170,232,0,23448,8838035,13.647058823529411
240,360,0,23449,8838395,15.0
450,670,0,23450,8839065,14.88888888888889
200,325,0,23451,8839390,16.25
300,492,0,23452,8839882,16.4
240,325,0,23453,8840207,13.541666666666666
300,461,0,23454,8840668,15.366666666666667
270,404,0,23455,8841072,14.962962962962964
190,299,0,23456,8841371,15.736842105263158
80,77,0,23457,8841448,9.625
280,437,0,23458,8841885,15.607142857142858
120,143,0,23459,8842028,11.916666666666666
130,200,0,23460,8842228,15.384615384615385
140,185,0,23461,8842413,13.214285714285714
120,187,0,23462,8842600,15.583333333333334
150,169,0,23463,8842769,11.266666666666667
260,396,0,23464,8843165,15.23076923076923
260,366,0,23465,8843531,14.076923076923077
280,437,0,23466,8843968,15.607142857142858
380,635,0,23467,8844603,16.710526315789473
340,533,0,23468,8845136,15.676470588235293
260,486,0,23469,8845622,18.692307692307693
180,295,0,23470,8845917,16.38888888888889
240,345,0,23471,8846262,14.375
270,416,0,23472,8846678,15.407407407407407
150,185,0,23473,8846863,12.333333333333334
280,422,0,23474,8847285,15.071428571428571
130,149,0,23475,8847434,11.461538461538462
290,469,0,23476,8847903,16.17241379310345
310,364,0,23477,8848267,11.741935483870968
250,363,0,23478,8848630,14.52
80,138,0,23479,8848768,17.25
190,235,0,23480,8849003,12.368421052631579
270,419,0,23481,8849422,15.518518518518519
160,206,0,23482,8849628,12.875
240,328,0,23483,8849956,13.666666666666666
310,453,0,23484,8850409,14.612903225806452
430,665,0,23485,8851074,15.465116279069768
190,237,0,23486,8851311,12.473684210526315
260,408,0,23487,8851719,15.692307692307692
330,514,0,23488,8852233,15.575757575757576
300,402,0,23489,8852635,13.4
180,290,0,23490,8852925,16.11111111111111
270,357,0,23491,8853282,13.222222222222221
160,208,0,23492,8853490,13.0
270,391,0,23493,8853881,14.481481481481481
170,240,0,23494,8854121,14.117647058823529
300,510,0,23495,8854631,17.0
390,516,0,23496,8855147,13.23076923076923
240,356,0,23497,8855503,14.833333333333334
100,135,0,23498,8855638,13.5
270,397,0,23499,8856035,14.703703703703704
250,330,0,23500,8856365,13.2
90,127,0,23501,8856492,14.11111111111111
320,485,0,23502,8856977,15.15625
160,209,0,23503,8857186,13.0625
170,251,0,23504,8857437,14.764705882352942
300,443,0,23505,8857880,14.766666666666667
210,303,0,23506,8858183,14.428571428571429
100,116,0,23507,8858299,11.6
150,223,0,23508,8858522,14.866666666666667
230,283,0,23509,8858805,12.304347826086957
170,238,0,23510,8859043,14.0
420,734,0,23511,8859777,17.476190476190474
270,371,0,23512,8860148,13.74074074074074
380,529,0,23513,8860677,13.921052631578947
180,308,0,23514,8860985,17.11111111111111
190,270,0,23515,8861255,14.210526315789474
350,563,0,23516,8861818,16.085714285714285
120,152,0,23517,8861970,12.666666666666666
220,358,0,23518,8862328,16.272727272727273
160,263,0,23519,8862591,16.4375
520,884,0,23520,8863475,17.0
250,421,0,23521,8863896,16.84
400,554,0,23522,8864450,13.85
280,434,0,23523,8864884,15.5
310,457,0,23524,8865341,14.741935483870968
310,555,0,23525,8865896,17.903225806451612
200,276,0,23526,8866172,13.8
260,336,0,23527,8866508,12.923076923076923
220,308,0,23528,8866816,14.0
120,184,0,23529,8867000,15.333333333333334
350,519,0,23530,8867519,14.82857142857143
270,352,0,23531,8867871,13.037037037037036
290,416,0,23532,8868287,14.344827586206897
290,486,0,23533,8868773,16.75862068965517
350,518,0,23534,8869291,14.8
270,411,0,23535,8869702,15.222222222222221
500,798,0,23536,8870500,15.96
240,371,0,23537,8870871,15.458333333333334
370,606,0,23538,8871477,16.37837837837838
90,108,0,23539,8871585,12.0
310,430,0,23540,8872015,13.870967741935484
170,228,0,23541,8872243,13.411764705882353
260,482,0,23542,8872725,18.53846153846154
380,565,0,23543,8873290,14.868421052631579
390,558,0,23544,8873848,14.307692307692308
190,273,0,23545,8874121,14.368421052631579
170,241,0,23546,8874362,14.176470588235293
400,657,0,23547,8875019,16.425
170,275,0,23548,8875294,16.176470588235293
300,453,0,23549,8875747,15.1
350,589,0,23550,8876336,16.82857142857143
280,486,0,23551,8876822,17.357142857142858
300,478,0,23552,8877300,15.933333333333334
480,718,0,23553,8878018,14.958333333333334
150,172,0,23554,8878190,11.466666666666667
270,427,0,23555,8878617,15.814814814814815
240,373,0,23556,8878990,15.541666666666666
250,390,0,23557,8879380,15.6
250,323,0,23558,8879703,12.92
180,268,0,23559,8879971,14.88888888888889
250,362,0,23560,8880333,14.48
110,116,0,23561,8880449,10.545454545454545
310,412,0,23562,8880861,13.290322580645162
230,383,0,23563,8881244,16.652173913043477
420,634,0,23564,8881878,15.095238095238095
330,492,0,23565,8882370,14.909090909090908
340,557,0,23566,8882927,16.38235294117647
150,201,0,23567,8883128,13.4
230,318,0,23568,8883446,13.826086956521738
230,351,0,23569,8883797,15.26086956521739
240,379,0,23570,8884176,15.791666666666666
200,289,0,23571,8884465,14.45
440,601,0,23572,8885066,13.659090909090908
310,451,0,23573,8885517,14.548387096774194
130,163,0,23574,8885680,12.538461538461538
210,294,0,23575,8885974,14.0
300,418,0,23576,8886392,13.933333333333334
250,378,0,23577,8886770,15.12
130,161,0,23578,8886931,12.384615384615385
150,238,0,23579,8887169,15.866666666666667
320,509,0,23580,8887678,15.90625
220,362,0,23581,8888040,16.454545454545453
250,436,0,23582,8888476,17.44
240,351,0,23583,8888827,14.625
140,146,0,23584,8888973,10.428571428571429
170,228,0,23585,8889201,13.411764705882353
180,272,0,23586,8889473,15.11111111111111
230,258,0,23587,8889731,11.217391304347826
520,952,0,23588,8890683,18.307692307692307
340,606,0,23589,8891289,17.823529411764707
300,322,0,23590,8891611,10.733333333333333
280,437,0,23591,8892048,15.607142857142858
260,373,0,23592,8892421,14.346153846153847
170,276,0,23593,8892697,16.235294117647058
390,649,0,23594,8893346,16.641025641025642
220,303,0,23595,8893649,13.772727272727273
250,354,0,23596,8894003,14.16
220,266,0,23597,8894269,12.090909090909092
300,408,0,23598,8894677,13.6
180,260,0,23599,8894937,14.444444444444445
120,167,0,23600,8895104,13.916666666666666
90,106,0,23601,8895210,11.777777777777779
190,205,0,23602,8895415,10.789473684210526
150,232,0,23603,8895647,15.466666666666667
280,460,0,23604,8896107,16.428571428571427
160,240,0,23605,8896347,15.0
280,441,0,23606,8896788,15.75
200,270,0,23607,8897058,13.5
270,399,0,23608,8897457,14.777777777777779
350,586,0,23609,8898043,16.742857142857144
220,312,0,23610,8898355,14.181818181818182
110,110,0,23611,8898465,10.0
220,295,0,23612,8898760,13.409090909090908
160,261,0,23613,8899021,16.3125
220,359,0,23614,8899380,16.318181818181817
340,574,0,23615,8899954,16.88235294117647
170,255,0,23616,8900209,15.0
180,249,0,23617,8900458,13.833333333333334
170,204,0,23618,8900662,12.0
170,228,0,23619,8900890,13.411764705882353
340,486,0,23620,8901376,14.294117647058824
240,336,0,23621,8901712,14.0
120,163,0,23622,8901875,13.583333333333334
320,425,0,23623,8902300,13.28125
290,450,0,23624,8902750,15.517241379310345
440,713,0,23625,8903463,16.204545454545453
270,390,0,23626,8903853,14.444444444444445
390,739,0,23627,8904592,18.94871794871795
350,519,0,23628,8905111,14.82857142857143
340,521,0,23629,8905632,15.323529411764707
290,435,0,23630,8906067,15.0
310,499,0,23631,8906566,16.096774193548388
100,168,0,23632,8906734,16.8
180,221,0,23633,8906955,12.277777777777779
370,557,0,23634,8907512,15.054054054054054
390,622,0,23635,8908134,15.948717948717949
410,670,0,23636,8908804,16.341463414634145
130,171,0,23637,8908975,13.153846153846153
110,198,0,23638,8909173,18.0
160,235,0,23639,8909408,14.6875
530,907,0,23640,8910315,17.11320754716981
260,435,0,23641,8910750,16.73076923076923
170,253,0,23642,8911003,14.882352941176471
340,582,0,23643,8911585,17.11764705882353
240,309,0,23644,8911894,12.875
410,651,0,23645,8912545,15.878048780487806
350,501,0,23646,8913046,14.314285714285715
220,294,0,23647,8913340,13.363636363636363
440,680,0,23648,8914020,15.454545454545455
190,266,0,23649,8914286,14.0
400,542,0,23650,8914828,13.55
130,145,0,23651,8914973,11.153846153846153
160,208,0,23652,8915181,13.0
180,254,0,23653,8915435,14.11111111111111
230,334,0,23654,8915769,14.521739130434783
290,388,0,23655,8916157,13.379310344827585
260,383,0,23656,8916540,14.73076923076923
280,362,0,23657,8916902,12.928571428571429
330,490,0,23658,8917392,14.848484848484848
370,550,0,23659,8917942,14.864864864864865
250,338,0,23660,8918280,13.52
440,663,0,23661,8918943,15.068181818181818
220,378,0,23662,8919321,17.181818181818183
260,408,0,23663,8919729,15.692307692307692
300,415,0,23664,8920144,13.833333333333334
320,479,0,23665,8920623,14.96875
320,574,0,23666,8921197,17.9375
260,427,0,23667,8921624,16.423076923076923
460,662,0,23668,8922286,14.391304347826088
200,302,0,23669,8922588,15.1
470,822,0,23670,8923410,17.48936170212766
110,120,0,23671,8923530,10.909090909090908
130,174,0,23672,8923704,13.384615384615385
320,446,0,23673,8924150,13.9375
90,76,0,23674,8924226,8.444444444444445
150,241,0,23675,8924467,16.066666666666666
490,871,0,23676,8925338,17.775510204081634
160,206,0,23677,8925544,12.875
210,272,0,23678,8925816,12.952380952380953
240,418,0,23679,8926234,17.416666666666668
240,315,0,23680,8926549,13.125
280,402,0,23681,8926951,14.357142857142858
120,161,0,23682,8927112,13.416666666666666
240,292,0,23683,8927404,12.166666666666666
370,568,0,23684,8927972,15.35135135135135
440,712,0,23685,8928684,16.181818181818183
210,317,0,23686,8929001,15.095238095238095
300,423,0,23687,8929424,14.1
330,508,0,23688,8929932,15.393939393939394
360,532,0,23689,8930464,14.777777777777779
310,450,0,23690,8930914,14.516129032258064
240,324,0,23691,8931238,13.5
100,132,0,23692,8931370,13.2
320,416,0,23693,8931786,13.0
380,595,0,23694,8932381,15.657894736842104
180,228,0,23695,8932609,12.666666666666666
390,490,0,23696,8933099,12.564102564102564
140,190,0,23697,8933289,13.571428571428571
160,207,0,23698,8933496,12.9375
360,504,0,23699,8934000,14.0
170,253,0,23700,8934253,14.882352941176471
180,282,0,23701,8934535,15.666666666666666
130,202,0,23702,8934737,15.538461538461538
220,301,0,23703,8935038,13.681818181818182
340,576,0,23704,8935614,16.941176470588236
290,444,0,23705,8936058,15.310344827586206
280,429,0,23706,8936487,15.321428571428571
230,347,0,23707,8936834,15.08695652173913
360,521,0,23708,8937355,14.472222222222221
110,161,0,23709,8937516,14.636363636363637
330,547,0,23710,8938063,16.575757575757574
190,275,0,23711,8938338,14.473684210526315
160,241,0,23712,8938579,15.0625
140,190,0,23713,8938769,13.571428571428571
320,510,0,23714,8939279,15.9375
340,504,0,23715,8939783,14.823529411764707
400,625,0,23716,8940408,15.625
150,259,0,23717,8940667,17.266666666666666
210,252,0,23718,8940919,12.0
110,133,0,23719,8941052,12.090909090909092
200,271,0,23720,8941323,13.55
150,257,0,23721,8941580,17.133333333333333
110,116,0,23722,8941696,10.545454545454545
180,210,0,23723,8941906,11.666666666666666
260,414,0,23724,8942320,15.923076923076923
170,265,0,23725,8942585,15.588235294117647
250,314,0,23726,8942899,12.56
200,273,0,23727,8943172,13.65
410,732,0,23728,8943904,17.853658536585368
210,280,0,23729,8944184,13.333333333333334
300,442,0,23730,8944626,14.733333333333333
220,325,0,23731,8944951,14.772727272727273
190,255,0,23732,8945206,13.421052631578947
280,431,0,23733,8945637,15.392857142857142
310,521,0,23734,8946158,16.806451612903224
390,670,0,23735,8946828,17.17948717948718
330,487,0,23736,8947315,14.757575757575758
290,482,0,23737,8947797,16.620689655172413
150,213,0,23738,8948010,14.2
180,297,0,23739,8948307,16.5
140,159,0,23740,8948466,11.357142857142858
150,190,0,23741,8948656,12.666666666666666
80,122,0,23742,8948778,15.25
180,225,0,23743,8949003,12.5
420,677,0,23744,8949680,16.11904761904762
380,648,0,23745,8950328,17.05263157894737
380,567,0,23746,8950895,14.921052631578947
120,183,0,23747,8951078,15.25
370,561,0,23748,8951639,15.162162162162161
130,162,0,23749,8951801,12.461538461538462
240,360,0,23750,8952161,15.0
160,189,0,23751,8952350,11.8125
360,540,0,23752,8952890,15.0
570,951,0,23753,8953841,16.68421052631579
380,685,0,23754,8954526,18.026315789473685
230,322,0,23755,8954848,14.0
240,372,0,23756,8955220,15.5
160,286,0,23757,8955506,17.875
510,974,0,23758,8956480,19.098039215686274
200,254,0,23759,8956734,12.7
350,457,0,23760,8957191,13.057142857142857
540,1135,0,23761,8958326,21.01851851851852
310,506,0,23762,8958832,16.322580645161292
360,515,0,23763,8959347,14.305555555555555
350,569,0,23764,8959916,16.257142857142856
280,477,0,23765,8960393,17.035714285714285
220,365,0,23766,8960758,16.59090909090909
140,201,0,23767,8960959,14.357142857142858
340,518,0,23768,8961477,15.235294117647058
150,219,0,23769,8961696,14.6
250,360,0,23770,8962056,14.4
320,428,0,23771,8962484,13.375
240,347,0,23772,8962831,14.458333333333334
220,339,0,23773,8963170,15.409090909090908
240,351,0,23774,8963521,14.625
180,212,0,23775,8963733,11.777777777777779
280,406,0,23776,8964139,14.5
240,389,0,23777,8964528,16.208333333333332
280,389,0,23778,8964917,13.892857142857142
230,432,0,23779,8965349,18.782608695652176
350,577,0,23780,8965926,16.485714285714284
200,242,0,23781,8966168,12.1
210,264,0,23782,8966432,12.571428571428571
330,537,0,23783,8966969,16.272727272727273
250,406,0,23784,8967375,16.24
340,483,0,23785,8967858,14.205882352941176
100,147,0,23786,8968005,14.7
220,313,0,23787,8968318,14.227272727272727
370,596,0,23788,8968914,16.10810810810811
360,592,0,23789,8969506,16.444444444444443
230,364,0,23790,8969870,15.826086956521738
210,343,0,23791,8970213,16.333333333333332
70,105,0,23792,8970318,15.0
280,567,0,23793,8970885,20.25
440,768,0,23794,8971653,17.454545454545453
90,95,0,23795,8971748,10.555555555555555
240,324,0,23796,8972072,13.5
140,188,0,23797,8972260,13.428571428571429
350,542,0,23798,8972802,15.485714285714286
160,228,0,23799,8973030,14.25
130,159,0,23800,8973189,12.23076923076923
320,421,0,23801,8973610,13.15625
280,440,0,23802,8974050,15.714285714285714
270,413,0,23803,8974463,15.296296296296296
330,553,0,23804,8975016,16.757575757575758
360,636,0,23805,8975652,17.666666666666668
160,188,0,23806,8975840,11.75
400,653,0,23807,8976493,16.325
240,326,0,23808,8976819,13.583333333333334
180,246,0,23809,8977065,13.666666666666666
100,127,0,23810,8977192,12.7
360,527,0,23811,8977719,14.63888888888889
90,126,0,23812,8977845,14.0
120,147,0,23813,8977992,12.25
290,425,0,23814,8978417,14.655172413793103
270,507,0,23815,8978924,18.77777777777778
330,489,0,23816,8979413,14.818181818181818
240,333,0,23817,8979746,13.875
430,624,0,23818,8980370,14.511627906976743
330,545,0,23819,8980915,16.515151515151516
330,503,0,23820,8981418,15.242424242424242
300,459,0,23821,8981877,15.3
290,419,0,23822,8982296,14.448275862068966
250,355,0,23823,8982651,14.2
290,406,0,23824,8983057,14.0
110,126,0,23825,8983183,11.454545454545455
230,399,0,23826,8983582,17.347826086956523
90,118,0,23827,8983700,13.11111111111111
230,388,0,23828,8984088,16.869565217391305
330,512,0,23829,8984600,15.515151515151516
240,335,0,23830,8984935,13.958333333333334
280,440,0,23831,8985375,15.714285714285714
390,630,0,23832,8986005,16.153846153846153
160,184,0,23833,8986189,11.5
550,809,0,23834,8986998,14.709090909090909
160,207,0,23835,8987205,12.9375
130,217,0,23836,8987422,16.692307692307693
220,317,0,23837,8987739,14.409090909090908
160,227,0,23838,8987966,14.1875
220,284,0,23839,8988250,12.909090909090908
190,294,0,23840,8988544,15.473684210526315
230,268,0,23841,8988812,11.652173913043478
210,295,0,23842,8989107,14.047619047619047
470,673,0,23843,8989780,14.319148936170214
320,475,0,23844,8990255,14.84375
200,295,0,23845,8990550,14.75
200,246,0,23846,8990796,12.3
110,133,0,23847,8990929,12.090909090909092
360,598,0,23848,8991527,16.61111111111111
290,431,0,23849,8991958,14.862068965517242
310,441,0,23850,8992399,14.225806451612904
190,233,0,23851,8992632,12.263157894736842
270,437,0,23852,8993069,16.185185185185187
510,1005,0,23853,8994074,19.705882352941178
210,320,0,23854,8994394,15.238095238095237
130,186,0,23855,8994580,14.307692307692308
200,298,0,23856,8994878,14.9
120,155,0,23857,8995033,12.916666666666666
190,235,0,23858,8995268,12.368421052631579
210,285,0,23859,8995553,13.571428571428571
180,253,0,23860,8995806,14.055555555555555
150,232,0,23861,8996038,15.466666666666667
310,413,0,23862,8996451,13.32258064516129
510,870,0,23863,8997321,17.058823529411764
300,493,0,23864,8997814,16.433333333333334
120,150,0,23865,8997964,12.5
360,524,0,23866,8998488,14.555555555555555
430,679,0,23867,8999167,15.790697674418604
190,259,0,23868,8999426,13.631578947368421
100,137,0,23869,8999563,13.7
170,289,0,23870,8999852,17.0
90,104,0,23871,8999956,11.555555555555555
490,751,0,23872,9000707,15.326530612244898
160,187,0,23873,9000894,11.6875
350,648,0,23874,9001542,18.514285714285716
260,378,0,23875,9001920,14.538461538461538
330,512,0,23876,9002432,15.515151515151516
180,251,0,23877,9002683,13.944444444444445
220,347,0,23878,9003030,15.772727272727273
410,593,0,23879,9003623,14.463414634146341
410,712,0,23880,9004335,17.365853658536587
270,396,0,23881,9004731,14.666666666666666
280,429,0,23882,9005160,15.321428571428571
150,224,0,23883,9005384,14.933333333333334
320,499,0,23884,9005883,15.59375
390,700,0,23885,9006583,17.94871794871795
240,374,0,23886,9006957,15.583333333333334
220,256,0,23887,9007213,11.636363636363637
180,208,0,23888,9007421,11.555555555555555
270,364,0,23889,9007785,13.481481481481481
330,488,0,23890,9008273,14.787878787878787
130,136,0,23891,9008409,10.461538461538462
150,222,0,23892,9008631,14.8
190,294,0,23893,9008925,15.473684210526315
370,574,0,23894,9009499,15.513513513513514
220,342,0,23895,9009841,15.545454545454545
270,453,0,23896,9010294,16.77777777777778
370,618,0,23897,9010912,16.7027027027027
270,355,0,23898,9011267,13.148148148148149
260,347,0,23899,9011614,13.346153846153847
250,361,0,23900,9011975,14.44
260,380,0,23901,9012355,14.615384615384615
200,312,0,23902,9012667,15.6
150,171,0,23903,9012838,11.4
280,336,0,23904,9013174,12.0
80,104,0,23905,9013278,13.0
50,48,0,23906,9013326,9.6
240,330,0,23907,9013656,13.75
310,424,0,23908,9014080,13.67741935483871
480,837,0,23909,9014917,17.4375
250,380,0,23910,9015297,15.2
350,501,0,23911,9015798,14.314285714285715
400,542,0,23912,9016340,13.55
240,415,0,23913,9016755,17.291666666666668
350,610,0,23914,9017365,17.428571428571427
200,302,0,23915,9017667,15.1
340,509,0,23916,9018176,14.970588235294118
200,262,0,23917,9018438,13.1
150,194,0,23918,9018632,12.933333333333334
200,308,0,23919,9018940,15.4
260,435,0,23920,9019375,16.73076923076923
500,916,0,23921,9020291,18.32
190,328,0,23922,9020619,17.263157894736842
280,423,0,23923,9021042,15.107142857142858
100,112,0,23924,9021154,11.2
200,291,0,23925,9021445,14.55
220,279,0,23926,9021724,12.681818181818182
260,331,0,23927,9022055,12.73076923076923
200,261,0,23928,9022316,13.05
210,329,0,23929,9022645,15.666666666666666
330,511,0,23930,9023156,15.484848484848484
370,549,0,23931,9023705,14.837837837837839
210,297,0,23932,9024002,14.142857142857142
350,531,0,23933,9024533,15.17142857142857
280,384,0,23934,9024917,13.714285714285714
210,269,0,23935,9025186,12.80952380952381
220,312,0,23936,9025498,14.181818181818182
120,179,0,23937,9025677,14.916666666666666
530,965,0,23938,9026642,18.20754716981132
180,230,0,23939,9026872,12.777777777777779
300,488,0,23940,9027360,16.266666666666666
240,279,0,23941,9027639,11.625
190,243,0,23942,9027882,12.789473684210526
120,180,0,23943,9028062,15.0
110,171,0,23944,9028233,15.545454545454545
370,626,0,23945,9028859,16.91891891891892
160,166,0,23946,9029025,10.375
290,416,0,23947,9029441,14.344827586206897
420,667,0,23948,9030108,15.880952380952381
180,266,0,23949,9030374,14.777777777777779
210,256,0,23950,9030630,12.19047619047619
300,417,0,23951,9031047,13.9
180,247,0,23952,9031294,13.722222222222221
310,479,0,23953,9031773,15.451612903225806
210,280,0,23954,9032053,13.333333333333334
280,426,0,23955,9032479,15.214285714285714
170,221,0,23956,9032700,13.0
190,249,0,23957,9032949,13.105263157894736
280,346,0,23958,9033295,12.357142857142858
490,732,0,23959,9034027,14.938775510204081
260,397,0,23960,9034424,15.26923076923077
160,186,0,23961,9034610,11.625
200,274,0,23962,9034884,13.7
400,579,0,23963,9035463,14.475
370,649,0,23964,9036112,17.54054054054054
80,82,0,23965,9036194,10.25
100,144,0,23966,9036338,14.4
330,523,0,23967,9036861,15.848484848484848
230,319,0,23968,9037180,13.869565217391305
370,534,0,23969,9037714,14.432432432432432
160,241,0,23970,9037955,15.0625
100,108,0,23971,9038063,10.8
270,532,0,23972,9038595,19.703703703703702
170,241,0,23973,9038836,14.176470588235293
500,883,0,23974,9039719,17.66
190,276,0,23975,9039995,14.526315789473685
220,386,0,23976,9040381,17.545454545454547
200,271,0,23977,9040652,13.55
350,518,0,23978,9041170,14.8
190,301,0,23979,9041471,15.842105263157896
230,395,0,23980,9041866,17.17391304347826
210,306,0,23981,9042172,14.571428571428571
150,200,0,23982,9042372,13.333333333333334
200,321,0,23983,9042693,16.05
180,233,0,23984,9042926,12.944444444444445
190,269,0,23985,9043195,14.157894736842104
350,571,0,23986,9043766,16.314285714285713
120,191,0,23987,9043957,15.916666666666666
330,540,0,23988,9044497,16.363636363636363
330,527,0,23989,9045024,15.969696969696969
210,258,0,23990,9045282,12.285714285714286
150,207,0,23991,9045489,13.8
310,470,0,23992,9045959,15.161290322580646
310,585,0,23993,9046544,18.870967741935484
190,268,0,23994,9046812,14.105263157894736
140,157,0,23995,9046969,11.214285714285714
250,393,0,23996,9047362,15.72
340,545,0,23997,9047907,16.029411764705884
270,425,0,23998,9048332,15.74074074074074
130,176,0,23999,9048508,13.538461538461538
80,87,0,24000,9048595,10.875
190,272,0,24001,9048867,14.31578947368421
350,477,0,24002,9049344,13.628571428571428
380,514,0,24003,9049858,13.526315789473685
320,495,0,24004,9050353,15.46875
410,526,0,24005,9050879,12.829268292682928
280,420,0,24006,9051299,15.0
100,121,0,24007,9051420,12.1
250,374,0,24008,9051794,14.96
310,480,0,24009,9052274,15.483870967741936
160,183,0,24010,9052457,11.4375
160,205,0,24011,9052662,12.8125
160,221,0,24012,9052883,13.8125
340,491,0,24013,9053374,14.441176470588236
420,603,0,24014,9053977,14.357142857142858
370,533,0,24015,9054510,14.405405405405405
250,393,0,24016,9054903,15.72
160,213,0,24017,9055116,13.3125
350,471,0,24018,9055587,13.457142857142857
450,667,0,24019,9056254,14.822222222222223
380,515,0,24020,9056769,13.552631578947368
240,348,0,24021,9057117,14.5
210,285,0,24022,9057402,13.571428571428571
300,441,0,24023,9057843,14.7
310,452,0,24024,9058295,14.580645161290322
180,290,0,24025,9058585,16.11111111111111
230,253,0,24026,9058838,11.0
270,393,0,24027,9059231,14.555555555555555
270,372,0,24028,9059603,13.777777777777779
320,491,0,24029,9060094,15.34375
180,318,0,24030,9060412,17.666666666666668
370,533,0,24031,9060945,14.405405405405405
190,258,0,24032,9061203,13.578947368421053
390,586,0,24033,9061789,15.025641025641026
350,574,0,24034,9062363,16.4
110,132,0,24035,9062495,12.0
200,272,0,24036,9062767,13.6
170,228,0,24037,9062995,13.411764705882353
130,198,0,24038,9063193,15.23076923076923
410,715,0,24039,9063908,17.4390243902439
270,403,0,24040,9064311,14.925925925925926
270,466,0,24041,9064777,17.25925925925926
320,454,0,24042,9065231,14.1875
230,277,0,24043,9065508,12.043478260869565
380,608,0,24044,9066116,16.0
220,311,0,24045,9066427,14.136363636363637
180,273,0,24046,9066700,15.166666666666666
100,145,0,24047,9066845,14.5
280,395,0,24048,9067240,14.107142857142858
330,467,0,24049,9067707,14.151515151515152
50,75,0,24050,9067782,15.0
280,323,0,24051,9068105,11.535714285714286
140,187,0,24052,9068292,13.357142857142858
240,359,0,24053,9068651,14.958333333333334
350,472,0,24054,9069123,13.485714285714286
170,227,0,24055,9069350,13.352941176470589
380,618,0,24056,9069968,16.263157894736842
220,281,0,24057,9070249,12.772727272727273
140,172,0,24058,9070421,12.285714285714286
100,138,0,24059,9070559,13.8
300,507,0,24060,9071066,16.9
410,668,0,24061,9071734,16.29268292682927
620,988,0,24062,9072722,15.935483870967742
90,96,0,24063,9072818,10.666666666666666
270,383,0,24064,9073201,14.185185185185185
160,233,0,24065,9073434,14.5625
250,411,0,24066,9073845,16.44
300,453,0,24067,9074298,15.1
250,376,0,24068,9074674,15.04
230,297,0,24069,9074971,12.91304347826087
190,265,0,24070,9075236,13.947368421052632
110,127,0,24071,9075363,11.545454545454545
400,565,0,24072,9075928,14.125
230,302,0,24073,9076230,13.130434782608695
240,263,0,24074,9076493,10.958333333333334
290,424,0,24075,9076917,14.620689655172415
280,419,0,24076,9077336,14.964285714285714
140,224,0,24077,9077560,16.0
310,455,0,24078,9078015,14.67741935483871
240,374,0,24079,9078389,15.583333333333334
450,649,0,24080,9079038,14.422222222222222
230,336,0,24081,9079374,14.608695652173912
390,641,0,24082,9080015,16.435897435897434
110,115,0,24083,9080130,10.454545454545455
280,365,0,24084,9080495,13.035714285714286
250,331,0,24085,9080826,13.24
280,398,0,24086,9081224,14.214285714285714
220,341,0,24087,9081565,15.5
310,550,0,24088,9082115,17.741935483870968
230,273,0,24089,9082388,11.869565217391305
380,650,0,24090,9083038,17.105263157894736
220,348,0,24091,9083386,15.818181818181818
460,786,0,24092,9084172,17.08695652173913
260,402,0,24093,9084574,15.461538461538462
280,430,0,24094,9085004,15.357142857142858
320,532,0,24095,9085536,16.625
300,436,0,24096,9085972,14.533333333333333
120,175,0,24097,9086147,14.583333333333334
520,908,0,24098,9087055,17.46153846153846
180,272,0,24099,9087327,15.11111111111111
220,324,0,24100,9087651,14.727272727272727
180,252,0,24101,9087903,14.0
210,254,0,24102,9088157,12.095238095238095
100,123,0,24103,9088280,12.3
100,143,0,24104,9088423,14.3
340,445,0,24105,9088868,13.088235294117647
160,269,0,24106,9089137,16.8125
310,467,0,24107,9089604,15.064516129032258
300,405,0,24108,9090009,13.5
270,406,0,24109,9090415,15.037037037037036
240,284,0,24110,9090699,11.833333333333334
80,138,0,24111,9090837,17.25
270,385,0,24112,9091222,14.25925925925926
120,162,0,24113,9091384,13.5
250,347,0,24114,9091731,13.88
320,544,0,24115,9092275,17.0
190,257,0,24116,9092532,13.526315789473685
340,542,0,24117,9093074,15.941176470588236
350,488,0,24118,9093562,13.942857142857143
180,212,0,24119,9093774,11.777777777777779
460,794,0,24120,9094568,17.26086956521739
220,305,0,24121,9094873,13.863636363636363
370,524,0,24122,9095397,14.162162162162161
170,245,0,24123,9095642,14.411764705882353
280,422,0,24124,9096064,15.071428571428571
200,254,0,24125,9096318,12.7
320,518,0,24126,9096836,16.1875
150,207,0,24127,9097043,13.8
320,419,0,24128,9097462,13.09375
210,255,0,24129,9097717,12.142857142857142
380,559,0,24130,9098276,14.710526315789474
180,211,0,24131,9098487,11.722222222222221
90,119,0,24132,9098606,13.222222222222221
320,534,0,24133,9099140,16.6875
510,840,0,24134,9099980,16.470588235294116
240,359,0,24135,9100339,14.958333333333334
440,656,0,24136,9100995,14.909090909090908
470,761,0,24137,9101756,16.19148936170213
160,261,0,24138,9102017,16.3125
90,128,0,24139,9102145,14.222222222222221
460,815,0,24140,9102960,17.717391304347824
260,430,0,24141,9103390,16.53846153846154
180,220,0,24142,9103610,12.222222222222221
200,272,0,24143,9103882,13.6
230,310,0,24144,9104192,13.478260869565217
360,585,0,24145,9104777,16.25
240,339,0,24146,9105116,14.125
250,405,0,24147,9105521,16.2
230,405,0,24148,9105926,17.608695652173914
320,459,0,24149,9106385,14.34375
340,503,0,24150,9106888,14.794117647058824
240,357,0,24151,9107245,14.875
280,409,0,24152,9107654,14.607142857142858
150,244,0,24153,9107898,16.266666666666666
350,508,0,24154,9108406,14.514285714285714
230,323,0,24155,9108729,14.043478260869565
310,489,0,24156,9109218,15.774193548387096
150,203,0,24157,9109421,13.533333333333333
270,396,0,24158,9109817,14.666666666666666
370,602,0,24159,9110419,16.27027027027027
160,237,0,24160,9110656,14.8125
100,158,0,24161,9110814,15.8
90,124,0,24162,9110938,13.777777777777779
220,332,0,24163,9111270,15.090909090909092
350,485,0,24164,9111755,13.857142857142858
210,283,0,24165,9112038,13.476190476190476
190,281,0,24166,9112319,14.789473684210526
90,112,0,24167,9112431,12.444444444444445
120,144,0,24168,9112575,12.0
200,279,0,24169,9112854,13.95
150,155,0,24170,9113009,10.333333333333334
390,571,0,24171,9113580,14.64102564102564
390,651,0,24172,9114231,16.692307692307693
440,706,0,24173,9114937,16.045454545454547
390,553,0,24174,9115490,14.179487179487179
350,580,0,24175,9116070,16.571428571428573
100,105,0,24176,9116175,10.5
150,251,0,24177,9116426,16.733333333333334
300,523,0,24178,9116949,17.433333333333334
360,545,0,24179,9117494,15.13888888888889
170,251,0,24180,9117745,14.764705882352942
260,386,0,24181,9118131,14.846153846153847
260,357,0,24182,9118488,13.73076923076923
270,347,0,24183,9118835,12.851851851851851
220,354,0,24184,9119189,16.09090909090909
220,275,0,24185,9119464,12.5
290,428,0,24186,9119892,14.758620689655173
300,466,0,24187,9120358,15.533333333333333
180,244,0,24188,9120602,13.555555555555555
360,496,0,24189,9121098,13.777777777777779
170,270,0,24190,9121368,15.882352941176471
240,324,0,24191,9121692,13.5
210,269,0,24192,9121961,12.80952380952381
410,727,0,24193,9122688,17.73170731707317
310,432,0,24194,9123120,13.935483870967742
80,104,0,24195,9123224,13.0
530,714,0,24196,9123938,13.471698113207546
370,619,0,24197,9124557,16.72972972972973
270,403,0,24198,9124960,14.925925925925926
150,174,0,24199,9125134,11.6
180,218,0,24200,9125352,12.11111111111111
140,191,0,24201,9125543,13.642857142857142
230,348,0,24202,9125891,15.130434782608695
290,369,0,24203,9126260,12.724137931034482
460,811,0,24204,9127071,17.630434782608695
340,496,0,24205,9127567,14.588235294117647
170,215,0,24206,9127782,12.647058823529411
110,156,0,24207,9127938,14.181818181818182
140,199,0,24208,9128137,14.214285714285714
370,670,0,24209,9128807,18.10810810810811
450,706,0,24210,9129513,15.688888888888888
300,371,0,24211,9129884,12.366666666666667
120,153,0,24212,9130037,12.75
220,317,0,24213,9130354,14.409090909090908
200,352,0,24214,9130706,17.6
110,132,0,24215,9130838,12.0
120,190,0,24216,9131028,15.833333333333334
310,444,0,24217,9131472,14.32258064516129
220,272,0,24218,9131744,12.363636363636363
220,259,0,24219,9132003,11.772727272727273
310,430,0,24220,9132433,13.870967741935484
500,714,0,24221,9133147,14.28
140,183,0,24222,9133330,13.071428571428571
470,817,0,24223,9134147,17.382978723404257
180,229,0,24224,9134376,12.722222222222221
250,406,0,24225,9134782,16.24
300,441,0,24226,9135223,14.7
110,179,0,24227,9135402,16.272727272727273
180,216,0,24228,9135618,12.0
150,200,0,24229,9135818,13.333333333333334
310,412,0,24230,9136230,13.290322580645162
420,718,0,24231,9136948,17.095238095238095
290,355,0,24232,9137303,12.241379310344827
330,528,0,24233,9137831,16.0
140,143,0,24234,9137974,10.214285714285714
110,172,0,24235,9138146,15.636363636363637
150,196,0,24236,9138342,13.066666666666666
190,236,0,24237,9138578,12.421052631578947
80,156,0,24238,9138734,19.5
340,500,0,24239,9139234,14.705882352941176
140,165,0,24240,9139399,11.785714285714286
230,327,0,24241,9139726,14.217391304347826
230,414,0,24242,9140140,18.0
280,444,0,24243,9140584,15.857142857142858
500,724,0,24244,9141308,14.48
270,375,0,24245,9141683,13.88888888888889
280,426,0,24246,9142109,15.214285714285714
180,211,0,24247,9142320,11.722222222222221
130,152,0,24248,9142472,11.692307692307692
260,385,0,24249,9142857,14.807692307692308
120,195,0,24250,9143052,16.25
290,455,0,24251,9143507,15.689655172413794
230,343,0,24252,9143850,14.91304347826087
250,376,0,24253,9144226,15.04
100,109,0,24254,9144335,10.9
400,532,0,24255,9144867,13.3
450,681,0,24256,9145548,15.133333333333333
290,430,0,24257,9145978,14.827586206896552
220,263,0,24258,9146241,11.954545454545455
90,93,0,24259,9146334,10.333333333333334
230,329,0,24260,9146663,14.304347826086957
350,528,0,24261,9147191,15.085714285714285
200,302,0,24262,9147493,15.1
280,347,0,24263,9147840,12.392857142857142
120,200,0,24264,9148040,16.666666666666668
280,361,0,24265,9148401,12.892857142857142
270,382,0,24266,9148783,14.148148148148149
280,423,0,24267,9149206,15.107142857142858
60,82,0,24268,9149288,13.666666666666666
180,347,0,24269,9149635,19.27777777777778
240,370,0,24270,9150005,15.416666666666666
140,206,0,24271,9150211,14.714285714285714
130,223,0,24272,9150434,17.153846153846153
520,822,0,24273,9151256,15.807692307692308
280,458,0,24274,9151714,16.357142857142858
230,376,0,24275,9152090,16.347826086956523
180,230,0,24276,9152320,12.777777777777779
110,166,0,24277,9152486,15.090909090909092
190,271,0,24278,9152757,14.263157894736842
140,149,0,24279,9152906,10.642857142857142
250,358,0,24280,9153264,14.32
170,262,0,24281,9153526,15.411764705882353
250,379,0,24282,9153905,15.16
180,261,0,24283,9154166,14.5
380,621,0,24284,9154787,16.342105263157894
200,278,0,24285,9155065,13.9
370,600,0,24286,9155665,16.216216216216218
370,547,0,24287,9156212,14.783783783783784
360,589,0,24288,9156801,16.36111111111111
250,370,0,24289,9157171,14.8
210,303,0,24290,9157474,14.428571428571429
440,718,0,24291,9158192,16.318181818181817
170,281,0,24292,9158473,16.529411764705884
380,711,0,24293,9159184,18.710526315789473
340,522,0,24294,9159706,15.352941176470589
270,401,0,24295,9160107,14.851851851851851
220,318,0,24296,9160425,14.454545454545455
160,209,0,24297,9160634,13.0625
410,614,0,24298,9161248,14.975609756097562
280,404,0,24299,9161652,14.428571428571429
110,162,0,24300,9161814,14.727272727272727
220,362,0,24301,9162176,16.454545454545453
440,807,0,24302,9162983,18.34090909090909
160,208,0,24303,9163191,13.0
400,638,0,24304,9163829,15.95
140,182,0,24305,9164011,13.0
250,393,0,24306,9164404,15.72
300,383,0,24307,9164787,12.766666666666667
240,375,0,24308,9165162,15.625
250,296,0,24309,9165458,11.84
280,483,0,24310,9165941,17.25
220,281,0,24311,9166222,12.772727272727273
220,300,0,24312,9166522,13.636363636363637
220,282,0,24313,9166804,12.818181818181818
250,390,0,24314,9167194,15.6
150,230,0,24315,9167424,15.333333333333334
120,152,0,24316,9167576,12.666666666666666
420,584,0,24317,9168160,13.904761904761905
150,205,0,24318,9168365,13.666666666666666
220,335,0,24319,9168700,15.227272727272727
360,527,0,24320,9169227,14.63888888888889
400,609,0,24321,9169836,15.225
160,202,0,24322,9170038,12.625
380,603,0,24323,9170641,15.868421052631579
230,358,0,24324,9170999,15.565217391304348
160,236,0,24325,9171235,14.75
420,631,0,24326,9171866,15.023809523809524
390,682,0,24327,9172548,17.487179487179485
390,625,0,24328,9173173,16.025641025641026
80,126,0,24329,9173299,15.75
180,183,0,24330,9173482,10.166666666666666
560,956,0,24331,9174438,17.071428571428573
360,483,0,24332,9174921,13.416666666666666
130,185,0,24333,9175106,14.23076923076923
170,230,0,24334,9175336,13.529411764705882
380,599,0,24335,9175935,15.763157894736842
320,511,0,24336,9176446,15.96875
260,334,0,24337,9176780,12.846153846153847
110,199,0,24338,9176979,18.09090909090909
180,244,0,24339,9177223,13.555555555555555
300,414,0,24340,9177637,13.8
250,341,0,24341,9177978,13.64
300,385,0,24342,9178363,12.833333333333334
280,451,0,24343,9178814,16.107142857142858
280,408,0,24344,9179222,14.571428571428571
430,652,0,24345,9179874,15.162790697674419
180,243,0,24346,9180117,13.5
320,473,0,24347,9180590,14.78125
460,752,0,24348,9181342,16.347826086956523
240,270,0,24349,9181612,11.25
270,400,0,24350,9182012,14.814814814814815
380,578,0,24351,9182590,15.210526315789474
280,396,0,24352,9182986,14.142857142857142
190,266,0,24353,9183252,14.0
320,483,0,24354,9183735,15.09375
310,353,0,24355,9184088,11.387096774193548
390,569,0,24356,9184657,14.58974358974359
130,186,0,24357,9184843,14.307692307692308
500,752,0,24358,9185595,15.04
210,321,0,24359,9185916,15.285714285714286
200,340,0,24360,9186256,17.0
280,436,0,24361,9186692,15.571428571428571
250,331,0,24362,9187023,13.24
320,462,0,24363,9187485,14.4375
190,247,0,24364,9187732,13.0
230,336,0,24365,9188068,14.608695652173912
410,640,0,24366,9188708,15.609756097560975
170,287,0,24367,9188995,16.88235294117647
280,396,0,24368,9189391,14.142857142857142
200,217,0,24369,9189608,10.85
300,447,0,24370,9190055,14.9
270,454,0,24371,9190509,16.814814814814813
360,501,0,24372,9191010,13.916666666666666
100,121,0,24373,9191131,12.1
180,256,0,24374,9191387,14.222222222222221
240,407,0,24375,9191794,16.958333333333332
110,137,0,24376,9191931,12.454545454545455
180,284,0,24377,9192215,15.777777777777779
140,203,0,24378,9192418,14.5
230,342,0,24379,9192760,14.869565217391305
240,382,0,24380,9193142,15.916666666666666
270,391,0,24381,9193533,14.481481481481481
310,458,0,24382,9193991,14.774193548387096
190,278,0,24383,9194269,14.631578947368421
260,348,0,24384,9194617,13.384615384615385
160,215,0,24385,9194832,13.4375
90,131,0,24386,9194963,14.555555555555555
180,233,0,24387,9195196,12.944444444444445
100,111,0,24388,9195307,11.1
210,287,0,24389,9195594,13.666666666666666
340,515,0,24390,9196109,15.147058823529411
350,534,0,24391,9196643,15.257142857142858
180,283,0,24392,9196926,15.722222222222221
170,280,0,24393,9197206,16.470588235294116
220,369,0,24394,9197575,16.772727272727273
230,291,0,24395,9197866,12.652173913043478
210,295,0,24396,9198161,14.047619047619047
210,282,0,24397,9198443,13.428571428571429
130,194,0,24398,9198637,14.923076923076923
120,128,0,24399,9198765,10.666666666666666
330,478,0,24400,9199243,14.484848484848484
190,249,0,24401,9199492,13.105263157894736
300,381,0,24402,9199873,12.7
310,455,0,24403,9200328,14.67741935483871
310,438,0,24404,9200766,14.129032258064516
350,604,0,24405,9201370,17.257142857142856
90,170,0,24406,9201540,18.88888888888889
100,141,0,24407,9201681,14.1
220,296,0,24408,9201977,13.454545454545455
200,232,0,24409,9202209,11.6
80,106,0,24410,9202315,13.25
180,247,0,24411,9202562,13.722222222222221
160,230,0,24412,9202792,14.375
120,163,0,24413,9202955,13.583333333333334
410,671,0,24414,9203626,16.365853658536587
290,489,0,24415,9204115,16.862068965517242
450,693,0,24416,9204808,15.4
300,537,0,24417,9205345,17.9
280,339,0,24418,9205684,12.107142857142858
240,349,0,24419,9206033,14.541666666666666
290,463,0,24420,9206496,15.96551724137931
310,444,0,24421,9206940,14.32258064516129
300,414,0,24422,9207354,13.8
250,304,0,24423,9207658,12.16
130,196,0,24424,9207854,15.076923076923077
190,283,0,24425,9208137,14.894736842105264
140,169,0,24426,9208306,12.071428571428571
110,163,0,24427,9208469,14.818181818181818
230,291,0,24428,9208760,12.652173913043478
160,216,0,24429,9208976,13.5
190,286,0,24430,9209262,15.052631578947368
350,500,0,24431,9209762,14.285714285714286
230,301,0,24432,9210063,13.08695652173913
360,586,0,24433,9210649,16.27777777777778
270,364,0,24434,9211013,13.481481481481481
430,634,0,24435,9211647,14.744186046511627
240,376,0,24436,9212023,15.666666666666666
260,327,0,24437,9212350,12.576923076923077
170,234,0,24438,9212584,13.764705882352942
260,384,0,24439,9212968,14.76923076923077
170,287,0,24440,9213255,16.88235294117647
380,503,0,24441,9213758,13.236842105263158
350,545,0,24442,9214303,15.571428571428571
190,251,0,24443,9214554,13.210526315789474
200,316,0,24444,9214870,15.8
210,305,0,24445,9215175,14.523809523809524
150,232,0,24446,9215407,15.466666666666667
310,495,0,24447,9215902,15.96774193548387
210,306,0,24448,9216208,14.571428571428571
410,636,0,24449,9216844,15.512195121951219
310,512,0,24450,9217356,16.516129032258064
180,231,0,24451,9217587,12.833333333333334
160,230,0,24452,9217817,14.375
200,283,0,24453,9218100,14.15
80,102,0,24454,9218202,12.75
170,248,0,24455,9218450,14.588235294117647
140,226,0,24456,9218676,16.142857142857142
260,361,0,24457,9219037,13.884615384615385
210,341,0,24458,9219378,16.238095238095237
310,713,0,24459,9220091,23.0
340,537,0,24460,9220628,15.794117647058824
260,342,0,24461,9220970,13.153846153846153
230,355,0,24462,9221325,15.434782608695652
140,212,0,24463,9221537,15.142857142857142
60,71,0,24464,9221608,11.833333333333334
190,273,0,24465,9221881,14.368421052631579
200,293,0,24466,9222174,14.65
180,247,0,24467,9222421,13.722222222222221
200,276,0,24468,9222697,13.8
170,221,0,24469,9222918,13.0
380,574,0,24470,9223492,15.105263157894736
300,427,0,24471,9223919,14.233333333333333
380,617,0,24472,9224536,16.236842105263158
190,230,0,24473,9224766,12.105263157894736
340,506,0,24474,9225272,14.882352941176471
340,592,0,24475,9225864,17.41176470588235
320,444,0,24476,9226308,13.875
240,327,0,24477,9226635,13.625
180,225,0,24478,9226860,12.5
460,728,0,24479,9227588,15.826086956521738
440,706,0,24480,9228294,16.045454545454547
280,354,0,24481,9228648,12.642857142857142
100,153,0,24482,9228801,15.3
200,285,0,24483,9229086,14.25
320,571,0,24484,9229657,17.84375
340,525,0,24485,9230182,15.441176470588236
180,257,0,24486,9230439,14.277777777777779
430,728,0,24487,9231167,16.930232558139537
330,501,0,24488,9231668,15.181818181818182
440,689,0,24489,9232357,15.659090909090908
360,600,0,24490,9232957,16.666666666666668
330,490,0,24491,9233447,14.848484848484848
320,468,0,24492,9233915,14.625
430,704,0,24493,9234619,16.372093023255815
340,430,0,24494,9235049,12.647058823529411
230,318,0,24495,9235367,13.826086956521738
280,381,0,24496,9235748,13.607142857142858
260,382,0,24497,9236130,14.692307692307692
120,150,0,24498,9236280,12.5
230,337,0,24499,9236617,14.652173913043478
280,448,0,24500,9237065,16.0
200,269,0,24501,9237334,13.45
270,361,0,24502,9237695,13.37037037037037
200,329,0,24503,9238024,16.45
330,468,0,24504,9238492,14.181818181818182
200,298,0,24505,9238790,14.9
350,544,0,24506,9239334,15.542857142857143
290,460,0,24507,9239794,15.862068965517242
190,281,0,24508,9240075,14.789473684210526
280,402,0,24509,9240477,14.357142857142858
230,294,0,24510,9240771,12.782608695652174
240,359,0,24511,9241130,14.958333333333334
360,644,0,24512,9241774,17.88888888888889
200,272,0,24513,9242046,13.6
100,148,0,24514,9242194,14.8
230,359,0,24515,9242553,15.608695652173912
150,155,0,24516,9242708,10.333333333333334
380,567,0,24517,9243275,14.921052631578947
130,202,0,24518,9243477,15.538461538461538
380,570,0,24519,9244047,15.0
200,289,0,24520,9244336,14.45
350,530,0,24521,9244866,15.142857142857142
210,302,0,24522,9245168,14.380952380952381
320,473,0,24523,9245641,14.78125
190,246,0,24524,9245887,12.947368421052632
130,151,0,24525,9246038,11.615384615384615
120,189,0,24526,9246227,15.75
270,445,0,24527,9246672,16.48148148148148
100,160,0,24528,9246832,16.0
370,506,0,24529,9247338,13.675675675675675
280,395,0,24530,9247733,14.107142857142858
280,469,0,24531,9248202,16.75
240,336,0,24532,9248538,14.0
170,258,0,24533,9248796,15.176470588235293
380,557,0,24534,9249353,14.657894736842104
300,464,0,24535,9249817,15.466666666666667
120,187,0,24536,9250004,15.583333333333334
180,263,0,24537,9250267,14.61111111111111
270,418,0,24538,9250685,15.481481481481481
380,633,0,24539,9251318,16.657894736842106
240,323,0,24540,9251641,13.458333333333334
270,389,0,24541,9252030,14.407407407407407
130,163,0,24542,9252193,12.538461538461538
180,247,0,24543,9252440,13.722222222222221
270,401,0,24544,9252841,14.851851851851851
550,867,0,24545,9253708,15.763636363636364
160,207,0,24546,9253915,12.9375
200,288,0,24547,9254203,14.4
170,180,0,24548,9254383,10.588235294117647
330,402,0,24549,9254785,12.181818181818182
280,437,0,24550,9255222,15.607142857142858
200,257,0,24551,9255479,12.85
200,273,0,24552,9255752,13.65
140,204,0,24553,9255956,14.571428571428571
140,256,0,24554,9256212,18.285714285714285
330,369,0,24555,9256581,11.181818181818182
340,466,0,24556,9257047,13.705882352941176
90,129,0,24557,9257176,14.333333333333334
290,446,0,24558,9257622,15.379310344827585
220,300,0,24559,9257922,13.636363636363637
350,524,0,24560,9258446,14.971428571428572
100,144,0,24561,9258590,14.4
210,241,0,24562,9258831,11.476190476190476
220,284,0,24563,9259115,12.909090909090908
370,560,0,24564,9259675,15.135135135135135
370,498,0,24565,9260173,13.45945945945946
300,423,0,24566,9260596,14.1
330,538,0,24567,9261134,16.303030303030305
360,492,0,24568,9261626,13.666666666666666
100,99,0,24569,9261725,9.9
370,599,0,24570,9262324,16.18918918918919
190,275,0,24571,9262599,14.473684210526315
160,195,0,24572,9262794,12.1875
340,456,0,24573,9263250,13.411764705882353
220,361,0,24574,9263611,16.40909090909091
270,358,0,24575,9263969,13.25925925925926
170,244,0,24576,9264213,14.352941176470589
240,301,0,24577,9264514,12.541666666666666
300,418,0,24578,9264932,13.933333333333334
220,310,0,24579,9265242,14.090909090909092
170,240,0,24580,9265482,14.117647058823529
180,310,0,24581,9265792,17.22222222222222
230,345,0,24582,9266137,15.0
230,319,0,24583,9266456,13.869565217391305
330,507,0,24584,9266963,15.363636363636363
400,666,0,24585,9267629,16.65
150,198,0,24586,9267827,13.2
380,560,0,24587,9268387,14.736842105263158
290,478,0,24588,9268865,16.482758620689655
320,520,0,24589,9269385,16.25
210,271,0,24590,9269656,12.904761904761905
210,341,0,24591,9269997,16.238095238095237
370,607,0,24592,9270604,16.405405405405407
250,376,0,24593,9270980,15.04
210,293,0,24594,9271273,13.952380952380953
320,488,0,24595,9271761,15.25
230,373,0,24596,9272134,16.217391304347824
300,329,0,24597,9272463,10.966666666666667
290,421,0,24598,9272884,14.517241379310345
280,358,0,24599,9273242,12.785714285714286
270,377,0,24600,9273619,13.962962962962964
360,555,0,24601,9274174,15.416666666666666
150,183,0,24602,9274357,12.2
200,356,0,24603,9274713,17.8
260,388,0,24604,9275101,14.923076923076923
370,582,0,24605,9275683,15.72972972972973
180,237,0,24606,9275920,13.166666666666666
440,611,0,24607,9276531,13.886363636363637
320,458,0,24608,9276989,14.3125
150,200,0,24609,9277189,13.333333333333334
50,68,0,24610,9277257,13.6
250,377,0,24611,9277634,15.08
250,350,0,24612,9277984,14.0
150,222,0,24613,9278206,14.8
250,435,0,24614,9278641,17.4
180,270,0,24615,9278911,15.0
280,484,0,24616,9279395,17.285714285714285
230,363,0,24617,9279758,15.782608695652174
410,684,0,24618,9280442,16.682926829268293
200,280,0,24619,9280722,14.0
290,353,0,24620,9281075,12.172413793103448
150,210,0,24621,9281285,14.0
240,412,0,24622,9281697,17.166666666666668
130,201,0,24623,9281898,15.461538461538462
300,474,0,24624,9282372,15.8
220,342,0,24625,9282714,15.545454545454545
290,394,0,24626,9283108,13.586206896551724
110,177,0,24627,9283285,16.09090909090909
300,461,0,24628,9283746,15.366666666666667
270,378,0,24629,9284124,14.0
170,266,0,24630,9284390,15.647058823529411
240,345,0,24631,9284735,14.375
290,424,0,24632,9285159,14.620689655172415
340,503,0,24633,9285662,14.794117647058824
240,404,0,24634,9286066,16.833333333333332
590,1052,0,24635,9287118,17.83050847457627
90,126,0,24636,9287244,14.0
290,432,0,24637,9287676,14.89655172413793
200,230,0,24638,9287906,11.5
280,415,0,24639,9288321,14.821428571428571
190,289,0,24640,9288610,15.210526315789474
220,343,0,24641,9288953,15.590909090909092
190,244,0,24642,9289197,12.842105263157896
380,658,0,24643,9289855,17.31578947368421
410,801,0,24644,9290656,19.536585365853657
240,366,0,24645,9291022,15.25
150,204,0,24646,9291226,13.6
260,335,0,24647,9291561,12.884615384615385
350,585,0,24648,9292146,16.714285714285715
360,508,0,24649,9292654,14.11111111111111
380,603,0,24650,9293257,15.868421052631579
160,209,0,24651,9293466,13.0625
320,454,0,24652,9293920,14.1875
340,538,0,24653,9294458,15.823529411764707
300,520,0,24654,9294978,17.333333333333332
210,296,0,24655,9295274,14.095238095238095
130,186,0,24656,9295460,14.307692307692308
270,398,0,24657,9295858,14.74074074074074
370,570,0,24658,9296428,15.405405405405405
320,418,0,24659,9296846,13.0625
220,334,0,24660,9297180,15.181818181818182
280,455,0,24661,9297635,16.25
430,731,0,24662,9298366,17.0
210,347,0,24663,9298713,16.523809523809526
210,356,0,24664,9299069,16.952380952380953
130,182,0,24665,9299251,14.0
400,585,0,24666,9299836,14.625
250,412,0,24667,9300248,16.48
380,623,0,24668,9300871,16.394736842105264
50,80,0,24669,9300951,16.0
410,599,0,24670,9301550,14.609756097560975
310,386,0,24671,9301936,12.451612903225806
210,285,0,24672,9302221,13.571428571428571
340,561,0,24673,9302782,16.5
120,169,0,24674,9302951,14.083333333333334
360,538,0,24675,9303489,14.944444444444445
230,371,0,24676,9303860,16.130434782608695
130,163,0,24677,9304023,12.538461538461538
250,374,0,24678,9304397,14.96
150,201,0,24679,9304598,13.4
170,277,0,24680,9304875,16.294117647058822
410,624,0,24681,9305499,15.21951219512195
100,128,0,24682,9305627,12.8
360,564,0,24683,9306191,15.666666666666666
300,445,0,24684,9306636,14.833333333333334
140,212,0,24685,9306848,15.142857142857142
70,75,0,24686,9306923,10.714285714285714
280,385,0,24687,9307308,13.75
340,577,0,24688,9307885,16.970588235294116
240,317,0,24689,9308202,13.208333333333334
180,281,0,24690,9308483,15.61111111111111
370,519,0,24691,9309002,14.027027027027026
170,331,0,24692,9309333,19.470588235294116
100,112,0,24693,9309445,11.2
360,534,0,24694,9309979,14.833333333333334
210,313,0,24695,9310292,14.904761904761905
220,336,0,24696,9310628,15.272727272727273
210,269,0,24697,9310897,12.80952380952381
80,105,0,24698,9311002,13.125
220,279,0,24699,9311281,12.681818181818182
260,431,0,24700,9311712,16.576923076923077
430,668,0,24701,9312380,15.534883720930232
480,805,0,24702,9313185,16.770833333333332
240,378,0,24703,9313563,15.75
170,239,0,24704,9313802,14.058823529411764
150,198,0,24705,9314000,13.2
360,604,0,24706,9314604,16.77777777777778
230,332,0,24707,9314936,14.434782608695652
200,303,0,24708,9315239,15.15
320,506,0,24709,9315745,15.8125
310,470,0,24710,9316215,15.161290322580646
240,375,0,24711,9316590,15.625
220,330,0,24712,9316920,15.0
300,430,0,24713,9317350,14.333333333333334
210,333,0,24714,9317683,15.857142857142858
200,256,0,24715,9317939,12.8
310,555,0,24716,9318494,17.903225806451612
270,358,0,24717,9318852,13.25925925925926
330,510,0,24718,9319362,15.454545454545455
170,178,0,24719,9319540,10.470588235294118
130,175,0,24720,9319715,13.461538461538462
230,350,0,24721,9320065,15.217391304347826
250,355,0,24722,9320420,14.2
160,240,0,24723,9320660,15.0
120,190,0,24724,9320850,15.833333333333334
80,109,0,24725,9320959,13.625
320,575,0,24726,9321534,17.96875
260,360,0,24727,9321894,13.846153846153847
380,592,0,24728,9322486,15.578947368421053
270,370,0,24729,9322856,13.703703703703704
210,282,0,24730,9323138,13.428571428571429
230,376,0,24731,9323514,16.347826086956523
290,491,0,24732,9324005,16.93103448275862
240,379,0,24733,9324384,15.791666666666666
330,500,0,24734,9324884,15.151515151515152
220,322,0,24735,9325206,14.636363636363637
390,606,0,24736,9325812,15.538461538461538
340,482,0,24737,9326294,14.176470588235293
170,191,0,24738,9326485,11.235294117647058
280,458,0,24739,9326943,16.357142857142858
190,319,0,24740,9327262,16.789473684210527
160,225,0,24741,9327487,14.0625
310,415,0,24742,9327902,13.387096774193548
290,388,0,24743,9328290,13.379310344827585
320,440,0,24744,9328730,13.75
70,68,0,24745,9328798,9.714285714285714
180,234,0,24746,9329032,13.0
130,188,0,24747,9329220,14.461538461538462
140,197,0,24748,9329417,14.071428571428571
180,253,0,24749,9329670,14.055555555555555
350,640,0,24750,9330310,18.285714285714285
150,154,0,24751,9330464,10.266666666666667
200,261,0,24752,9330725,13.05
170,286,0,24753,9331011,16.823529411764707
330,458,0,24754,9331469,13.878787878787879
260,389,0,24755,9331858,14.961538461538462
230,390,0,24756,9332248,16.956521739130434
230,322,0,24757,9332570,14.0
330,469,0,24758,9333039,14.212121212121213
220,297,0,24759,9333336,13.5
370,511,0,24760,9333847,13.81081081081081
550,842,0,24761,9334689,15.309090909090909
150,213,0,24762,9334902,14.2
250,387,0,24763,9335289,15.48
250,388,0,24764,9335677,15.52
130,214,0,24765,9335891,16.46153846153846
280,445,0,24766,9336336,15.892857142857142
130,150,0,24767,9336486,11.538461538461538
120,138,0,24768,9336624,11.5
210,274,0,24769,9336898,13.047619047619047
280,427,0,24770,9337325,15.25
110,133,0,24771,9337458,12.090909090909092
250,403,0,24772,9337861,16.12
150,184,0,24773,9338045,12.266666666666667
350,574,0,24774,9338619,16.4
140,179,0,24775,9338798,12.785714285714286
470,789,0,24776,9339587,16.78723404255319
190,313,0,24777,9339900,16.473684210526315
160,224,0,24778,9340124,14.0
240,307,0,24779,9340431,12.791666666666666
420,540,0,24780,9340971,12.857142857142858
290,419,0,24781,9341390,14.448275862068966
330,524,0,24782,9341914,15.878787878787879
440,560,0,24783,9342474,12.727272727272727
90,95,0,24784,9342569,10.555555555555555
160,228,0,24785,9342797,14.25
260,375,0,24786,9343172,14.423076923076923
180,244,0,24787,9343416,13.555555555555555
350,502,0,24788,9343918,14.342857142857143
330,548,0,24789,9344466,16.606060606060606
260,472,0,24790,9344938,18.153846153846153
340,479,0,24791,9345417,14.088235294117647
180,263,0,24792,9345680,14.61111111111111
230,309,0,24793,9345989,13.434782608695652
200,317,0,24794,9346306,15.85
160,181,0,24795,9346487,11.3125
220,317,0,24796,9346804,14.409090909090908
170,304,0,24797,9347108,17.88235294117647
240,371,0,24798,9347479,15.458333333333334
140,183,0,24799,9347662,13.071428571428571
230,283,0,24800,9347945,12.304347826086957
260,344,0,24801,9348289,13.23076923076923
60,54,0,24802,9348343,9.0
190,273,0,24803,9348616,14.368421052631579
240,356,0,24804,9348972,14.833333333333334
60,74,0,24805,9349046,12.333333333333334
210,297,0,24806,9349343,14.142857142857142
350,600,0,24807,9349943,17.142857142857142
210,293,0,24808,9350236,13.952380952380953
250,417,0,24809,9350653,16.68
220,268,0,24810,9350921,12.181818181818182
190,262,0,24811,9351183,13.789473684210526
180,272,0,24812,9351455,15.11111111111111
240,360,0,24813,9351815,15.0
230,380,0,24814,9352195,16.52173913043478
120,178,0,24815,9352373,14.833333333333334
360,580,0,24816,9352953,16.11111111111111
100,108,0,24817,9353061,10.8
150,171,0,24818,9353232,11.4
110,192,0,24819,9353424,17.454545454545453
250,393,0,24820,9353817,15.72
290,354,0,24821,9354171,12.206896551724139
270,388,0,24822,9354559,14.37037037037037
290,457,0,24823,9355016,15.758620689655173
250,347,0,24824,9355363,13.88
390,591,0,24825,9355954,15.153846153846153
210,266,0,24826,9356220,12.666666666666666
230,314,0,24827,9356534,13.652173913043478
350,556,0,24828,9357090,15.885714285714286
570,967,0,24829,9358057,16.964912280701753
470,792,0,24830,9358849,16.851063829787233
160,206,0,24831,9359055,12.875
340,517,0,24832,9359572,15.205882352941176
210,300,0,24833,9359872,14.285714285714286
140,232,0,24834,9360104,16.571428571428573
230,322,0,24835,9360426,14.0
310,477,0,24836,9360903,15.387096774193548
280,400,0,24837,9361303,14.285714285714286
430,610,0,24838,9361913,14.186046511627907
210,271,0,24839,9362184,12.904761904761905
330,495,0,24840,9362679,15.0
220,303,0,24841,9362982,13.772727272727273
120,208,0,24842,9363190,17.333333333333332
70,79,0,24843,9363269,11.285714285714286
330,523,0,24844,9363792,15.848484848484848
320,445,0,24845,9364237,13.90625
180,287,0,24846,9364524,15.944444444444445
150,197,0,24847,9364721,13.133333333333333
320,515,0,24848,9365236,16.09375
310,443,0,24849,9365679,14.290322580645162
210,260,0,24850,9365939,12.380952380952381
160,225,0,24851,9366164,14.0625
400,599,0,24852,9366763,14.975
310,579,0,24853,9367342,18.677419354838708
400,591,0,24854,9367933,14.775
570,1096,0,24855,9369029,19.228070175438596
370,558,0,24856,9369587,15.08108108108108
100,128,0,24857,9369715,12.8
330,468,0,24858,9370183,14.181818181818182
90,134,0,24859,9370317,14.88888888888889
210,328,0,24860,9370645,15.619047619047619
190,257,0,24861,9370902,13.526315789473685
290,403,0,24862,9371305,13.89655172413793
290,442,0,24863,9371747,15.241379310344827
220,373,0,24864,9372120,16.954545454545453
130,190,0,24865,9372310,14.615384615384615
330,486,0,24866,9372796,14.727272727272727
120,174,0,24867,9372970,14.5
230,342,0,24868,9373312,14.869565217391305
180,244,0,24869,9373556,13.555555555555555
310,495,0,24870,9374051,15.96774193548387
340,508,0,24871,9374559,14.941176470588236
190,249,0,24872,9374808,13.105263157894736
240,379,0,24873,9375187,15.791666666666666
300,476,0,24874,9375663,15.866666666666667
210,304,0,24875,9375967,14.476190476190476
160,216,0,24876,9376183,13.5
270,444,0,24877,9376627,16.444444444444443
160,223,0,24878,9376850,13.9375
390,584,0,24879,9377434,14.974358974358974
330,408,0,24880,9377842,12.363636363636363
350,559,0,24881,9378401,15.971428571428572
390,590,0,24882,9378991,15.128205128205128
160,222,0,24883,9379213,13.875
250,321,0,24884,9379534,12.84
270,391,0,24885,9379925,14.481481481481481
120,189,0,24886,9380114,15.75
250,316,0,24887,9380430,12.64
380,524,0,24888,9380954,13.789473684210526
320,478,0,24889,9381432,14.9375
230,335,0,24890,9381767,14.565217391304348
410,555,0,24891,9382322,13.536585365853659
170,212,0,24892,9382534,12.470588235294118
320,574,0,24893,9383108,17.9375
260,318,0,24894,9383426,12.23076923076923
160,260,0,24895,9383686,16.25
200,278,0,24896,9383964,13.9
170,237,0,24897,9384201,13.941176470588236
120,183,0,24898,9384384,15.25
170,264,0,24899,9384648,15.529411764705882
80,119,0,24900,9384767,14.875
200,342,0,24901,9385109,17.1
130,181,0,24902,9385290,13.923076923076923
90,118,0,24903,9385408,13.11111111111111
410,656,0,24904,9386064,16.0
240,414,0,24905,9386478,17.25
250,345,0,24906,9386823,13.8
330,578,0,24907,9387401,17.515151515151516
330,363,0,24908,9387764,11.0
320,431,0,24909,9388195,13.46875
330,510,0,24910,9388705,15.454545454545455
390,620,0,24911,9389325,15.897435897435898
270,383,0,24912,9389708,14.185185185185185
320,420,0,24913,9390128,13.125
330,479,0,24914,9390607,14.515151515151516
250,387,0,24915,9390994,15.48
250,383,0,24916,9391377,15.32
320,512,0,24917,9391889,16.0
350,595,0,24918,9392484,17.0
170,251,0,24919,9392735,14.764705882352942
160,231,0,24920,9392966,14.4375
360,529,0,24921,9393495,14.694444444444445
60,65,0,24922,9393560,10.833333333333334
140,208,0,24923,9393768,14.857142857142858
290,425,0,24924,9394193,14.655172413793103
280,448,0,24925,9394641,16.0
180,243,0,24926,9394884,13.5
130,204,0,24927,9395088,15.692307692307692
60,66,0,24928,9395154,11.0
240,378,0,24929,9395532,15.75
190,312,0,24930,9395844,16.42105263157895
140,236,0,24931,9396080,16.857142857142858
250,376,0,24932,9396456,15.04
210,388,0,24933,9396844,18.476190476190474
170,314,0,24934,9397158,18.470588235294116
300,474,0,24935,9397632,15.8
230,370,0,24936,9398002,16.08695652173913
260,401,0,24937,9398403,15.423076923076923
400,566,0,24938,9398969,14.15
120,168,0,24939,9399137,14.0
210,279,0,24940,9399416,13.285714285714286
140,208,0,24941,9399624,14.857142857142858
180,246,0,24942,9399870,13.666666666666666
180,293,0,24943,9400163,16.27777777777778
220,299,0,24944,9400462,13.590909090909092
200,335,0,24945,9400797,16.75
390,596,0,24946,9401393,15.282051282051283
240,373,0,24947,9401766,15.541666666666666
210,334,0,24948,9402100,15.904761904761905
140,185,0,24949,9402285,13.214285714285714
190,332,0,24950,9402617,17.473684210526315
320,427,0,24951,9403044,13.34375
200,255,0,24952,9403299,12.75
500,712,0,24953,9404011,14.24
280,442,0,24954,9404453,15.785714285714286
250,377,0,24955,9404830,15.08
360,504,0,24956,9405334,14.0
330,461,0,24957,9405795,13.969696969696969
180,263,0,24958,9406058,14.61111111111111
100,122,0,24959,9406180,12.2
260,381,0,24960,9406561,14.653846153846153
360,519,0,24961,9407080,14.416666666666666
320,543,0,24962,9407623,16.96875
110,178,0,24963,9407801,16.181818181818183
440,702,0,24964,9408503,15.954545454545455
210,282,0,24965,9408785,13.428571428571429
210,307,0,24966,9409092,14.619047619047619
330,551,0,24967,9409643,16.696969696969695
330,558,0,24968,9410201,16.90909090909091
270,386,0,24969,9410587,14.296296296296296
190,305,0,24970,9410892,16.05263157894737
330,557,0,24971,9411449,16.87878787878788
120,149,0,24972,9411598,12.416666666666666
140,216,0,24973,9411814,15.428571428571429
300,412,0,24974,9412226,13.733333333333333
140,189,0,24975,9412415,13.5
100,121,0,24976,9412536,12.1
200,271,0,24977,9412807,13.55
200,270,0,24978,9413077,13.5
250,452,0,24979,9413529,18.08
220,315,0,24980,9413844,14.318181818181818
200,292,0,24981,9414136,14.6
380,532,0,24982,9414668,14.0
320,459,0,24983,9415127,14.34375
70,90,0,24984,9415217,12.857142857142858
350,447,0,24985,9415664,12.771428571428572
120,123,0,24986,9415787,10.25
150,191,0,24987,9415978,12.733333333333333
300,442,0,24988,9416420,14.733333333333333
340,454,0,24989,9416874,13.352941176470589
230,310,0,24990,9417184,13.478260869565217
430,549,0,24991,9417733,12.767441860465116
280,386,0,24992,9418119,13.785714285714286
290,399,0,24993,9418518,13.758620689655173
330,528,0,24994,9419046,16.0
270,412,0,24995,9419458,15.25925925925926
150,223,0,24996,9419681,14.866666666666667
280,400,0,24997,9420081,14.285714285714286
250,409,0,24998,9420490,16.36
340,598,0,24999,9421088,17.58823529411765
